. . . . . . . @ . . . . . . . . . . . . . @ . . . @ . . . . . . 
. . . . . . @ . @ @ @ . . . . @ @ . . . . . . @ . . . . . . . . 
. . @ . . . . . . @ . . . . . @ . . . . @ . . @ @ . . . . . . . 
@ @ . . @ . . . @ . . . @ @ . . . . . . . . . . . . . @ . . @ @ 
. . . . . . . @ @ . . . . . . . . @ . . . . . . @ @ . . . . . . 
. @ . . . . . @ . . . . . . . . @ . . . . . . . . . @ . . . @ . 
. @ . . @ . . . @ . . . . @ @ @ . @ @ . . . . . . . . . @ . . @ 
. @ . . . . @ . . @ . . . @ . . . @ . . @ . . . . . . . @ . . . 
. . . . . . @ . . @ . . @ @ . . @ . . @ . @ . . . . @ @ . . . . 
. . . . . . . . . . . @ . . . . . . . @ @ . . . . @ . . . @ . . 
. . . . . @ . @ . . . . . @ . . . . . . @ . . . . . @ . . . . . 
. . @ . . . @ . . @ . . . . @ . @ . . . . . . . . @ @ . . @ . . 
. . . @ @ . . . . . . . . . . . . @ . . @ . . @ @ . . . . . . . 
. . @ . . @ . . . @ . . . . @ . . @ . @ @ @ @ @ . . . . . . @ . 
. @ . . . . . . . . . . . . . @ @ . . @ @ . . . . . . . . . . . 
. . . . @ . . . . . . . . . . . . . . . . . @ @ @ . . . . . @ @ 
. @ . . @ . . . . . . . . . . @ . . . . . . @ . . . @ . . . . . 
. . . . . . . . . . . . . . . @ . @ . . . . . @ @ . . . . . @ @ 
. . . . . . @ . . . @ @ . . . . @ . . @ . . . . . . @ . @ . . . 
. . . . . @ . . . . . @ . . . . . . . . . @ . . . . @ . . . . . 
. @ . . . @ @ . . . @ . @ . . . . . . . . . . . . @ . @ . . . . 
. . . . . . . . @ . . . @ . @ @ . . . . . @ @ . @ @ . @ @ . @ @ 
. @ . . . . . . . . . . . . . . . . . . . . . . . . @ . . . . . 
. . . . . @ . . . . . . @ @ . . . . . @ . . @ . . . @ . . . . . 
. . @ . . . @ . @ . . . . . . . . . . . . . . . . . . . . . @ . 
. @ . . . . . . . . @ . . . . @ @ . . . . @ . @ @ . . . . @ . . 
@ . . @ . . . . . . . . . @ @ . . . . . . . . @ . . . . . . @ . 
@ . . . . . . . . @ . . . @ . . @ @ @ . . . @ @ . . . @ . . @ . 
. . . . @ . . . . . . @ . . @ . . @ . . . . @ . . @ . . . . . . 
. . . . . . . . . . . . @ . . . . . . . . . . . . . . . . . . . 
. @ . @ . . . @ . @ . . . @ . . . . . . . . . . @ . . . . . . @ 
. @ . . . . . . @ . . . @ . @ . . . . . . @ . . . . . @ . . . . 
