8 8
. . . @ . . . @ 
. @ @ . . . . . 
. @ @ . . . @ . 
@ . @ . . . . . 
. . . . . . . . 
. . . . . . . . 
. . . @ . @ . . 
. . . . @ . . . 
7
2 7 7 3
6 0 6 1
6 7 4 5
6 3 7 7
3 2 4 2
7 2 3 2
5 1 5 3
