8 8
. . . @ . . . . 
. . . . @ . @ . 
. . . . . @ . @ 
. . . . . . . . 
@ . @ . . . . . 
. . . @ . . @ @ 
@ . . . . . . . 
. . . @ . . . . 
10
6 6 1 1
0 7 4 6
2 0 2 1
5 7 5 5
7 7 1 6
1 4 7 3
4 2 3 3
2 1 1 5
7 6 1 0
3 4 1 2
