8 8
. . . . . @ . . 
@ . . . . . @ . 
@ . . . . . . . 
. @ @ . . . . . 
. @ . @ @ . . . 
. . @ . @ . . . 
. . @ . . . . . 
. . . . . . . . 
9
3 0 5 1
2 7 0 4
7 1 5 3
7 6 6 6
1 5 4 6
1 7 2 1
0 7 2 2
6 5 0 6
3 1 4 3
