8 8
@ @ @ . @ . . . 
. . . . . . . . 
. . . . . . . @ 
. . . @ . . @ @ 
. . . . . @ . . 
. . . @ . . . . 
. . . . . . . . 
. . . . . @ @ . 
3
3 4 7 1
2 5 6 0
3 1 3 2
