8 8
. @ . . @ @ . . 
. . . . . . . . 
. . . @ . @ . . 
@ . . . . . . . 
. @ . . . @ @ . 
. . . . . . . . 
. . . . . . . . 
. . . @ . . @ @ 
1
6 5 5 5
