8 8
. . . . . . . . 
. . @ . . . . . 
. . . . . . . . 
. . . . @ . . . 
. @ @ . . . @ . 
@ . . @ . . . @ 
@ . . . . @ . @ 
. . @ . . . . . 
3
6 2 1 0
1 2 4 7
3 7 6 6
