8 8
. . . . @ . @ @ 
. . . . @ . . . 
@ . . . . . . @ 
. . . . . . . . 
. . . . . . . . 
. . . @ . @ . . 
. @ @ . . . . @ 
@ . . . . . . . 
2
5 4 2 2
5 6 7 5
