8 8
. . . . . . . . 
. . . . . . . . 
. @ . . . @ . @ 
. @ @ . . @ . . 
. @ . . . @ . . 
. . @ . . . . . 
. . . . . @ . . 
@ . . . . @ . . 
5
0 3 4 4
1 5 3 4
5 5 7 1
0 4 4 5
1 7 3 5
