8 8
. . @ . @ . . . 
. @ . . @ . . . 
. . . . . . . . 
@ @ . . . . . . 
. . . @ . . . @ 
. . . . . . . . 
. . @ @ . . . @ 
. @ . . . . . . 
5
6 5 1 6
6 7 1 5
7 3 0 7
7 5 6 4
4 6 5 6
