8 8
. . @ @ . . . . 
. . . . @ @ . . 
. . . . @ . . . 
. . . . . . . . 
. . . . . . . . 
. @ . . . . . . 
. . @ . . . . @ 
@ @ . @ @ . . . 
6
4 4 1 0
5 3 2 4
1 4 3 4
4 5 6 2
1 0 0 3
1 1 4 3
