8 8
@ . . . . . . . 
. . @ @ . . . . 
. . . . . . . . 
@ . . . . . . @ 
. . @ . . . @ . 
. . . . . . . . 
@ . . . @ . . @ 
@ . . @ . . . . 
10
5 4 0 5
6 6 4 3
0 1 6 6
3 6 0 1
2 3 6 7
5 3 3 3
6 1 6 3
6 2 3 4
1 3 3 2
1 4 2 6
