8 8
. . . . . . . . 
@ . . @ @ @ @ . 
. @ . . . . . . 
. . . . . . . . 
. . . . @ . . @ 
. . . @ . . . . 
@ @ @ . . . . . 
. . . . . . . . 
5
4 0 7 5
6 4 6 2
0 3 1 3
6 2 5 6
2 7 2 2
