8 8
. . . . . . @ . 
@ . @ . . . . . 
@ . . . . . . . 
. . . @ . @ . . 
. . @ . . . . . 
. . . . . . . . 
. . . . @ . . . 
@ . @ . . @ . @ 
3
7 0 7 4
3 1 0 4
4 2 3 2
