8 8
. . . . . . @ . 
. . . . @ . . . 
. . @ @ . . @ @ 
@ . . . . . . . 
. . . . @ . . @ 
. . . . . . . . 
. . . @ . . @ . 
. . . . . . @ . 
8
0 7 6 3
6 1 7 3
5 0 1 1
0 6 5 5
6 4 2 0
1 0 2 6
5 6 5 1
1 7 4 0
