8 8
. . . @ . . @ . 
@ . @ . . @ . . 
. . . . . . . @ 
. . @ . . . . . 
. . . . . @ . . 
@ . . . . . @ . 
. @ . . . . . @ 
. . . . . . . . 
3
3 5 1 0
0 0 3 1
4 6 4 1
