8 8
. . . . . . @ . 
@ . . . . . . . 
. . . . . @ . . 
. . . . @ @ . . 
. . . . . . . . 
. @ . . . @ @ . 
. . @ . . . . . 
. @ @ . . @ . . 
6
7 6 1 3
3 1 6 6
7 5 0 2
6 2 1 2
0 4 4 2
1 4 3 5
