8 8
. . @ . . . . . 
. . . . . @ @ . 
. @ . . . . . . 
. . . @ . . . . 
. . . @ . @ . . 
. . . . . . @ . 
. . . @ . . @ . 
. . . @ @ . . . 
5
5 6 0 5
6 3 7 4
6 0 6 4
0 3 7 5
7 1 6 0
