8 8
. . . . . . . . 
@ . . @ . . . @ 
. @ . . . @ . . 
. . . . . . @ . 
. @ @ . . . @ . 
. . . @ . @ . @ 
. . . . . . . . 
. . . . . . . . 
7
6 6 7 7
3 6 3 6
5 6 5 0
3 3 5 6
5 3 4 7
6 7 7 2
0 5 2 5
