8 8
. @ @ . . . . . 
. . @ . . . @ . 
. . . . . @ @ . 
@ . . @ . . . . 
. . . . . . . . 
. . . . . . . @ 
. . . . . . . . 
. @ . @ @ . . . 
9
0 4 1 1
0 6 1 2
4 4 7 2
5 1 6 3
3 2 7 7
3 6 3 4
2 4 2 3
7 6 5 6
1 5 6 6
