8 8
@ . . . @ . . @ 
. . . . . . . . 
. . . @ @ . . . 
. @ . . . . . @ 
. @ . @ . . . . 
. . @ . . . . . 
. . . @ . . . . 
. . . . . . @ . 
8
6 0 0 3
6 6 5 0
2 3 1 7
6 2 6 1
2 4 1 1
3 7 0 1
0 4 4 3
3 0 6 2
