8 8
. . . . . . . . 
@ . . . . . . . 
. . . @ . . @ @ 
@ . . . . @ . @ 
. . @ @ . . . . 
. @ @ . . . . . 
. . . . . . . . 
. . @ . . . . . 
2
6 1 7 0
4 0 4 7
