8 8
. . . . . . . . 
. . @ . . . . . 
@ . @ . . . @ @ 
. . . . . . @ . 
. . . . . . . . 
@ @ . . . . . . 
@ . @ . . . @ . 
. . . . . . . @ 
8
1 6 6 5
5 1 4 1
4 5 0 4
3 4 2 0
1 3 2 7
5 6 5 7
7 0 4 5
4 7 1 7
