8 8
. . . . . . . . 
@ . . . . . @ . 
@ @ @ . . @ . . 
@ . . @ . . . @ 
. . . @ . . . . 
. . . . @ . . . 
. . . . . . . . 
. . . . . @ . . 
10
5 6 0 0
2 7 7 7
6 4 1 7
4 7 4 0
4 6 1 3
7 5 5 5
5 0 2 1
6 7 2 4
3 7 7 1
5 3 5 1
