8 8
. . . @ @ . . . 
. . . . . . . . 
@ @ . @ . . @ . 
. . . . . . . . 
. . . . @ . . @ 
. . . . . . . . 
. @ . . @ @ . . 
@ . . . . . . . 
1
3 1 5 3
