8 8
. @ . . . . @ . 
. . . . . . . @ 
. . . @ . . . . 
. . . . . . . . 
@ . . @ . . . . 
. . . . . . @ . 
. . . . @ . @ . 
. . @ @ . . @ . 
5
7 6 6 3
5 1 1 1
2 6 3 0
2 3 1 5
2 4 1 3
