8 8
. . . . @ . . @ 
. . . . . . . . 
. . . @ . . . . 
@ . . . . . . . 
@ . . . . @ . . 
. . . . @ @ . . 
@ . @ . . . . . 
. . . @ . . . @ 
10
7 4 2 7
6 2 1 0
0 2 1 3
1 0 6 0
6 0 6 3
5 0 7 1
0 7 5 2
5 7 4 1
1 3 1 7
2 0 1 5
