8 8
. . . . . . . . 
. . . @ . @ . . 
. . . @ . . . @ 
@ . . . . . . @ 
. . . @ . . . . 
. . . . . @ . . 
. . . @ . . . @ 
@ . . . . . . @ 
8
0 2 5 3
3 0 4 7
1 3 2 1
1 1 6 5
3 5 5 4
4 0 6 0
2 4 0 4
7 4 3 5
