8 8
. . . . . . . . 
. . . . . . @ . 
. @ @ . . @ . . 
. @ @ . . @ . . 
. @ . . . . . @ 
. . . . . . . . 
. . . . . . @ . 
. . @ . @ . . . 
10
1 5 2 6
3 5 4 1
4 1 4 6
0 4 2 4
7 1 5 0
3 6 1 7
5 1 0 5
2 6 7 3
2 4 0 3
7 5 6 7
