8 8
. . . @ . . . . 
. . . . . @ . . 
. . . . . . @ . 
. . . . . @ @ . 
@ . . . . . . . 
. @ . @ . @ @ . 
. . . . @ . . . 
. . . . . . . @ 
4
0 6 2 3
7 2 0 2
3 1 7 2
5 7 2 1
