8 8
. . . . . . . . 
. . @ . . @ . . 
. @ @ @ . . . . 
. . . . . . . @ 
. @ . . . . . . 
. @ @ . @ . . . 
@ . . @ . . . . 
. . . . . . . . 
2
0 5 5 2
4 2 3 5
