8 8
@ . . . @ . @ @ 
. . . . . . . . 
. @ @ @ . . . . 
. . @ . . . . . 
. . @ . . . . . 
. . . @ . . . . 
. . @ . . . . . 
. @ . . . . . . 
7
7 5 6 5
0 1 7 4
6 7 5 1
2 7 0 6
1 1 0 7
5 2 5 5
3 4 5 0
