8 8
. . . @ @ . . . 
. . . . . . @ . 
. . . . @ . @ . 
@ . . . . . . . 
@ . . . . . . . 
@ @ @ . . . . . 
@ . . . . . @ . 
. . . . . . . . 
1
0 1 1 2
