8 8
. . . @ . @ . . 
. @ . . @ . . . 
. . @ . @ . . . 
. . . . . . . . 
@ . . . . . . . 
. . . . . . @ @ 
@ @ . . . . . . 
. . . . . . . @ 
7
2 0 3 6
4 7 7 2
3 1 2 7
5 4 2 6
7 6 6 3
1 3 2 1
6 1 5 2
