8 8
. . . . . . . . 
. . . . . . . . 
. @ . . . . . . 
. . . . @ @ . . 
. @ @ . . . . . 
@ . . . @ . . . 
. . . @ . . . . 
. @ . @ . @ . @ 
10
6 2 3 0
7 5 2 3
0 7 4 2
4 7 7 2
5 4 7 3
3 5 1 5
1 3 6 7
2 6 5 4
6 5 7 1
7 0 5 5
