8 8
. @ . . @ . . . 
. . . . . . . @ 
. @ . . . . . . 
. . . . . @ @ . 
. . . . @ . . . 
@ . . . . @ . @ 
. . . . @ . . . 
. @ . . . . . . 
2
3 3 5 7
3 6 2 2
