8 8
. . . . . . . . 
. . . . @ . . . 
@ . . . @ . . @ 
. . . @ . . . . 
. . . @ . . . . 
. . . . . @ . . 
. @ @ . . @ . @ 
. . . . @ . . . 
3
5 2 1 4
7 7 4 6
7 5 7 1
