8 8
. . . @ . @ . . 
. . . . . . . . 
. . @ . @ @ . @ 
. . . . . . . . 
@ . . . . . @ . 
. . . . . . @ . 
. @ . . . @ . . 
. . @ . . . . . 
7
1 4 0 7
4 0 6 3
0 6 4 5
6 7 5 1
6 1 5 4
4 5 2 6
7 6 5 3
