8 8
@ . . @ . . @ . 
. @ . . . . . . 
. . . . . . . @ 
. . . . . @ . . 
. . . . . @ . . 
. . . . . . . @ 
. . . . . . . . 
@ @ @ . . @ . . 
1
6 3 2 4
