8 8
. . . . . . @ @ 
. . . . . . . . 
@ . @ . @ @ . . 
. . . . @ . . . 
. . . . . . @ @ 
. @ . . . @ . . 
. . . . . . . . 
. . . . @ . . . 
7
7 7 1 3
0 5 1 0
6 7 1 2
3 7 3 1
2 0 7 6
1 4 7 3
4 6 4 5
