8 8
. @ . . . . . . 
. . . . @ . . . 
. . . . . . . . 
. . . . . . . . 
@ . . . @ . . . 
@ . . . . @ . . 
. . @ . @ . . @ 
. @ . . . . @ @ 
4
7 4 1 3
6 2 5 2
6 4 3 5
7 2 0 1
