8 8
. @ . . . . . . 
. . @ . . . . . 
. . @ . . . . @ 
. . . @ . @ . . 
. . . @ . . . . 
. . @ . . . . . 
@ . . . . . . . 
. . @ . @ . . @ 
4
3 5 3 0
4 5 6 2
1 6 4 4
5 2 2 4
