8 8
. . . . . . . . 
. @ . @ . . . . 
. . @ . . . . . 
. @ . . . @ . . 
. @ . . @ . . . 
. . . @ @ . . . 
. . @ . . . . @ 
. . . @ . . . . 
2
5 7 1 7
6 6 5 7
