8 8
. . . @ . . . . 
@ . . . . . . . 
. . . @ . . . . 
. @ . @ . . . . 
@ . . . . . . @ 
. . . . @ . . . 
. . @ @ . . . . 
. . @ . @ . . . 
9
5 3 2 4
2 0 1 2
0 2 1 1
0 0 6 4
4 1 5 6
5 5 1 4
4 4 7 0
5 2 5 0
7 6 2 0
