8 8
. @ . . . . . . 
. @ . . . . . . 
. . @ . . . @ @ 
. . . . @ . . . 
@ . . . . . @ . 
@ . . @ . . . . 
. . . . . . . @ 
. . . @ . . . . 
3
6 1 3 4
1 2 1 5
7 1 0 3
