8 8
@ @ . . @ . . @ 
. . @ @ . . . . 
@ . @ . . @ . . 
. . . . . . . . 
. . . . . @ . . 
. . . . . . . . 
. . . . . @ . @ 
. . . . . . . . 
7
2 7 3 5
0 4 1 4
1 4 6 2
6 3 6 1
1 1 4 7
5 0 1 3
1 6 1 5
