8 8
. . @ . . @ . . 
@ . . . . . . . 
@ . . @ . . . . 
. . . . . . . . 
. . . @ . . . @ 
@ . . @ . . . @ 
. . . . . . . . 
. . . . @ @ . . 
9
1 7 7 6
1 6 5 4
4 0 6 5
5 3 1 3
7 0 7 2
1 0 2 3
6 6 6 6
0 3 7 7
7 1 5 6
