8 8
@ . . . . . @ . 
. . . @ @ . . . 
. . . . . . . . 
. . . . . . . . 
. . . . . . @ . 
@ . . . @ . . . 
. . @ . @ @ . @ 
. @ . . . . . . 
4
1 4 2 5
2 5 6 1
6 1 0 3
5 0 0 2
