8 8
@ . . . . . . . 
. . . . . @ . . 
. . . . . . . . 
@ @ . @ . . . . 
@ @ @ . . @ . . 
. @ . . . @ . . 
. . . . . @ . . 
. . . . . . . . 
8
3 4 2 5
4 4 1 2
7 2 4 2
4 6 6 3
6 6 2 3
2 7 1 6
7 1 7 6
3 2 4 0
