8 8
. . . . @ . . @ 
. . @ . . @ . . 
@ . . . . . . . 
. . @ . . . . @ 
@ . . . . . . . 
@ @ . . . . . @ 
. . . . @ . . . 
. . . . . . . . 
10
6 6 1 6
6 3 2 0
0 3 5 3
3 6 7 7
7 4 2 7
1 1 0 7
2 6 4 4
7 1 1 2
6 4 7 2
5 7 6 1
