8 8
. . . . . . . @ 
@ . . . . . . . 
@ . @ . . . . . 
. . . . . @ . . 
. . @ . . @ . @ 
. @ . . . . . . 
@ . . . . . . . 
. . . @ @ . . . 
2
2 3 5 1
6 4 4 0
