8 8
. . . @ @ . . . 
. . @ . @ . . @ 
@ . . . . . . . 
. @ . . . . @ . 
. @ . . . . . @ 
. . . . . . . . 
. @ . . . . . . 
. . . @ . . . . 
3
7 0 2 4
1 1 5 5
1 5 2 7
