8 8
. . . . . . . . 
. . . @ . @ . . 
@ . . . . @ . . 
. . . @ . . . . 
. . . @ . @ . . 
. . . @ . . . . 
@ . . . . . @ . 
. . @ . . @ . . 
10
4 0 5 5
2 4 3 2
4 5 7 1
0 4 2 2
7 6 2 0
5 6 0 5
6 0 7 3
1 2 0 1
4 1 4 2
0 5 1 7
