8 8
. . . . . @ . . 
. @ . . . . . . 
. . @ . . . . . 
. . . . @ @ @ @ 
. . . . . . @ . 
. . . @ . . . . 
. . . . @ . . @ 
. . @ . . . . . 
2
0 7 6 1
0 1 5 2
