8 8
. @ . . . . . . 
. @ @ . . . . @ 
. @ @ . @ . . . 
. @ @ . . . . . 
. . . . . . . @ 
. . . . . . . . 
. . . . . . @ . 
. . . . @ . . . 
3
4 4 5 6
0 6 5 5
5 3 6 3
