8 8
. . . . @ . . . 
@ . @ . . . . . 
. . . . @ . @ . 
. . . . . . . . 
. . . . . . . @ 
. @ . . @ . . . 
. @ . . @ @ . . 
. . @ . . . . . 
4
1 4 5 5
7 7 4 1
5 4 6 3
6 0 5 4
