8 8
. . . . . . . . 
. @ . @ . @ . @ 
. . . . . . . . 
. . . . . . . . 
. . . @ . . @ . 
. . . . . . . @ 
. . . . . . @ . 
. @ @ @ . . @ . 
4
2 5 7 2
1 2 3 3
1 0 6 1
2 4 3 0
