8 8
. . . . . . . . 
@ @ . @ . . . . 
. . . @ . . @ . 
. . . . . . . . 
. . . . . . @ . 
. @ . . . . . . 
. . . @ . . @ @ 
. . @ . @ . . . 
6
7 2 1 7
6 7 7 1
0 0 4 4
5 2 2 6
7 5 7 4
1 7 0 2
