8 8
. . . . @ . . . 
@ . . @ . . . . 
. . @ . . . @ . 
. . . . . . . . 
. . @ @ . . @ . 
. . . . . . . . 
. @ @ . @ . . . 
. . @ . . . . . 
2
5 0 5 4
4 5 2 0
