8 8
. . . . . . . . 
. . . . . . . @ 
. . . @ . . . @ 
. . . . . . . . 
. . @ . . . @ . 
. . @ @ . @ . . 
. @ . @ . . . . 
. . . @ . . . @ 
6
0 2 6 0
1 0 7 5
0 7 6 7
4 6 3 4
0 1 1 7
5 2 2 7
