8 8
. . . . @ . . @ 
. @ . . . . . . 
. @ . . . . @ . 
. . . . . @ . . 
. @ . . . . . @ 
. . . @ . . . @ 
. . . . . . . . 
. . . @ . . @ . 
9
4 4 7 7
5 5 7 6
0 7 0 4
5 7 7 1
4 5 1 0
0 3 0 7
3 6 1 3
2 0 2 1
4 6 2 4
