8 8
. @ . @ . . @ . 
@ . . . . . . . 
@ . . . . . . . 
. . . . . @ . . 
. @ @ @ . . . @ 
. . . . @ . . . 
. . . . @ . . . 
. . . . . . . . 
9
4 4 6 5
6 4 7 3
0 6 1 2
6 1 6 7
2 1 2 1
2 6 2 7
3 2 5 7
7 7 4 0
2 5 3 2
