8 8
. . . . @ . . . 
. . @ . . . . @ 
. . . . . . . . 
. . . . . . . . 
@ . @ @ . @ . . 
. @ . . . . . @ 
. . . . . @ . . 
. . . @ . . . @ 
6
3 0 7 2
5 2 6 3
1 3 1 4
4 6 3 6
3 5 2 5
4 5 4 5
