8 8
@ @ @ . . . . @ 
. . . . . @ . . 
. . . . . . . @ 
. @ . . . . @ @ 
. . . . . . . . 
@ . . . . . . . 
. . . . . . . . 
. . @ . . @ . . 
5
6 1 1 2
5 5 6 0
6 6 0 2
4 3 0 7
2 6 5 5
