8 8
. . . @ . . . . 
@ @ . . . @ . . 
. . . . . @ . @ 
. . . . . @ @ . 
. . . . @ @ . . 
. . . . . . . @ 
. . . . @ . . . 
. . . . . . . . 
10
0 0 1 6
2 7 7 0
1 5 7 7
5 5 3 2
5 0 0 6
0 5 1 3
3 1 2 0
0 4 6 1
2 3 4 1
2 6 3 6
