8 8
. . . . . . . . 
. @ . . . . . @ 
. . . . . @ @ . 
@ . . . . . . . 
. . . @ . @ @ . 
. . . . . @ . . 
. . . . . . . . 
. . @ . . @ . @ 
1
6 7 1 4
