8 8
. . @ . . . @ . 
@ . @ @ . . . . 
. @ . @ . . . . 
@ . . . . @ . . 
. . . . . . . . 
. . . . @ . . . 
. . . . . . . . 
@ . . . . . . @ 
5
2 6 7 4
4 2 4 7
6 6 1 5
7 0 6 1
5 7 5 5
