8 8
@ @ . . @ . . . 
. . . . . . . . 
. @ . . . . . @ 
. . . @ . . . @ 
. . . @ . @ . . 
@ . . . . . . . 
. @ . . . . . . 
. . . . @ . . . 
3
0 2 7 5
5 7 6 5
3 7 5 6
