8 8
. . . . . . . . 
. @ . . . . . . 
. . . @ . . . . 
. @ . @ . . @ . 
. . @ . @ @ . . 
. . @ . . . . . 
. . . @ . . . @ 
. . . . . . @ . 
8
7 5 2 7
0 4 2 0
2 3 0 2
1 5 2 3
3 0 5 2
6 4 2 2
7 4 4 6
5 1 0 5
