8 8
. . . . . @ . . 
. . . . @ @ . . 
@ . @ @ . . . . 
@ @ . . . . @ . 
. . @ . . . . . 
. . . . . . . . 
. . . . . . @ . 
. . . @ . . . . 
3
4 6 7 0
4 4 6 0
5 6 6 1
