8 8
. . . . @ @ . . 
. @ . . . . @ . 
. . . . @ . . . 
. . . . . . . . 
. . @ . @ . . . 
. @ . . @ . . . 
. . . . . . . @ 
. @ . . . . . @ 
6
3 0 0 7
6 5 0 5
4 6 5 5
0 7 3 1
2 3 5 6
6 6 4 6
