8 8
@ . . @ @ . . @ 
. . . . . . . @ 
. . . @ . . . . 
. . @ . . . @ @ 
. @ . . . . . . 
. @ . . . . . . 
. . . . . @ . . 
. . . . . . . . 
5
1 2 3 6
6 2 7 4
6 7 0 3
6 4 2 0
0 2 6 5
