8 8
. @ . . @ . . . 
. . . . @ . . . 
@ . . . . . . . 
. . . . . . . . 
@ . . @ . . . . 
@ . . . . . @ . 
. @ @ . . . . . 
. . . @ . . . @ 
2
2 2 5 3
7 0 0 0
