8 8
. . . @ . . . @ 
@ . . . . . . . 
. . . . @ . . . 
. . . . . . . . 
. . . . . . . . 
. @ . @ @ . . @ 
@ @ @ . . . . @ 
. . . . . . . . 
8
3 3 0 7
5 3 3 1
3 6 3 3
0 3 3 6
2 4 2 2
7 3 1 4
6 1 6 6
5 2 6 1
