8 8
@ . . . . . . . 
@ @ . . . . . . 
. @ . . @ . . @ 
@ . . . . . . . 
. . . . . . . . 
@ . @ . . . @ . 
. . . . . . . . 
. . @ . . . . @ 
4
1 4 0 6
1 7 1 4
7 1 3 4
0 4 4 6
