8 8
. . . @ . @ . . 
. . . . . . . @ 
. . . . . . @ . 
@ . . . . . . . 
. . . . @ . . . 
@ . . @ . . . . 
. . . @ @ . . . 
@ @ . . . . . . 
6
6 7 1 2
2 5 4 7
6 1 1 3
1 5 0 1
0 1 2 5
5 6 6 3
