8 8
. . @ @ . @ . . 
. . . @ . . . . 
@ . @ @ . . . . 
. . . . @ . . . 
@ . . . . . @ . 
. . . . . . . . 
. . @ . . . . . 
@ . . . . . . . 
2
1 2 6 3
0 0 2 4
