8 8
. . . @ . . . @ 
. . . . . . . . 
. . @ . . @ . . 
. . @ . . . @ . 
. @ . . . . @ . 
. . . . . @ . . 
. . . . @ @ . . 
. . @ . . . . . 
3
1 7 7 5
0 7 2 4
0 2 5 7
