8 8
. . . . . . . . 
. . . @ . @ . @ 
. . . . . . . . 
. . @ . . . @ . 
. @ . @ . . . @ 
. . . @ @ . . . 
@ . . @ . . . . 
. . . . . . . . 
9
0 3 0 0
6 2 6 5
5 5 6 0
1 2 7 0
1 3 0 1
0 2 5 5
6 4 1 6
6 6 4 2
7 2 0 5
