8 8
. . . . @ . . . 
. @ @ . . . . . 
. . . . @ . . . 
. . . @ @ . . . 
. . . . . @ . . 
. . . . . . @ . 
. . . . @ . . . 
. @ . . @ . . @ 
9
3 6 0 4
3 5 7 2
2 3 4 5
6 3 4 1
0 6 5 0
1 6 6 7
0 7 3 2
3 4 2 2
7 4 3 1
