8 8
@ . . @ . . . . 
. . . . . @ . . 
. @ . . . . @ . 
. @ . . . . . . 
. @ @ . . . . @ 
@ . . . . . @ . 
. . . . @ . . . 
. . . . . . . . 
2
6 4 7 3
4 2 2 3
