8 8
. . @ . . . . . 
. . @ . . . . @ 
. . @ @ . @ . . 
. . . . . . . . 
. @ @ . . . . . 
. . . . @ @ . . 
. . . . . . . . 
. . . @ @ . . . 
5
4 6 5 6
7 3 6 4
1 0 5 7
3 3 1 6
4 1 0 3
