8 8
. . @ @ . . . . 
. . . @ . . . . 
@ . . . . . . . 
. . . . . . @ . 
. . @ . . . . . 
. . @ . . @ . . 
. . . . . . . . 
@ . @ @ . @ . . 
5
6 0 6 0
1 5 4 1
2 6 2 2
5 1 6 1
6 4 7 4
