8 8
@ . . . @ . . . 
. @ . @ . . . . 
@ . . . . . . @ 
. . . . . . . . 
. . . @ . . @ . 
. . . . @ . . . 
. . . . . . . . 
. . @ . @ . @ . 
3
7 4 2 1
2 0 1 3
0 6 7 4
