8 8
@ . . . @ @ . . 
. . . . . . . . 
. . . . . . . . 
. . . @ @ . . @ 
. . . . . . . . 
. . @ @ . . . . 
. . @ . @ @ . . 
. . . . . @ . . 
5
7 2 6 6
2 7 2 1
5 3 5 2
5 5 4 7
7 4 0 4
