8 8
. . . . . . . . 
. @ . . . . . . 
. . @ @ . @ . . 
. . . . . . . . 
. @ . . . . . @ 
. @ . . @ . . . 
. @ . . . . . . 
@ . . @ . . . @ 
7
2 4 6 5
6 4 5 6
0 0 1 2
1 2 5 0
7 3 0 0
2 0 2 7
7 1 0 6
