8 8
. . . . . . . . 
@ . @ . . . @ . 
. @ . . . . . . 
. . . . . @ @ . 
. . @ . . . @ . 
. @ . . @ @ . . 
. . . . . . . . 
. . . . @ . . . 
9
0 5 3 4
4 0 7 0
4 3 0 7
2 6 1 3
3 2 0 2
5 6 6 2
6 6 4 1
3 1 3 1
5 4 3 5
