8 8
. @ . . . . . . 
. . @ . . . . @ 
. . . . . @ @ . 
@ . . @ @ . . . 
. . . . . @ @ . 
. . . . . . . . 
. . . . . . . . 
. @ . . . @ . . 
7
2 5 5 5
7 0 7 3
6 5 7 6
2 3 2 5
2 7 7 0
1 6 0 7
4 7 6 6
