8 8
. . . . @ . . @ 
. . . . . . . . 
. . . . . . . @ 
. . . @ @ . . . 
. . @ . @ . . . 
. . . . . . . @ 
. . . . . . @ . 
. . @ @ . @ . . 
7
4 5 0 2
4 7 0 5
1 1 6 1
0 1 5 1
6 3 0 4
1 5 7 4
3 6 5 3
