8 8
. . @ @ . . @ . 
. . . . . . . . 
. . @ @ . . . . 
. . . @ . . . @ 
@ . . . . . @ . 
@ . . . . . @ . 
. @ . . . . . . 
. . . . . . . . 
2
6 7 7 1
6 2 5 0
