8 8
. . . . . . . . 
. . . . . . . . 
. . @ . @ . . . 
@ . . . @ . . . 
. . @ . . . . . 
@ . . . @ @ . . 
. . . . . . @ . 
@ @ . . . @ . . 
8
0 6 0 0
4 4 7 7
2 3 1 3
3 3 6 2
7 1 0 2
7 0 4 1
6 1 6 0
7 5 5 0
