8 8
. @ . . . . . . 
. . . . . @ . . 
. . . . . . @ @ 
. . . . . . . . 
. . . . @ . . @ 
. . . . @ . @ . 
@ @ . . . . . . 
. @ . . @ . . . 
8
0 5 5 0
4 2 7 7
2 5 4 2
3 4 2 4
2 7 3 4
1 4 4 3
5 0 6 7
7 3 6 3
