8 8
@ @ . . . . . . 
@ . . . . . . . 
. . . . . . . @ 
. . . . . . . . 
. . @ . . @ . @ 
. @ . . . . @ . 
@ @ . . . . . . 
. . . @ . . . . 
3
6 1 3 6
6 6 4 2
0 5 7 0
