8 8
. @ . . . . . . 
@ @ . . . . . . 
@ . . . . . . . 
. . . @ @ . . . 
. . . . @ . . @ 
. . . . . . @ . 
. . . . @ . @ . 
. . . . . @ . . 
3
3 6 6 4
1 2 2 5
3 4 2 2
