8 8
. . . @ . . . . 
. . . @ . @ . @ 
. . . . . . . . 
. . . . . . . @ 
@ . . . . . @ . 
@ . . . . . . . 
. . . @ . . . . 
@ . . @ . @ . . 
9
1 6 4 1
4 1 0 0
6 0 7 6
5 3 1 6
1 1 0 1
1 2 6 7
7 0 2 0
7 5 5 3
0 1 4 3
