8 8
. . . @ . @ . . 
. . . . . @ . . 
. . @ . @ . . @ 
. . . . . . . . 
. @ . . . . . . 
. . . . . . . . 
@ . . . @ @ . . 
. . . @ . @ . . 
2
6 4 7 6
3 2 0 7
