8 8
. . @ . . @ . . 
@ . . @ . . . . 
. . . @ . . . . 
. . . . . . . . 
@ @ . @ . . . @ 
. . . . . . @ . 
. . . . . . . . 
. @ . . @ . . . 
6
6 4 1 0
7 3 3 5
1 5 2 4
4 5 2 2
5 2 4 5
0 0 3 0
