8 8
. . . . @ . . . 
. . . . . . . . 
. . . . . @ @ . 
@ . . @ . . @ . 
. . . . . . . @ 
. . . . . . . @ 
. . . . . . . . 
@ . . . @ @ . @ 
3
4 2 5 0
6 4 4 3
0 5 1 4
