8 8
@ . . . . @ @ . 
. @ @ . . . . . 
. . . . . . . . 
. . . . . . . . 
. . . . . . . . 
. @ @ . @ . . . 
. . . . . @ . . 
. . @ . . . @ @ 
5
3 3 5 4
4 4 3 7
7 3 7 5
6 6 1 7
4 3 1 0
