8 8
. . . . @ . . @ 
. . . . @ . . . 
. . . . . . @ @ 
. . . . . . . . 
. . . @ . . . . 
. . @ . . @ . . 
. . . . @ . @ . 
@ . . @ . . . . 
10
5 0 2 4
7 3 1 7
6 5 5 1
0 0 0 5
7 4 2 2
0 1 0 1
1 6 1 0
6 4 4 2
1 1 0 3
4 2 7 7
