8 8
. . @ . . . @ @ 
. . . . . . . @ 
. . @ . . . . . 
@ . . . . . . . 
. . . . . . . . 
@ . . . . @ @ . 
. . . . . @ @ . 
. . . . . . . @ 
3
0 1 4 0
6 2 0 2
2 1 0 1
