8 8
. @ . . . . @ @ 
. . . . @ . . . 
. . . . . . . . 
. @ . . . @ . . 
. . . @ . @ . . 
@ . @ . . . . . 
. @ . . @ . . . 
. . . . . . . . 
2
3 5 2 1
2 7 4 4
