8 8
. @ . . . . . . 
. . . . . . . . 
. . @ @ . . . . 
@ . @ . . . @ . 
. . . . . . . @ 
@ . . . . @ . . 
. . . . . . @ . 
. @ . @ . . . . 
4
2 5 1 3
0 0 4 6
5 2 3 3
1 3 7 0
