8 8
. . . . . . . . 
. . . @ . @ . . 
. . . . @ . @ . 
. . . . . . . . 
@ . @ . @ @ @ . 
. . . . . @ . . 
. . . . @ . . . 
. . . @ . . . . 
5
3 2 2 7
3 6 6 0
2 1 6 5
5 7 7 3
1 4 1 7
