8 8
. . . @ @ . . @ 
. @ . . . . . . 
. @ . . . . . . 
. . . . . . . . 
. . . @ @ @ . . 
. @ . . @ . @ . 
. . . . . . . . 
. @ . . . . . . 
8
4 2 0 4
5 7 4 7
0 5 4 6
7 1 0 7
0 0 0 0
7 2 5 3
3 5 5 6
3 7 1 4
