8 8
. @ @ . . . @ . 
. . . . . . . . 
. @ @ @ . @ @ . 
. . . . @ . . . 
. . . . . . . . 
. . . . . @ @ . 
. . . @ . . . . 
. . . . . . . . 
7
3 4 2 3
0 5 5 3
7 3 7 6
2 5 5 4
7 6 4 6
6 6 6 1
1 1 6 3
