8 8
. @ @ . . . . . 
. . . . . @ . . 
. . . . . . @ . 
. . @ . . . . . 
. @ . . . . . @ 
@ . . @ . . . . 
. @ . . . @ @ . 
. . . . . . . . 
8
4 0 4 5
7 0 6 1
0 7 5 7
4 6 3 0
5 5 3 2
0 3 5 2
5 7 7 5
4 5 4 2
