8 8
@ . . . . . . . 
. . . . . . @ @ 
. . . . . . . . 
. @ . . . @ @ . 
. @ @ . . . . . 
@ . . . @ . . . 
. @ . @ . . . . 
. . . . . . . . 
5
1 1 0 7
7 5 3 7
5 7 6 7
2 7 2 3
1 5 5 5
