8 8
. @ . @ . . . @ 
. . . . . . . . 
. . . . @ . . @ 
. . . . . . @ @ 
. . @ . . . . . 
. @ . . . . . @ 
. . @ . . . . . 
. . @ . . . . . 
7
4 1 6 6
2 1 6 7
2 3 4 0
3 3 0 3
5 4 4 6
7 1 3 3
7 4 7 1
