8 8
. . . @ @ . . . 
. . . . . . @ @ 
. . . . . . . . 
. . . . . . . @ 
. . . . . @ . . 
. . @ . . . . . 
. @ . . @ . . . 
@ . . . @ @ . . 
3
7 4 7 7
1 2 3 4
2 7 4 1
