8 8
. @ @ . . @ . . 
. . . . . . @ . 
. @ . @ . . . . 
. . . . @ . . @ 
. . . . . . . @ 
@ . . . . . . . 
. . . . . . . . 
@ . . . . . @ . 
1
5 4 7 1
