8 8
. . . . @ . . @ 
. . . . . . . . 
. . . . . . . @ 
. @ @ . . . . @ 
. . @ . @ @ . . 
. . . . . @ . . 
. . . . . . @ @ 
. . . . . . . . 
10
5 2 4 2
6 1 1 5
3 0 6 7
4 5 6 5
1 7 2 5
0 6 4 6
0 7 2 0
0 2 1 2
6 3 3 7
1 2 3 3
