8 8
@ . @ . . . . . 
. . . @ . . . . 
. . . @ . . . . 
. . . . . . . . 
. @ . @ . @ . . 
@ @ @ . . . . @ 
. . . . . @ . . 
. . . . . . . . 
3
6 4 0 7
5 7 5 2
2 6 1 1
