8 8
@ . @ . . . . . 
@ @ . . . . @ . 
. . . . @ . @ . 
. . . @ . . @ . 
. . @ . . . . . 
. . . . . . . . 
. . . @ . . . . 
. . @ . . . . . 
6
4 6 5 5
5 2 3 1
0 7 3 4
4 3 6 6
4 1 1 4
1 6 2 2
