8 8
. @ . . . @ @ . 
@ . . . . . @ . 
. @ @ . . . . . 
. . . . . . . . 
. . . . @ . . . 
@ @ . . . . . . 
. . @ . . . . @ 
. . . . . . . . 
1
6 6 6 3
