8 8
@ . . . . . . . 
. . @ . . . . . 
. @ @ . . . . . 
. @ . . . . . . 
@ . . . . . . . 
. . . . . @ . . 
@ . @ . @ . . . 
@ . . . . . . @ 
4
1 6 6 1
0 1 2 0
3 0 1 1
4 1 3 2
