8 8
. . . . . . . @ 
. @ . . . . @ . 
. . . @ . . @ . 
. . . @ . . @ . 
. . . . @ @ . . 
. . . . @ . . . 
. . . . . . . . 
@ @ . . . . . . 
2
2 5 4 7
4 3 1 3
