8 8
. . . . . . . . 
. . . . . . @ @ 
. . . . @ . . . 
. . . . @ . . @ 
@ . @ . . . . . 
@ @ . . . @ . . 
. . @ . . . . @ 
. . . . . . . . 
2
7 5 7 2
3 3 6 3
