8 8
. . . . . . @ . 
. . . . . . . . 
. . @ @ @ . . @ 
. @ . . . @ . . 
. . . . . . . . 
@ @ . @ . . . . 
. . . . @ . . . 
@ . . . . . . . 
10
3 6 4 0
0 4 4 3
5 5 7 5
3 0 5 7
2 4 2 7
6 4 1 0
5 7 7 1
2 0 2 6
3 1 1 6
4 4 0 1
