8 8
. . . . . . . . 
. . . . . . . . 
@ @ . . . @ . . 
@ @ . . . . . . 
@ @ . . . . . @ 
. . @ . . . . @ 
. . . . . . . . 
. . @ . @ . . . 
6
6 4 6 3
4 3 3 2
7 1 1 0
7 7 5 0
6 6 6 0
6 5 6 4
