8 8
. . . . . . . . 
. . . . @ @ . . 
@ . . . @ . . @ 
. . . . @ . . . 
. . @ @ . . @ . 
. . . . . . . . 
. . . . @ . . @ 
. . . @ . . . . 
9
6 5 1 0
1 1 2 2
6 2 4 7
7 3 6 3
0 4 7 3
7 7 7 1
7 5 0 5
0 7 6 7
0 3 7 4
