8 8
. . @ . . . . @ 
. . . . . . . . 
. . . . . . @ @ 
. @ . . @ . . . 
. @ . . . . . . 
@ . . @ @ @ . . 
. . . . . . . . 
. . . . . . @ . 
4
6 6 0 3
4 1 2 2
1 5 0 4
0 0 6 1
