8 8
@ . . . . @ . . 
. . . . . . @ . 
. @ . . . @ . . 
. . @ . . . . @ 
. . . . . . . . 
. . . @ @ . . . 
. . . . . @ . . 
@ . . . . . . @ 
10
5 4 5 4
0 4 3 1
7 2 5 1
5 5 5 3
6 7 1 3
3 2 0 4
4 6 4 3
7 0 1 1
7 1 4 7
4 3 7 6
