8 8
. . . @ . . . . 
. . . . . . . @ 
@ . . . . @ . . 
. . . . . @ @ . 
. . . . . . @ . 
. . . . . . . . 
. . @ . . @ . @ 
@ @ . . . . . . 
2
4 3 2 7
2 5 0 3
