8 8
. . @ . . . . @ 
. . . . . . . . 
. . @ @ . . . . 
. . . . . @ @ @ 
. . . . . . . . 
@ @ . . @ . . . 
. . . . . . . . 
. . . . . @ @ . 
5
7 1 6 4
1 2 1 7
1 4 2 6
3 7 0 4
4 2 5 5
