8 8
. . . @ . . . . 
. . . . @ . @ . 
. @ . @ @ . . . 
. . . . . . @ . 
. . . . . . . . 
. . . . . . @ . 
@ . @ . . . . . 
. . . @ . . @ . 
7
4 4 1 3
6 6 7 1
1 4 5 4
2 0 4 4
5 7 4 3
3 1 6 0
3 4 3 1
