8 8
. . . . . . . . 
. . . . . . . . 
. . @ . . . @ . 
. . @ . . . @ . 
. . . . . @ @ . 
. @ . . @ @ . @ 
. . . . . @ . . 
. . @ . . . . . 
8
7 3 1 1
2 0 4 3
2 1 5 2
3 3 3 7
4 0 7 4
4 3 0 7
6 5 1 4
3 5 1 7
