8 8
@ . . . @ . . . 
. @ . . @ . . @ 
. . . @ . . . . 
. . @ . . . . . 
. . . . . . . . 
. . . . @ @ . . 
@ . . . . . . @ 
. . . . . . @ . 
3
7 5 5 4
6 5 0 2
0 4 1 6
