8 8
. . @ . . . . . 
@ . . . . . . . 
. . . . @ . . . 
@ @ . . . . . . 
. . . . . . . @ 
. . . . . @ . . 
@ . . @ @ @ . . 
. . . . @ . . . 
4
0 7 6 7
1 7 3 1
6 0 5 3
5 0 3 2
