8 8
@ . . @ . . . . 
. . . . @ . . . 
. . . . . . @ . 
. . . . . @ . . 
@ @ . . . . . @ 
. @ . . . . . . 
. . . @ . . . . 
@ . . . . . @ . 
8
2 0 4 4
7 2 7 2
0 3 3 3
6 3 5 4
5 2 3 1
1 6 5 5
3 2 3 5
5 4 1 1
