8 8
@ . . @ . . . . 
. @ . . . . . . 
. . . . . @ . . 
@ . . . @ . . . 
. . . . . @ @ . 
@ . . . . . . . 
@ . . . . . . . 
. @ . . . @ . . 
10
6 1 7 3
2 0 5 5
4 4 6 6
3 6 7 0
5 5 3 1
6 7 4 7
3 7 5 6
4 7 6 2
7 6 2 7
6 0 5 0
