8 8
. . . . . . . . 
@ . . . @ . . . 
. . . . . . . . 
. . @ @ @ @ @ . 
. . . . . . @ . 
@ . @ . @ . @ . 
. . . . . . . . 
. . . . . . . . 
4
4 0 7 6
1 5 0 2
0 2 2 1
3 1 3 0
