8 8
. . @ . . @ . @ 
@ . . . . @ . . 
. . . . . . . @ 
. . . . @ . @ . 
. . . . . @ . . 
. . . . . . . . 
. . . . . . . @ 
. . . @ @ . . . 
7
1 2 4 5
4 4 3 2
2 6 0 2
1 5 6 6
4 1 1 0
6 6 0 6
0 7 0 7
