8 8
. . @ @ . . @ @ 
. . . . . @ . . 
. @ . . @ . . . 
. . . . @ . . . 
@ . . . . . . . 
. . . . @ . . . 
. . . @ . . . . 
. . . . . . . @ 
3
7 2 2 1
0 5 6 1
0 7 5 5
