8 8
. . . . . . . . 
. . . . . @ . . 
. @ . . . . . @ 
. @ . . . . . @ 
. @ . @ . . . . 
. @ . . @ . . . 
@ . . . . . . . 
. . @ . . . @ . 
5
3 2 6 5
0 0 7 1
6 2 4 3
4 0 2 1
7 6 6 6
