8 8
. . @ . . . . @ 
. . . . @ @ . . 
@ . . . . . . . 
. . . . . @ . @ 
@ . @ @ . . . @ 
. . . . . . . . 
. . . . @ . . . 
. . . . . . . . 
5
0 6 4 0
5 5 0 3
0 0 0 1
0 1 5 6
2 5 3 0
