8 8
. . @ . . . . . 
@ . . . . . . . 
. . . . . . . . 
. @ . . . . . @ 
. . . . . . . . 
@ @ . . . . . . 
. . @ . @ @ . . 
@ . . . @ . . @ 
10
5 4 4 5
7 1 4 3
2 3 0 0
5 7 3 7
1 2 3 6
3 5 3 0
5 5 2 7
2 7 5 3
0 2 2 2
6 1 4 2
