8 8
. . @ . . . . @ 
. . . . . . . . 
. . . @ . . @ . 
. @ . . @ . . . 
. @ . . . . . . 
@ . . . . . . . 
. @ @ . . . . . 
. . @ . . . @ . 
8
6 6 7 2
3 5 3 5
1 1 7 5
6 3 5 6
5 3 2 3
7 1 5 2
3 6 4 6
5 5 1 0
