8 8
. . @ @ . . @ . 
. . . . . @ . . 
@ . . . . . . . 
. . @ . . . . @ 
. . . . . . @ . 
. . . . . . @ @ 
. . . @ . . . . 
. . . @ . . . . 
3
2 1 2 4
4 5 5 6
3 5 0 1
