8 8
. . . . . . @ . 
. . . . . . @ . 
. . . @ @ . . . 
. . . . . @ . . 
@ @ . . . @ . . 
. . . . @ . . . 
. . . . . . @ . 
@ . . . . @ . . 
9
3 0 2 2
3 4 4 4
1 3 7 7
5 0 4 7
0 1 5 2
7 5 4 1
6 4 3 7
0 6 1 6
7 3 1 0
