8 8
. . . . @ . . @ 
. @ . . @ . . . 
. . . . . @ . @ 
. . . . @ @ . . 
. . . . . . . . 
. . . . . . . . 
. . . . @ . @ . 
. . . . @ . @ . 
6
2 6 0 7
7 3 2 7
5 5 7 5
0 3 5 4
0 4 2 3
0 0 6 3
