8 8
. @ @ . . . . . 
. . . . . . . . 
. . . . . . @ . 
. . . . . . . . 
. . @ @ . @ . . 
@ . . . @ . . @ 
@ . . . . . . . 
. @ @ . . . . . 
5
3 7 6 5
2 2 7 0
4 0 5 6
1 5 1 6
2 1 7 2
