8 8
. . . . . . @ . 
. . . . . . @ . 
@ . . . . @ . . 
. @ . . . . @ . 
. . . @ . . . . 
. . . . @ . . . 
@ . . . . . . . 
. @ @ . . . . @ 
7
0 5 1 0
4 4 6 2
6 6 3 5
2 0 2 4
5 0 1 4
7 1 2 2
0 4 3 0
