8 8
. @ . @ . @ . . 
@ . . . . . . . 
. @ . . . @ . . 
. . . . . . . . 
. . . . . . . @ 
. . . @ . . . @ 
@ . . . . . . . 
. @ . . . . @ . 
8
6 0 6 4
5 4 3 7
4 5 4 4
1 3 7 3
4 6 4 6
5 3 1 4
4 3 0 4
1 1 7 2
