8 8
@ @ . . . . . . 
. @ . . . . @ . 
. . . . . . . . 
. . . . . . . @ 
. . @ @ @ . . . 
. @ . . . . @ . 
@ . . . . . . . 
@ . . . . . . . 
10
0 2 6 0
4 6 4 3
1 7 6 6
2 1 1 3
6 2 0 2
0 5 5 1
3 1 7 1
7 4 4 0
3 2 0 3
4 1 2 6
