8 8
. . . . . @ . . 
@ . . @ . . . . 
. . . . . . . . 
. . . . . . . @ 
. . . . . . @ . 
. . . @ @ . . . 
. @ . . @ @ . . 
. . . . . @ . @ 
6
5 5 1 2
4 2 4 4
1 3 1 0
7 4 5 5
3 3 0 6
4 7 3 6
