8 8
. . . . . . . @ 
. . . . . . . @ 
. . . @ . . @ . 
. . . . @ . . . 
. . . @ . . . . 
. @ . . . . @ . 
@ . . . . . . @ 
. . . . @ . @ . 
1
2 5 4 5
