8 8
. . . . . . . . 
. . . . . . . . 
. . @ . . . @ . 
@ @ . @ . . . . 
. @ . . . . . . 
@ . . . @ @ . . 
. . @ . . . . . 
@ . @ . . . . . 
8
7 2 1 5
3 6 4 4
2 3 1 6
5 0 1 1
4 6 2 4
0 6 5 0
7 1 7 0
6 4 3 4
