8 8
. . . . @ @ . . 
. . @ . . . . . 
. . . . . . . . 
. . . @ . @ . @ 
@ . . . . @ . . 
. @ . . . . @ . 
@ . . . . . @ . 
. . . . . . . . 
10
3 1 6 7
0 2 3 6
1 7 5 2
7 5 0 2
0 1 3 2
0 7 5 6
2 5 3 5
3 5 3 4
6 4 1 7
3 7 4 7
