8 8
@ . . . . @ . @ 
. . . . @ @ . . 
. . . . . . . . 
. . @ . . . . . 
@ . . @ . . . @ 
. @ . @ . . . . 
. . . . . . . . 
. . . . . . @ . 
1
1 7 6 4
