8 8
. . @ @ . . . @ 
. . . @ . @ . . 
. . . . . . . . 
@ . . . . @ . . 
. @ @ . . . . @ 
. @ . . . . . . 
. . . . . . . . 
. . . . . . @ . 
2
7 6 1 2
4 2 7 6
