8 8
. . . . . . . . 
. @ . @ @ @ . . 
. . . . . . . . 
. @ . . . . . . 
. . @ . . @ . . 
@ . . . . . . . 
. . . . . @ . @ 
. . @ . . . . @ 
10
2 3 2 1
3 6 3 2
0 4 3 6
2 2 4 0
5 5 4 3
0 3 1 2
5 7 6 1
0 7 0 6
6 0 7 2
4 5 4 2
