8 8
. @ . . @ @ . . 
. . . . @ @ . . 
@ . . . . . . . 
. . . @ . . . . 
. . . . . . . . 
. @ . @ . . @ . 
. . . @ . . . . 
. . . @ . . . . 
4
1 7 7 7
5 2 6 2
5 5 6 3
0 4 7 1
