8 8
. . . . @ . . . 
. . . . @ . . @ 
@ @ . @ . . . . 
. . . . @ @ . . 
. . . . . . . . 
. . . . . . . @ 
@ . @ . . . . . 
. . . . @ . . . 
1
4 5 0 0
