8 8
. . . . . . . . 
@ @ . @ . . . . 
. . . . . @ @ @ 
. @ . . . . . . 
. . . . . . . @ 
. . . . . . . . 
@ @ . . . . . @ 
. . . . . . . @ 
4
4 0 4 5
7 0 4 6
2 4 7 3
6 0 1 7
