8 8
. . . . . . . . 
@ . . . @ . . @ 
. . . . @ . . . 
. . . . . . . . 
. . . . @ . . . 
. . . . . . @ . 
. . @ . @ . . @ 
. . @ @ . . . @ 
5
1 0 6 3
1 5 3 4
2 5 1 2
3 1 1 0
5 2 6 1
