8 8
. . . . @ @ . . 
. . . @ . . @ . 
. . . . . . . . 
. . @ . . . @ . 
. . . . . . . @ 
. . . . . . . @ 
@ . . . @ . . . 
. . . . @ . . @ 
2
7 3 6 7
4 1 1 2
