8 8
. . . . . . . . 
. . . . . . @ . 
. @ @ . . @ . . 
. . @ . . . . . 
@ . . . . . . . 
@ @ . . . . . . 
. . . . @ . . @ 
. . . . @ @ . . 
3
0 6 4 4
1 0 3 3
7 3 2 1
