8 8
. @ . . . . . . 
. . . . . . . . 
. . @ . . . . . 
. @ . . . @ . . 
. . . . . . . . 
@ . . . @ @ . @ 
. . . . . @ . . 
@ @ . . . @ . . 
3
1 4 6 5
3 0 1 6
4 1 7 1
