8 8
. . . . . @ . . 
. . . . . @ . @ 
. . . . . . . . 
. @ . @ . . . @ 
. . . . @ . . . 
. @ . @ . . . . 
. . @ . . . . . 
. . . . . . @ @ 
3
3 7 3 2
5 6 6 0
2 0 1 1
