8 8
. . . . . . . . 
. . . . . . . . 
. @ @ . . . @ . 
. @ @ . . . @ @ 
. . @ . . . . . 
. . @ . @ . . . 
. . . @ . . . . 
. . . . @ . . . 
10
4 4 5 4
5 4 1 5
6 6 0 1
0 6 2 1
5 5 3 3
4 2 7 5
5 7 4 0
1 5 4 3
0 2 5 1
1 1 4 4
