8 8
. . . . @ . . . 
. @ . . . . @ . 
@ . . . . . . . 
. . . . @ . . @ 
. . . @ @ @ . . 
. . . . . . . . 
. . @ . . . . . 
. @ . . . . @ . 
7
7 0 1 5
3 0 1 4
2 4 3 6
1 5 2 5
7 7 6 0
3 6 5 5
0 6 3 5
