8 8
. . @ @ . . @ . 
. @ . @ . . . . 
. . . . . @ . @ 
. . . . . . . . 
. . @ . . . . . 
. @ . . . @ . . 
. . . . . . @ . 
. . . . . . @ . 
6
7 4 7 3
3 6 4 4
4 0 1 4
1 0 5 4
4 3 3 3
0 0 6 2
