8 8
@ . . . . . . . 
. . @ . . . . . 
@ . @ . . . . . 
. . . . . . . . 
. . . . . . . . 
. . . . . @ . . 
. . @ @ @ @ @ @ 
. @ . . . . . . 
9
3 0 6 2
0 5 5 1
6 4 3 4
5 4 1 4
7 5 0 4
2 0 1 5
4 3 5 3
7 3 6 5
0 3 3 3
