8 8
. . . @ . . . . 
. @ . . . . . @ 
. . @ @ . . @ . 
. . @ . @ @ . . 
. . @ . . . . . 
. . . . . . . . 
. . . . @ . . . 
. . . . @ . . . 
10
1 6 3 6
3 5 5 4
1 5 3 4
6 6 4 2
0 0 5 5
1 7 7 6
0 1 6 5
3 4 0 2
0 6 3 3
3 6 0 5
