8 8
. . . @ . . . @ 
@ . @ @ @ . . . 
. . . . . . . . 
@ . . . . . @ . 
. . @ . . . . @ 
. . . . . . . . 
@ . . . . . . . 
. . . . . . @ . 
4
3 2 5 2
1 2 1 5
3 5 4 7
2 0 6 1
