8 8
. . . . . @ @ . 
. . . . . . @ . 
@ @ . . . . @ . 
. . . . . . @ . 
. . . . @ . @ . 
. . . . . . . . 
@ . @ . . . . . 
@ . . . . . . . 
1
5 7 1 0
