8 8
. . . @ . . . . 
. . . @ . . . @ 
. @ @ . . . . . 
. . . . . . . . 
. . . . . . . . 
. @ @ @ @ . . . 
. . . . . . . . 
@ . @ . . . . @ 
9
2 0 4 3
1 4 7 2
5 3 0 1
4 6 0 5
0 5 5 4
5 4 4 4
0 6 2 4
0 1 0 2
2 3 4 1
