8 8
. . . . @ @ . . 
@ . . . . @ . . 
. . . . . . . @ 
. . . @ . @ . . 
@ . . . . . . @ 
. . . . . . @ . 
. . @ . . . . . 
. . . . @ . . . 
6
5 7 1 1
1 3 0 6
2 3 6 6
3 4 2 5
0 6 5 4
3 5 2 2
