8 8
. . . . . . . . 
@ . . . . . @ . 
@ . . . . . . . 
@ . . . . @ . . 
. @ . . . . @ @ 
. . . . . . . . 
. . @ @ . . . @ 
@ . . . . . . . 
8
5 1 3 7
5 2 0 6
0 6 3 1
5 6 1 2
3 7 5 5
2 1 3 5
5 4 4 4
1 0 6 0
