8 8
@ . . . . . . . 
. . . @ . . @ . 
. . @ @ . . @ . 
. . . @ . . . . 
. . . . . . . . 
@ . . @ . . . . 
. . . . . . . . 
@ . . @ . . . @ 
7
7 2 7 1
5 1 4 2
4 1 7 5
7 5 2 6
6 7 6 0
4 5 5 0
7 0 0 1
