8 8
@ . . . . . . . 
@ @ . . @ . . . 
. . @ . . . . @ 
. . . . . . . @ 
. . . . . . . . 
. . @ @ . . . @ 
. . @ . . . . . 
. . . @ . . . . 
5
5 2 1 7
6 6 5 1
7 1 5 3
2 1 6 7
0 3 4 3
