8 8
. . . . . . . . 
. . . @ . . . . 
. @ . @ @ . . @ 
. . @ . . . . @ 
. . . . . . . . 
. @ . @ . . . . 
. . @ . . . . @ 
. . . . . . @ . 
1
5 6 7 4
