8 8
. . . . . . . . 
. . @ . . . . . 
. . @ . . . @ . 
. . . @ @ . . @ 
. @ . . . . . @ 
. . . . . @ . . 
. . . @ . . . @ 
. . @ . . . . . 
10
3 7 6 6
6 5 4 1
4 1 1 6
4 0 1 7
7 7 5 2
1 0 7 1
6 0 3 1
1 5 0 3
2 4 1 0
3 4 4 7
