8 8
. . @ . . . . . 
. . . . . . . @ 
. . . @ @ . @ . 
. . . . @ . . . 
@ . . @ . . . . 
. . . . . @ . . 
@ . . . . . @ . 
. . . @ . . . . 
10
5 2 6 7
1 1 0 1
2 7 4 7
3 6 4 0
6 3 1 7
0 0 4 4
7 2 2 1
1 2 2 6
7 7 3 0
1 3 6 1
