8 8
. . . . . @ @ . 
. . . @ @ . . . 
. . . @ @ @ . . 
@ . . . . . @ . 
. . . @ . . . . 
. . . . . . @ . 
. . . . . @ . . 
. . . . . . . . 
7
1 1 7 7
3 6 2 2
3 5 2 3
7 3 2 6
7 1 2 4
5 7 6 1
1 0 3 0
