8 8
. @ . . . . . . 
@ . . @ @ . . . 
. . . . @ . . . 
. . . . . . . . 
. @ . . . . @ @ 
. . . . . . . . 
. . @ . . @ @ . 
. @ . . . . . . 
3
0 4 4 7
5 0 1 1
6 3 3 4
