8 8
. . . @ . @ . @ 
. . . . . . . . 
. . . . @ . . . 
. . . . @ . @ . 
. . @ . . . . @ 
. . . . . @ @ . 
. . . . @ @ . . 
. . . . . . . . 
1
7 7 6 0
