8 8
. . @ . . @ . @ 
@ . . . . . @ . 
@ . @ @ . . . . 
. . . . . . . . 
. . . . . . . . 
. . . . @ . @ @ 
. . . . . . . . 
@ . . . . . . . 
6
3 3 4 2
5 7 4 1
4 0 5 5
2 4 5 6
1 0 7 7
3 7 1 0
