8 8
. . . . @ . . . 
. . . . . . . . 
. @ . . . . . @ 
. . @ . . . . . 
@ @ . . . . . . 
. @ . @ @ . . . 
. . . . . . . . 
. . @ @ . . @ . 
1
6 1 2 1
