8 8
@ . . . @ . . . 
. . . . . @ . . 
. . . . . @ . . 
. . . @ . . @ . 
. . . . . . . @ 
. . . . . . . . 
@ . . . . @ @ @ 
@ . . . . . . . 
3
0 2 2 2
2 1 4 1
1 6 3 4
