8 8
@ . . . . . @ . 
. @ . @ . . . . 
@ @ . . . @ . . 
. . . . . . . . 
. . . . . . . @ 
. . . . . . @ . 
@ . . . @ . . . 
. . @ . . . . . 
7
3 7 4 5
3 6 4 3
2 0 4 0
3 5 1 5
5 7 7 6
5 0 6 3
5 4 6 6
