8 8
. . @ @ . . . . 
. . . . . @ . . 
. . . @ . @ . . 
. . . . . @ . @ 
. . . . . . @ @ 
@ . . . . . . @ 
. . @ . . . . . 
. . . . . . . . 
3
7 6 1 1
5 4 1 5
0 4 1 3
