8 8
@ . . . . @ . @ 
@ . . . . . . . 
. . . . . . . . 
@ @ . @ . . . . 
. . @ @ . . . . 
. . . . . . . . 
. . . @ @ . . . 
. . . . . @ . . 
9
2 6 6 7
6 5 5 6
1 4 0 6
3 5 7 4
1 5 0 5
3 2 6 6
6 1 6 0
7 6 6 1
4 0 3 1
