8 8
. @ @ . . . . . 
. . . . . . @ . 
. . @ . . @ . . 
. @ @ @ . . . . 
. . . . . . . @ 
. . . . . . . . 
. . @ @ . . . . 
. . . @ . . . . 
7
5 4 2 7
7 2 3 1
0 4 2 4
0 3 1 2
4 4 0 0
6 2 5 1
0 1 5 3
