8 8
. @ @ . @ . . . 
. @ . . . @ . . 
. . . . @ . . . 
@ . . . . . . . 
. . @ @ @ . @ . 
. . . . . . . . 
. . . @ . . . . 
. . . . . . . . 
8
3 7 2 2
4 3 5 3
2 3 5 6
3 3 4 1
2 7 1 7
6 1 2 3
1 5 3 3
6 6 7 7
