8 8
. . . . @ . . . 
. @ . . @ . . @ 
. . . . . . . . 
. . @ . . . . . 
. . @ @ @ . . . 
. . . . . . @ . 
. . @ . . . @ . 
. . . . . . . @ 
2
5 0 6 0
6 0 5 5
