8 8
. . . @ . @ . . 
. . . . @ . . . 
. . . . . . @ . 
. . @ . . . . . 
. . . . . . . . 
@ . . . . . . @ 
@ . @ . . @ @ . 
. . . . @ . . . 
5
3 4 6 4
6 0 2 2
0 0 5 1
3 7 3 5
6 4 7 2
