8 8
@ . . . . . . . 
@ . @ . . . . . 
. . . . @ . . . 
@ @ @ . . . . . 
. . . . @ . . . 
. . @ . . . . . 
. . @ . . . . @ 
. @ . . . . . . 
2
2 0 2 0
1 2 6 2
