8 8
@ . @ . . . . . 
@ . . . . . . . 
. . . . . . . . 
. . . . . . @ . 
. . . . . . . . 
. @ @ . @ . @ . 
. . . . . . . @ 
@ . . . . @ . @ 
7
3 0 0 6
1 2 6 6
6 2 4 3
4 6 1 0
1 7 1 6
7 4 3 2
4 4 1 2
