8 8
. @ . . . . . . 
@ . . . . . . . 
. @ . . @ @ . @ 
. . . @ @ @ . . 
@ . . . . . . @ 
. . . . . . . . 
. . . . . . . . 
. . . @ . . . . 
8
6 5 7 6
7 0 0 5
5 4 7 5
3 1 1 7
2 3 3 1
5 1 5 7
5 0 0 2
2 1 3 6
