8 8
. @ . . . @ . @ 
. . . . . @ . . 
. . . . . @ . . 
@ . . . . . . @ 
. @ . @ @ . . . 
@ . . . . @ . . 
. . . . . . . . 
. . . . . . . . 
9
0 7 2 3
5 6 4 7
3 3 2 6
4 3 6 1
6 2 2 7
2 1 6 7
2 3 4 0
7 2 4 3
2 2 4 6
