8 8
. . . . . . . . 
. . . . . . . @ 
. . . . . @ @ . 
@ @ . @ . . . . 
. @ @ . . . . @ 
. . . . . . . . 
. @ @ . . . @ . 
. . . . . . . . 
3
3 5 0 1
3 2 3 7
4 0 5 6
