8 8
. . . . . . . . 
. . . @ . @ . . 
. . @ . . . . . 
. @ . . . @ . . 
@ . . . . . . @ 
. . . . @ . . . 
@ . . . . @ . . 
. . . . @ @ . . 
5
4 4 0 7
6 0 4 2
6 4 1 1
3 7 0 3
7 7 6 5
