8 8
. . @ . . . . . 
. . . @ . . . . 
@ @ . . @ . @ . 
. . . . . @ . @ 
. @ . . . . . . 
. . . @ . . . . 
. . . . @ . . . 
. . . . . . @ . 
6
4 1 4 1
6 3 2 5
5 7 0 4
7 7 2 3
7 4 0 5
1 7 6 5
