8 8
. . @ @ . . @ . 
. @ . . . . . @ 
. @ . . @ . . . 
. . . . . . . . 
. . . . . . . @ 
. . . . . . . . 
. . @ @ . @ . . 
@ . . . . . . . 
7
6 7 2 5
4 3 0 5
0 1 4 5
1 6 3 4
0 6 7 3
2 5 0 0
6 4 3 5
