8 8
. . . . @ @ . . 
. . . . . . . . 
. . . . . . . . 
. @ . . . . . @ 
. @ . . . @ . . 
. . . @ . . . . 
@ . @ . @ . . . 
. . @ . . @ . . 
1
7 2 7 6
