8 8
. . . . @ . @ . 
. . . . . . . . 
. . . . . . @ . 
@ . . . . . . . 
. . . . . . . . 
. . . . . . @ @ 
. @ . @ . @ . . 
. . . @ . @ . @ 
8
2 1 1 3
2 5 5 1
7 2 7 3
4 5 2 0
3 3 5 5
7 4 3 3
5 2 1 2
2 4 3 0
