8 8
. @ . . @ . . . 
. . . @ . . . @ 
. @ . . @ @ . . 
. . . . @ . . @ 
. . . @ . . @ . 
. . . . . . . . 
. . . . . . . . 
. . . . . @ . . 
4
2 0 5 5
3 0 2 5
1 3 2 4
3 6 2 7
