8 8
. . . . . . . . 
@ . @ . . . @ . 
. . . . @ . . . 
. . . . . @ @ . 
. . . @ . @ . . 
. . . . . . @ @ 
. . . @ . . @ . 
. . . . . . . . 
4
4 1 3 0
7 1 2 2
5 1 7 3
5 7 3 2
