8 8
. @ . . . . . . 
. . . @ . . . . 
. . . . . . . . 
. . . @ . . @ . 
. . . . . @ . . 
. . . . . @ . @ 
. . @ . . . . @ 
. @ . . @ @ . . 
6
2 4 1 6
2 3 4 2
3 5 3 4
5 3 7 3
0 6 7 1
1 5 6 4
