8 8
. @ @ @ . @ . . 
. . @ . @ . . @ 
. . . . . . . . 
. . . @ . . . . 
. . . . . . @ . 
. . . . . . . . 
. . . . @ . . @ 
. . . . @ . . . 
10
0 7 6 6
6 0 1 2
0 5 4 2
1 2 0 3
6 3 7 4
4 3 3 6
1 6 4 4
3 5 6 1
2 6 5 3
5 5 5 2
