8 8
@ . . . @ @ . . 
. . . . . . . . 
. . . . @ . . @ 
@ @ . . . @ . . 
. . @ . . . . . 
. . . @ . . . . 
@ . . . . . @ . 
. . . . . . . . 
7
2 7 0 7
5 4 1 7
1 1 4 3
7 7 4 1
1 2 7 0
7 1 1 4
3 3 4 7
