8 8
. . . . . . @ . 
. . @ . . . . . 
@ . . . . . . . 
. . . . . . . . 
@ . . @ @ . . . 
. . @ . . . @ . 
. . @ . . . @ . 
. . . . @ . @ . 
2
1 7 1 0
0 3 4 3
