8 8
. . . @ @ . . . 
. . . . . . . @ 
@ . @ . . . . . 
@ @ @ . . . . . 
. . @ . . . . . 
. . . . @ . . . 
@ . . . . . . . 
. . . . @ . . . 
3
1 0 2 0
3 5 6 0
3 4 1 4
