8 8
@ . . . . . . . 
. . @ . . @ . @ 
. . @ . @ . . . 
. . . @ @ @ . . 
. . @ . . . . . 
. . . . @ . . . 
. . . . . . . . 
. . . @ . . . . 
7
0 5 5 2
6 5 2 7
5 7 6 1
5 2 1 6
7 5 6 0
0 3 7 2
4 0 7 5
