8 8
. . . . @ . @ . 
. . . @ . . . @ 
. . . . @ . @ . 
. . @ . . . . . 
@ . . . . @ . . 
. . . . . . . . 
. . . . . . @ . 
. . . @ @ . . . 
6
7 4 2 6
0 3 5 6
1 2 7 7
6 3 3 5
2 6 3 2
5 1 2 0
