8 8
. . . . . . . . 
. @ . . . @ @ . 
@ . . . . @ . . 
@ . @ . . . . . 
. . . . . . . . 
. . . . . . . . 
@ @ . . . . . . 
@ @ . . @ . . . 
7
7 7 2 2
4 2 1 5
0 0 0 4
2 5 5 4
6 5 6 4
2 2 6 7
3 6 5 6
