8 8
@ . . . . . . . 
. . @ @ . @ . . 
. . . . . . . @ 
. . . . . . . @ 
. . . . . @ . @ 
. @ @ . . . . . 
. . . . @ . @ . 
. . . . . . . . 
6
0 2 6 2
1 4 5 5
2 2 1 6
4 7 7 0
5 0 5 2
1 7 1 4
