8 8
. . . . . . . . 
@ . . . . . . . 
. . . . @ . @ . 
. . . . . @ @ . 
. . . . . . . @ 
@ . . . @ . . . 
@ . @ . . . . . 
@ . . . @ . . . 
5
0 0 4 3
2 5 2 5
4 1 3 3
1 4 1 1
2 1 3 7
