8 8
. . . @ . . . @ 
. . . . . . @ @ 
. . . . . . . . 
. . . . . . . . 
. . . . . @ . . 
. . . @ . . . . 
. @ . . . @ . . 
@ @ . @ . . @ . 
9
4 6 0 5
2 1 3 4
6 0 3 2
6 2 7 6
7 3 5 1
6 5 7 2
7 6 2 0
6 3 2 1
7 4 6 3
