8 8
. . . . @ . . . 
. @ . . @ . @ . 
. . . . . . . . 
. . . . @ . . . 
@ . . . @ . . . 
@ @ . . . . . . 
. . . . @ . @ . 
. . . . . @ . . 
4
6 7 5 4
1 2 1 6
0 2 0 3
1 6 2 0
