8 8
@ . . . @ . . . 
. . . . . . . . 
. . . @ . . @ . 
. . . @ . . . . 
@ . @ . . @ . . 
. . . . @ . . . 
. . . . . @ . . 
@ . . @ . . . . 
2
1 3 1 2
7 3 4 7
