8 8
. . @ . . . . @ 
. @ . . . . @ . 
. . . @ . . . @ 
. . . . . . . . 
. . . . . . . . 
@ . . . @ . . @ 
. . . @ . . . @ 
. @ . . . . . . 
2
0 1 2 3
6 5 0 6
