8 8
. . @ . . . . . 
. . . @ . . . . 
. @ . . . . . . 
. @ @ . . . . . 
. . @ . @ @ . . 
. . . . . . . . 
. @ . . . . . . 
@ . @ . @ . . . 
10
6 3 5 7
4 6 0 0
6 5 6 3
5 0 1 4
7 6 6 2
3 5 2 5
0 3 0 3
1 5 5 1
1 1 4 1
5 2 4 0
