8 8
. @ @ . . . . . 
@ . . . @ . . . 
. . @ . . . . . 
. . . . @ @ . . 
. . . @ . . . . 
. . . . . . . . 
. @ . . . . . . 
. @ @ . @ . . . 
3
3 5 7 5
4 2 1 3
4 5 5 1
