8 8
. . . . . . . @ 
. @ . @ . @ @ . 
. @ . @ . . . . 
@ . . . . . . . 
. . . . . . . . 
. . . . . . . @ 
. @ . . . . . . 
. . . . . . @ @ 
6
2 5 1 0
3 0 6 6
1 7 3 7
0 0 4 4
1 0 3 3
4 6 4 0
