8 8
. . . . . . @ @ 
. . . . . . . @ 
. . . . @ . . . 
. @ . . . . . . 
. . . . . . . . 
. . @ . . . . . 
. . . @ . . @ @ 
. @ . @ @ . . . 
8
0 2 4 1
1 2 5 3
4 5 3 4
2 6 6 5
7 5 2 3
0 1 1 4
3 0 5 0
4 1 1 5
