8 8
. . . @ . . . @ 
. . . . . @ . . 
. . . @ . . . . 
@ . . @ . . @ . 
. @ . . @ . . . 
. . . . . . . @ 
. . . . . . . . 
@ . . . @ . . . 
2
5 7 3 4
2 6 6 0
