8 8
@ . @ . . . @ . 
. @ . . . . . . 
. . . . . . . @ 
. . . @ . . . . 
. . . . @ . . . 
. . . @ . . . . 
@ . . . @ @ . . 
. . . . . . . @ 
9
2 5 3 7
1 5 3 6
6 2 4 2
5 7 7 1
1 4 4 0
5 0 0 4
5 2 6 2
4 0 1 5
0 7 2 1
