8 8
. . . . . . @ . 
. . . . . @ @ . 
. @ . . . . . . 
. . . . @ . @ . 
@ . . . . . . . 
. . . . @ . . . 
@ . @ . . . . . 
. . . @ . . @ . 
4
1 5 5 3
0 5 3 5
4 4 5 5
6 6 3 6
