8 8
. . . @ . . . . 
. . . . . . . . 
. @ . . @ . . . 
. . . @ @ . . @ 
. . . . @ . @ . 
. . . . . @ . . 
. @ . . . . . . 
@ . @ . . . . . 
9
2 4 2 5
0 2 6 2
5 3 6 1
6 1 3 7
4 7 2 6
0 0 1 4
0 4 3 6
1 1 0 3
2 1 4 1
