8 8
@ . @ @ . . . . 
. . @ . . . . . 
. . . . . . . . 
. @ . @ . . . . 
. . . . . . . . 
. . . . . . @ . 
@ @ . @ . . . . 
. @ . . . . . @ 
6
7 6 2 2
4 3 0 5
1 5 7 5
6 7 1 0
3 2 7 6
5 7 7 3
