8 8
. @ . . . @ . . 
. @ . @ . . . . 
. . . . . . @ . 
. . . . . . . . 
. . @ . @ . . . 
. @ @ . . . . . 
. . . @ @ . . . 
. . . . . . . @ 
2
6 0 1 2
5 5 2 3
