8 8
. . . . . . . . 
. @ . @ @ @ . . 
. @ @ . . . . . 
. . . . . @ . @ 
. @ . . . . . . 
. . . . . . @ . 
. . . . . . . . 
. @ . @ . . . . 
4
5 4 2 0
7 7 7 1
0 0 0 7
2 6 7 0
