8 8
. . . . . @ . . 
. @ @ @ . . . . 
. . @ . . . @ . 
@ . . . . . @ . 
. . . @ . . . . 
. . . . @ . . . 
. . . . . @ . . 
. . . . @ . . . 
8
3 3 7 7
1 6 5 1
0 4 5 4
7 5 2 0
7 4 5 7
1 7 7 0
6 0 1 3
5 4 7 5
