8 8
@ . . . . . @ . 
. . . @ . . . . 
. @ . @ . . . . 
. . . @ . . . . 
@ . . . . . @ @ 
. . . . . @ . . 
. . @ . . . . . 
. @ . . . . . . 
4
0 7 0 1
7 7 2 5
2 1 0 5
7 6 3 5
