8 8
@ . . . . . . @ 
. . . . . . . . 
@ . @ . . . . . 
@ . . . . . . . 
. . . . . . @ . 
. . @ . . . . . 
. . @ . . . . @ 
@ . @ @ . . . . 
8
7 5 1 1
0 4 6 1
1 0 1 4
4 6 4 1
6 1 0 1
4 3 7 5
7 2 3 5
4 2 2 4
