8 8
. . . @ . . . . 
. . . . . . . . 
. @ . . . @ . . 
@ . . . . . . . 
. . . . . . @ @ 
. . . . . . . . 
@ . . . @ . @ . 
@ @ . . @ . . . 
8
3 5 0 1
6 3 7 2
2 4 5 4
1 5 6 3
4 1 4 1
3 7 7 0
4 2 1 4
1 0 5 6
