8 8
. @ . @ . @ . . 
@ . @ . . . . . 
. . . . . . . . 
@ . . . . . . . 
@ . @ . . . . . 
@ . . . . . . . 
. . . . . @ @ . 
. . . . @ . . . 
4
5 7 5 4
4 4 4 4
0 2 2 5
1 1 6 1
