8 8
. . . . . @ . . 
@ @ @ . . @ . . 
. . . . . . . . 
@ @ . . . . . . 
. . . . . . . . 
. . . . @ . . . 
. . . . @ . @ . 
. @ . . . . @ . 
2
3 2 5 5
1 0 1 2
