8 8
. . . . . . . . 
. . . . @ . . @ 
@ . . . . . . . 
. @ . . . . @ . 
@ . . @ . . . . 
. . . @ . . . . 
. @ . . . . . @ 
@ . @ . . . . . 
7
4 0 3 1
5 5 1 5
7 3 4 6
4 3 2 6
7 5 2 5
1 2 7 0
5 0 7 5
