8 8
. . . . . @ . . 
@ . . . . . . . 
. @ . . . . . @ 
@ . . . @ . . . 
. . . . . . . . 
. . @ @ . . . . 
. . @ . . . . . 
@ @ . . @ . . . 
5
4 4 1 4
3 3 3 3
2 3 6 4
6 4 4 6
4 5 6 1
