8 8
. . . . . . . . 
@ . . . . . . . 
@ . . . . . . . 
. @ . . . . . . 
@ . . . . . . @ 
. . . . . . . @ 
. . @ . . . @ @ 
@ @ . @ . . . . 
2
5 7 3 1
5 5 4 4
