8 8
. . . @ @ . . . 
. . . . . . . @ 
@ . @ . . . . . 
. . . . . . . . 
. . . . @ . . . 
@ . . . . . . . 
@ . . . . @ @ . 
. . @ . . @ . . 
5
7 6 7 2
2 6 4 3
2 0 7 5
1 7 7 4
0 1 4 5
