8 8
. . . @ . . . . 
. . . . . . @ . 
. . . . . @ . @ 
@ . @ . . . . . 
@ . . . . . . . 
@ . . . . . . . 
. . . @ . . . @ 
. . . . @ @ . . 
3
4 5 7 1
3 2 0 6
7 4 1 6
