8 8
@ . @ . @ . @ . 
. @ . . . . . . 
. . . @ . @ . . 
. . . . . . @ . 
. . . @ . . . . 
@ . . . . . . @ 
. . . . . . . . 
. . . . . @ . . 
8
4 3 1 6
3 3 5 4
1 3 7 1
6 5 6 6
6 6 5 6
0 1 0 2
4 6 7 0
1 7 7 2
