8 8
@ . @ @ @ @ . . 
@ . . . . . . . 
. . . @ . . . . 
. . . . . @ . . 
. @ . . @ . . . 
@ . . . . . . . 
. . @ . . . . . 
. . . . . . . . 
3
6 4 4 1
1 7 3 4
5 6 5 4
