8 8
. . . . . . . @ 
. @ . . . . . . 
. . . . . . . @ 
. @ . @ @ . . . 
. . . . . . . . 
. . . @ . . @ . 
@ . . . @ @ @ . 
. . . . . . . . 
9
7 3 3 4
0 1 4 0
3 7 4 1
7 6 2 6
6 4 5 2
1 2 3 1
0 3 0 3
4 4 6 2
0 5 1 6
