8 8
. . . . . . . . 
@ @ . @ . . . @ 
. . . . . . . . 
. . . . . . . . 
. . @ . @ @ . . 
. . . . . . @ . 
. . @ . . . . @ 
. @ . . . . @ . 
4
7 4 3 2
2 3 0 0
1 4 7 3
4 3 5 1
