8 8
. . . . . @ . . 
@ . . @ . . . . 
. . . @ @ . . . 
. . . . . . . . 
. @ . . . . @ . 
@ . . . . . . . 
. . @ . . . . . 
@ . . @ . . @ . 
8
5 4 3 0
7 4 3 6
5 6 0 4
5 3 7 3
2 2 1 2
4 6 1 5
5 5 2 3
3 3 5 3
