8 8
. . . . @ . . . 
. . . @ . . . @ 
@ . . . . @ . . 
. . . @ . @ . . 
@ . . . . . . @ 
. . . . . . . . 
. @ . @ . @ . . 
. . . . . . . . 
2
7 0 5 0
2 2 3 4
