8 8
. . . . . . . . 
. @ . . @ @ . . 
@ . @ . . . . @ 
. . . @ @ . . . 
. . . . . . @ . 
@ . . . . . . @ 
. . . . . . @ . 
. . . . . . . . 
9
0 1 7 6
6 1 0 6
0 4 6 2
5 3 3 2
1 5 4 0
5 5 5 6
1 7 7 0
1 6 1 0
5 0 4 7
