8 8
@ . . . @ . . . 
. @ . @ . . . @ 
. . . . . . . . 
. . . . . @ . . 
. . @ . @ . . . 
. . . . . . . . 
. . . . @ . . . 
. . @ @ . . . @ 
4
3 6 5 6
7 4 1 7
0 5 2 5
5 4 7 2
