8 8
. . . . . . . . 
. . . . . . . . 
@ . . . @ . . . 
. . . . . . . . 
. . . . @ . . . 
@ . . . @ . @ . 
. . . @ . @ . . 
. @ @ @ . @ . . 
3
2 4 2 4
7 7 2 3
1 0 6 7
