8 8
. . . . . . . . 
. @ @ . . . @ @ 
. . @ . @ . . @ 
. . . . . . . . 
. . . . . . . . 
. @ . . . @ . . 
. . . . . . . . 
@ . . @ @ . . . 
2
0 0 3 6
6 2 0 4
