8 8
. . @ @ @ @ . @ 
@ . . . . . . . 
. . . . @ . . @ 
. . . . . . . . 
. @ . . . . . @ 
. . . . . . . . 
. . . . . . . . 
. . . . @ . . @ 
1
2 5 7 1
