8 8
@ . @ . . . @ . 
@ . . . . . @ . 
. . . @ . . . . 
@ . . . . . . . 
. . . . . @ . . 
. . @ . @ . . . 
. . . . . . . . 
@ . @ . . . . . 
1
3 1 3 4
