8 8
. . . . . @ . . 
. . . . . . @ . 
@ . . @ . . . @ 
. . . . . . . . 
. . . . . . @ . 
. . . . . . . @ 
. . . @ . . . @ 
@ @ . @ . . . . 
4
4 2 5 1
2 0 4 6
5 4 4 7
4 6 4 2
