8 8
. @ . @ . . . . 
. . . . . @ . . 
. . . . @ . . @ 
. . . . . . . @ 
@ @ . . . . . . 
. . . . @ . . . 
@ . @ @ . . . . 
. . . . . . . . 
7
4 7 4 0
7 1 1 5
3 2 3 5
6 3 6 0
2 2 2 7
1 2 7 0
2 3 0 0
