8 8
. @ . . . @ @ . 
. . @ . . @ . . 
. . . @ . @ @ . 
. @ . . . . . . 
. @ . . . . . . 
. . . @ @ . . . 
. . . . . . . . 
. . . . . . . . 
3
7 1 1 1
4 7 0 6
7 2 4 4
