8 8
. . . . . . . . 
. @ @ . . @ . @ 
. . . . . . . . 
. . . . . . . @ 
. . . . . . . . 
. @ . @ @ . . . 
. . . @ . . . . 
. @ @ @ . . . . 
9
7 4 5 0
7 6 6 5
5 3 4 7
4 7 5 5
1 0 5 4
7 2 5 2
0 1 1 0
5 5 2 4
6 6 5 3
