8 8
. . . . . . . . 
. . @ . . . . . 
. @ . . @ . . @ 
@ . . . . @ . . 
. . @ @ . . . . 
@ . @ . . . . . 
. . . . . @ . . 
. . @ . . . . . 
6
6 5 1 4
1 4 2 6
0 4 7 3
4 6 5 5
2 6 3 2
4 7 1 1
