8 8
@ . . . . . . . 
. . . . . . . . 
@ . . . . @ . . 
@ . . . @ . . . 
. . . @ . . . . 
. @ . @ . . . . 
. . . . . . @ @ 
. @ . @ . . . . 
4
5 7 2 7
0 4 7 3
1 6 7 7
4 6 7 2
