8 8
. . . @ . . . @ 
. . . @ @ . . . 
. . . @ . . @ . 
. . . . . . . . 
. . . . . . . . 
. . . . @ . . . 
. . . . @ @ . @ 
. @ . . . . . @ 
4
5 4 2 4
0 4 2 5
6 4 3 4
0 1 2 0
