8 8
. @ . @ . . . . 
. . @ . @ @ . . 
. . . . . . . . 
. . @ . @ . . . 
. . . . . . @ . 
. . . . . @ . . 
. . . . . . @ @ 
. . @ . . . . . 
4
2 4 1 7
1 6 1 6
5 4 1 2
0 4 7 2
