8 8
. . . @ @ . . . 
@ . . . . . . . 
. . @ @ . . . @ 
. . . . . . @ @ 
. . . . @ . . . 
. . @ . . . . @ 
. . . . . . . . 
. . . . . @ . . 
4
3 6 5 5
5 0 5 4
6 0 5 3
2 6 4 2
