8 8
. . . @ . . . . 
. . . . . . . . 
. . @ . . . @ . 
. @ . . . . . . 
. . . . . . . . 
@ . . . . . . @ 
. . @ . @ . . . 
. @ . . . @ @ @ 
4
2 1 7 6
6 4 7 0
5 2 4 1
0 3 6 3
