8 8
@ . . . @ . . . 
. . @ . @ . . . 
. @ . . @ . @ . 
. @ . . @ . . . 
. . @ . . . . . 
. . . . . . . . 
. . . @ . . . . 
. . . . @ . . . 
9
4 6 3 5
1 1 6 0
5 3 5 3
2 7 5 2
7 1 6 1
0 2 2 6
0 5 2 3
7 5 0 2
0 1 7 1
