8 8
. @ . . . . @ . 
. . . . . . . . 
@ . . . . . . . 
. . . . . . . @ 
. . . @ . . . . 
. @ . . . . @ . 
. . . @ . @ . @ 
. . . @ @ . . . 
8
2 6 3 0
3 2 0 7
5 5 0 6
1 4 2 6
0 6 3 2
5 0 2 7
2 7 4 4
3 3 1 2
