8 8
. . . . . . . . 
. . . . @ . . @ 
. . . . @ . . . 
. . . . . . . . 
. @ . . @ . @ . 
@ . . . @ . . . 
. @ @ . . . . . 
. . . @ . . . @ 
2
5 3 3 6
5 6 0 0
