8 8
. . . . . . . @ 
@ . . . @ . . . 
. . . . . . . . 
. . . . . . . @ 
. . @ . @ . . . 
. . @ . @ @ . . 
. . @ . . @ . . 
@ . . . . . . . 
7
4 0 4 6
3 1 1 1
2 3 0 4
7 1 5 7
1 1 6 6
6 6 3 6
7 4 3 2
