8 8
. @ . . . . . . 
. @ @ . . . . @ 
@ . . . . . . . 
. . . . . . . @ 
. @ . . . . . @ 
. . . . . @ . . 
@ . . @ . . @ . 
. . . . . . . . 
7
4 0 7 6
2 6 6 4
6 5 5 0
3 0 2 5
7 2 4 0
3 3 1 5
5 4 2 4
