8 8
. . . . . . @ . 
. . . . @ . . . 
. . @ @ . @ . . 
. . . . . . @ @ 
. . @ . . . . . 
. @ @ . . . . . 
. . . . . . . . 
. . @ . . @ . . 
6
2 0 4 2
7 2 4 4
0 1 0 4
3 4 7 7
4 0 7 2
0 6 4 5
