8 8
. . . @ . . @ . 
. . . . . . . . 
. . . @ . @ @ @ 
@ . . . @ . . . 
. . . . . . . . 
. . . . @ . . . 
. . . @ . . @ . 
. . . @ . . . . 
6
7 4 5 6
1 2 5 3
6 5 7 4
2 6 2 0
2 7 0 4
7 5 2 6
