8 8
. . . . . . . . 
. @ @ . . . . . 
. . . @ . . . @ 
. . . . . . @ . 
. . . . @ @ @ . 
. . . . . . . . 
@ . . @ . . . @ 
. . . @ . . . . 
5
4 7 0 2
2 2 2 2
4 0 0 5
1 7 5 1
5 2 5 2
