8 8
. @ . . . . . . 
@ . . @ . . . . 
. . . @ @ @ . . 
. . . @ @ . . . 
. . . . . . . . 
. . . . @ . . @ 
. . . . . . . @ 
. . . . . . @ . 
2
5 0 7 3
0 5 6 3
