8 8
. . . . . . . . 
@ . @ . . @ . . 
. . @ . @ @ . . 
. . . . . . @ . 
. . . . . . . @ 
@ . . . . . . . 
. . . . @ . @ . 
@ . . . . . . . 
1
3 3 6 0
