8 8
. . . . . @ . . 
. . . . . @ . @ 
@ . @ . . @ @ . 
. . . . . . . . 
. . . . @ . . . 
@ @ . . @ . . . 
. . . @ . . . . 
. . . . . . . . 
9
7 3 4 1
3 0 3 0
0 6 0 6
3 4 3 2
3 2 6 5
2 0 6 6
0 3 3 4
2 5 4 3
7 5 5 3
