8 8
. . . . . . . . 
. . @ . @ . @ . 
. . . . . . @ . 
. @ @ @ . . . . 
. . . . . . . . 
. @ . . . . . . 
. . . . . . . @ 
. . . @ @ @ . . 
7
0 0 6 7
0 4 4 0
6 5 2 6
0 5 5 2
0 1 6 0
3 5 7 2
7 3 4 2
