8 8
. @ . @ . @ . . 
. . . @ . . . . 
. . @ . @ . . . 
. . @ . . . @ . 
. . . . . . . @ 
. . . . . . @ . 
. . . . . . . . 
. . @ . . @ . . 
2
3 7 4 6
1 1 3 2
