8 8
. . . . . . . . 
. . . @ @ . . @ 
. @ . . . . . . 
@ . . . . . . . 
. . @ . . . . . 
. . . @ . . . @ 
. . @ . . @ . . 
. . @ . @ . . . 
10
5 1 7 6
6 1 0 1
1 1 6 0
0 4 4 4
4 3 5 1
5 3 5 5
0 1 6 1
7 2 0 5
0 7 7 7
2 2 5 7
