8 8
. @ . . . @ . . 
. . @ . . . . @ 
. . . . @ . . . 
. . . . @ . @ . 
. @ . . . . @ . 
. . . . @ . . . 
. . . @ . . . . 
. . . . . . @ . 
8
0 6 0 5
2 6 1 6
4 0 6 5
0 3 6 2
3 4 4 7
0 1 0 2
3 7 5 7
5 5 5 1
