8 8
@ . . . . @ . @ 
. . . . . . @ . 
@ . @ . . . . . 
@ . @ . . . . . 
. . . . . . . . 
. . . . . @ . . 
. . . @ @ . . . 
. . . . . @ . . 
7
3 0 1 4
3 4 7 2
7 5 2 0
5 1 3 4
3 7 6 7
5 3 5 4
1 0 3 5
