8 8
. @ . @ . . . . 
. . . . . . . . 
. . . . . . . @ 
. . . . @ . @ . 
. . @ . @ @ . @ 
. . . @ . . @ @ 
. . . . . . . . 
. . . . . . . . 
2
0 5 2 7
6 7 1 6
