8 8
. . . . . @ . . 
. @ . . . . . . 
. . @ . . . . . 
@ @ @ . @ . . . 
. . . . . . . @ 
. . . . @ . . . 
. . . . @ . @ . 
. . . . . @ . . 
3
7 3 3 6
3 2 7 5
4 4 1 0
