8 8
. . . . . . . . 
. . . @ . . . @ 
. . . @ . @ . . 
. @ . . . @ . . 
. @ . . . @ . . 
. @ . . . . . . 
. . . @ . . . . 
. . . . @ @ . . 
3
4 6 4 1
5 5 2 5
0 3 5 6
