8 8
. . . @ . . @ . 
. . . . . . . @ 
. . . . . . @ . 
. . . . . @ . . 
. . . . . . . . 
@ . @ . @ @ . . 
. . . . @ . @ . 
. . . . . @ . . 
7
0 0 7 5
0 7 5 4
4 7 3 1
6 7 3 4
3 5 3 5
4 0 2 7
6 1 4 1
