8 8
. . . . @ . . @ 
. . . . . . . . 
. . . . . . @ . 
. . @ . . . . . 
. . . . . . @ . 
@ . . @ . @ @ . 
. . . . @ @ @ . 
. . . . . . . . 
10
1 1 7 5
3 6 0 1
3 4 3 0
5 0 1 1
0 1 3 1
1 6 5 7
4 7 6 3
7 2 4 1
1 3 2 1
7 6 1 3
