8 8
@ . . . . . @ . 
. . . . . . . . 
. . . @ @ . . . 
. @ @ @ . . . . 
. . . . . . . . 
. . . . . . . . 
. . . . @ @ . . 
@ . . . @ @ . . 
10
7 0 6 1
2 2 0 2
2 1 2 4
3 0 7 6
1 0 4 0
7 3 5 1
0 2 1 0
3 7 1 2
6 3 2 7
4 0 6 4
