8 8
. . . . . . . . 
@ . . . . . . . 
. @ . @ . . @ @ 
. . . . . . . . 
@ . @ . @ . . . 
@ . . @ . . . @ 
. . . @ . . . . 
. . . . . . . . 
2
4 0 5 6
2 7 4 0
