8 8
@ @ . @ . . . . 
. @ @ . . . . . 
. . . @ . @ . @ 
@ . . . . . . . 
. @ . . . . . . 
. . . . . . @ . 
. . . . . . . . 
. @ . . . . . . 
7
3 6 5 4
2 2 4 1
4 2 5 5
5 6 3 4
5 7 4 3
6 7 6 3
0 4 5 3
