8 8
. . . . . . . . 
@ . @ . . . . . 
. . . @ @ . @ . 
. . . . . . @ . 
. . @ @ . . . . 
@ . . . . . . . 
. . . . @ @ . . 
. @ . . . . . . 
4
6 4 6 0
5 2 3 0
0 7 2 7
4 7 3 5
