8 8
. . . . @ . . . 
. @ . . @ . . . 
. . . . . . @ . 
. . @ . . @ @ @ 
@ . . . . . . . 
. . . . @ . . . 
. . . . . . . . 
. . @ @ . . . . 
6
5 2 1 3
3 1 0 5
7 7 2 4
0 2 7 7
5 0 5 2
5 6 3 3
