8 8
. . @ . @ . . . 
. @ @ @ . . . . 
. . . . . . . . 
. @ . . . . @ . 
. . . . . @ . @ 
. . . @ . . @ . 
. . . . . @ . . 
. . . . . . . . 
6
6 2 4 6
1 4 0 6
0 5 2 6
0 3 5 5
2 4 1 2
0 7 2 3
