8 8
. . @ . @ . . . 
. @ . . @ . . . 
. . . . @ . . . 
. @ . @ . @ . . 
. . @ . . . . . 
. . . . . . . . 
. . . . . . @ @ 
. . . @ . . . . 
5
6 1 5 2
5 4 3 6
0 2 3 2
1 7 1 2
6 3 2 6
