8 8
. . . . . . @ . 
. . @ . . @ . . 
. . . . . . . . 
. . . . @ @ . . 
. . . @ . . @ . 
. . . . . . . . 
. . . . . @ @ @ 
@ @ . . . . . . 
1
5 0 4 1
