8 8
. . . . . @ @ . 
. . . . . . . . 
. . . @ @ . @ @ 
. . . . . . . . 
. . . . . . . . 
. . . . @ . . . 
. . @ . . @ . . 
. @ @ . . . @ . 
2
7 4 0 3
7 0 2 5
