8 8
. . . . . . . @ 
. . . . @ . . . 
. . . . @ . . . 
. @ . . . @ . . 
. . . . . . . @ 
. . . . . . . @ 
. @ . . . @ . . 
@ @ . @ . . . . 
8
2 3 6 1
6 1 2 4
1 0 3 6
3 0 5 2
2 4 3 0
3 2 1 4
0 0 4 6
4 5 1 5
