8 8
. . . . . . . @ 
@ @ . . . . . . 
. . . @ @ . . . 
. . . . @ . . @ 
. @ . . . . . . 
. . @ @ . @ . . 
. . . @ . . . . 
. . . . . . . . 
7
1 3 2 3
4 4 1 2
7 6 6 2
5 1 6 0
4 0 7 5
1 0 0 3
7 1 2 4
