8 8
. . . . . . . . 
. @ . . . . . . 
. . . @ . . . @ 
. . . . . . . . 
. . @ @ @ . . . 
@ . . @ . . . . 
@ . . . @ . @ . 
. @ . . . . . . 
6
2 5 7 4
4 2 1 3
4 7 4 2
3 1 1 4
2 6 5 3
6 5 7 5
