8 8
. @ . . . . . . 
. @ . . . @ . . 
. . @ . . . . . 
. . . . . . . @ 
. @ . . . @ . . 
. . @ . @ . . . 
@ @ . . . . . . 
. . . @ . . . . 
6
4 2 6 0
1 7 7 4
1 3 3 0
3 4 5 0
0 1 6 7
6 0 6 4
