8 8
. . . . . . . @ 
@ . . . . . . . 
. . @ . . . . @ 
. . @ . . @ @ . 
. . . . . . . @ 
@ . . . @ . @ . 
. . . . . @ . . 
. . . . . . . . 
9
0 7 4 3
3 5 7 7
1 7 2 6
2 1 1 4
1 0 1 3
3 4 0 0
4 2 3 6
0 2 1 5
3 6 6 4
