8 8
. @ @ . . . . . 
. . . . . . . . 
@ @ . @ . @ @ . 
. . . . . @ . @ 
. . . . . . . . 
. . . . . . . . 
. . . . . . . @ 
. @ @ . . . . . 
8
7 0 6 1
7 2 6 3
7 1 4 6
5 1 5 5
7 4 1 4
3 4 0 7
3 1 4 3
3 5 6 6
