8 8
@ . @ . . . . . 
. . @ . . . @ . 
. . . @ . @ . . 
@ . . . . @ . . 
. @ . . . . . . 
@ . . @ . . . . 
. . . . . @ . . 
. . . . . . . . 
1
7 7 4 7
