8 8
. @ . @ . . . . 
. . . . . . . @ 
. @ . . . . . . 
. . . . . @ . . 
. . . @ @ . . . 
. . . @ . . . . 
. . @ @ . . . . 
. . . . . @ . @ 
1
2 2 1 1
