8 8
@ . . . . . @ . 
. . @ . @ @ . @ 
. @ @ @ . . . . 
@ . . . . . . . 
@ . . . . . @ . 
. . . . . . . . 
. . . . . . . . 
. . . . . . . . 
10
7 2 5 2
5 6 0 5
4 6 7 3
6 3 1 4
4 5 5 4
3 7 4 7
3 6 7 7
7 3 6 3
1 7 5 3
7 5 7 2
