8 8
@ . . . . @ @ . 
. . . . . . . . 
. . . . . . . . 
. . . @ . . . . 
. @ @ @ @ . . . 
. . . . . . @ . 
. . @ . . . . . 
. . . @ . . @ . 
8
7 7 1 0
0 5 7 0
3 0 0 5
3 6 5 7
5 6 4 3
5 1 2 1
6 3 0 2
0 4 7 3
