8 8
@ . . . . . @ . 
@ . . . . . . @ 
. @ . @ . . . @ 
. . . . @ @ . . 
. . . . . . . @ 
. . . . . . . . 
. . . . . . . . 
. . . . . . @ @ 
6
6 2 4 4
4 4 5 2
1 4 4 5
2 6 2 2
0 4 1 0
5 0 0 3
