8 8
@ . . @ . . @ . 
@ . . . . . @ . 
. . . . . . . . 
. @ . . . . @ . 
. @ . . . . . . 
. . @ . . . . . 
. . . . . @ @ . 
. @ . . . . . . 
3
7 4 3 1
0 7 5 1
4 7 7 4
