8 8
. @ . . . . . . 
. @ . . . . . @ 
. . . . . . @ . 
. @ . . . . @ . 
. . . . . . . @ 
. . . @ . @ . . 
. . . . . . @ @ 
@ . . . . . . . 
10
5 4 6 0
5 0 3 2
6 1 5 7
2 0 1 2
2 1 3 4
5 7 6 7
6 5 5 2
0 2 3 3
5 1 2 7
4 6 2 4
