32 32
. . . . . @ . @ . . . . . . . @ . . . . @ @ . . . . . . . @ . . 
@ . . @ . . @ . . . . @ . . . . . @ @ . . . . . . . @ . . . . . 
. . @ . . @ . . . . . @ . . @ . . . @ . @ . . . . . . . . . . . 
. . . . . . . @ . @ . . . . . . . . . . . . . @ . . . . . . @ . 
. . . . . . . . . . . . @ . @ @ . . . . . . @ . . . . . . @ . @ 
. . . @ . . . . . @ . . @ . @ . @ . @ . @ . . . . . . @ @ . @ . 
. . . . . @ . . . . . @ . . . . @ . @ . . . . @ . . . . . . . . 
. @ . . . . . . . . . . . @ . . . @ . . @ . . . . . . . @ . . . 
. . . . . . . . . . . . . . . . . @ . . . @ . . . . . . . . . . 
. @ . . . . . . . . @ . . . . @ . . @ . . @ . . . @ @ @ . . . @ 
. . . . . @ . . @ . . . @ . @ . . . @ . . @ . . . . . . . . . @ 
. . @ . . . . @ . . @ . . . . . . . @ . @ . . . . . . . . . . . 
. . . . . . . . . @ . . @ . . . . @ . . . @ . . . @ . . . . . @ 
. . @ . . . @ . . . @ . . . @ . . . . . @ . . @ . . . @ @ @ . . 
. . @ . . . . . . . . . . . . . @ . . . . . . . . . . . . @ . . 
. . . . . . . @ . . . @ @ . . . . . @ @ . @ . . . . . . . . . . 
@ . @ . @ . . . . @ . . . . . @ . . . . . . . . @ . . . . @ @ . 
. . @ . . . . . . @ . . . @ . . . . . . @ . . . . . . . @ . . . 
. . . . . . @ @ . . @ . . . . . . . . . . . . . . . . @ . . . . 
@ . . . . @ . . . . @ @ . @ . . . . . . . . . . . . . . . . . . 
@ @ . . @ . . . . . . . @ . . . . . . . @ @ . . . . @ . . . . . 
. . . . . . . @ . @ . @ . @ . . . @ . . . . . @ . . . . . . . . 
. . . . . . @ . @ . . . . . . . . . . . . @ . . . @ . . @ @ @ . 
. @ . . @ @ . . . . . @ . @ . . . @ . . . @ . . . . . . . . . . 
. . . . @ . . . . . . . . . . @ . . . @ . . . @ . . @ @ @ . . . 
@ . @ . . . . . . . . . . @ . . . . . . . . @ . . . @ @ . @ . @ 
@ . . . . @ . . . . . @ . . @ . @ . . . @ . @ . . . . @ . . @ . 
@ . . @ . @ @ . . . . . . . @ @ . . . . . . @ @ . . . . . . . . 
. . . @ . @ . . @ @ @ @ . . . . @ . . @ . @ @ . @ . . . . . . @ 
. . . . . . . @ . . @ . . . @ . @ . . . . . . @ . . . . . . . @ 
@ . . . . . . . . . . @ . . . @ . . . . . . . . . . . . . . @ . 
. . . . @ @ . . . . . . . . @ . . . . . . @ . . . . . . . . @ . 
20
30 27 9 23
2 12 7 13
20 12 4 13
29 12 12 9
15 14 18 7
22 23 21 7
4 6 31 27
25 25 31 8
4 22 7 22
26 23 1 22
17 27 26 2
17 17 29 17
7 2 30 15
31 26 13 20
26 22 12 13
18 14 26 19
4 30 5 21
26 5 16 10
13 22 16 30
31 3 19 13
