32 32
. @ . @ . @ . . . . . . . . . . . . @ . @ . . . . . @ . . @ @ . 
@ . . . . . . . . . . . . . . . . . . . @ . . @ . . . . . . @ . 
. . . . . . . . . . . . . . @ . . . . . . . . @ @ . . . . @ . . 
@ @ . . . @ . . . @ . . . . . . @ . . . . . . . . . @ . . . @ . 
. . @ . @ . . . . @ . . . . . . . . . @ . . . . . . @ . . . . . 
. @ . . . . . . @ . @ . . . @ @ . . . . . . . . . @ @ . . . @ . 
. . . . . . . . . . @ . . . . . . . @ . . . . . . . . . . . . . 
. . @ . . . . . . . . . @ . . . . . . . . . @ . . . . @ . . . . 
. . . . . . @ . @ . . . . . . . . . . @ . . . . . . . . . . @ @ 
@ @ . . . . . . . . . . . . . @ . . . . . @ . . . @ . . . @ . . 
. . . . . . . . @ . . . . . @ . . . @ @ . . . . . . @ . . . @ @ 
. . . @ . . . @ . . . . . @ @ . . @ . . . @ . @ . . . . . . . @ 
. . @ . . . @ @ . . . . . @ . . . . . . @ . . . . . . @ . @ . . 
. . @ . . . . . . @ . . @ . . . . . . . . . . @ . . . @ . . . . 
@ . . @ . . . . . . . . . . . . @ . . . . @ . . @ . . . . . @ . 
. . . . . . . @ @ . . . @ . . . . . . @ . . . @ . . . . @ . . . 
. . @ . @ . . . . . . . . . @ . @ . @ . . . . . . . . . . . . . 
. . . @ @ . . @ . . @ . . . . . . . . . . . . . . . . . . . . . 
@ @ @ . . . @ . . . . @ @ . @ . @ . . @ . @ . . @ @ . . . . . . 
. @ . . . . . . . . . . @ . . @ . . @ . . . . . . . . . @ @ . . 
. . . . @ . . . @ . . . . . . . . . . @ @ @ . . . . . @ . . @ . 
@ @ . . @ @ . . . . . @ @ . @ . . . . . . . . @ . . . @ . . . . 
. @ . . @ @ . . . . @ . @ . . . @ @ . @ . . . . . . . @ . . . @ 
. . . . . @ . . @ @ . . . @ . . . . @ . . . . . . . . . . . . . 
@ . . @ @ . . @ . @ . . . @ . . . @ @ . . @ . . . . @ . . . @ . 
. . . . . . . @ . . . @ . . @ . @ . @ @ . . . . . . . . . . . . 
. . . . . @ . @ . . . . @ . . . . . . @ . . . . . @ @ . . . . . 
. @ . @ @ . . @ . . . . . . . . . . . . @ . . @ . . . . . . . . 
. . @ . . . @ . . . . . . . . @ . . . . . . . . . @ @ . . . @ . 
. . . . . . . . . @ . . . . . . . . . . . . . . . @ . . . . @ . 
. . . . @ @ . . . . @ . . . @ @ . @ @ . . . . . . . . . . . . @ 
. . . . . @ . . . . . . @ . . @ . . . @ . . . . . @ . @ @ . @ . 
70
24 3 0 31
11 7 28 16
3 26 0 29
10 25 14 24
26 12 6 20
19 1 5 6
25 21 5 8
20 5 5 14
30 23 16 26
11 24 31 16
2 26 0 19
17 27 26 31
28 20 14 17
25 25 25 12
23 18 24 31
8 29 19 14
21 13 19 12
22 6 27 4
3 5 21 23
1 7 10 25
28 0 11 16
16 8 29 3
12 2 8 1
12 0 12 12
26 25 3 6
10 7 22 19
11 3 20 6
0 8 9 18
23 14 8 22
28 18 4 8
25 2 26 8
29 1 6 2
6 21 21 0
22 24 27 8
11 11 10 24
30 17 25 25
23 12 28 11
12 27 18 13
15 10 25 30
12 6 27 17
13 6 31 6
16 21 23 18
16 29 18 4
20 29 24 6
21 22 7 21
5 10 10 15
11 17 25 16
19 3 28 25
27 9 13 14
29 11 14 31
30 13 6 21
28 8 28 17
11 12 23 14
26 8 23 31
17 14 11 22
8 6 10 31
5 13 6 6
22 11 29 23
6 24 0 22
27 24 4 7
5 8 6 16
12 3 30 12
5 7 10 2
9 7 24 25
13 20 2 3
19 5 25 21
23 31 1 14
1 6 6 3
30 2 4 10
17 16 6 9
