32 32
. . . @ . @ . . . . . @ . . . @ . . @ . . . . . . . . . . . . . 
. . . . @ @ . . . . . . . . . . @ . . . . . . @ . . . . . . . . 
. . . . . . @ . . . . . . . . . . . . . . . @ . . . . . . @ . . 
. . . . @ . . . . . . . . . . . . . . . . . . . . . . . . . @ . 
. . . @ . . . @ . . . . @ . . . . @ @ . . . . . . . . . . @ @ . 
. . . . . @ . . . @ . . . @ . @ . @ . @ . . . @ . . . . . . . . 
. . . . @ . . . . . . @ . . @ . @ . . . @ . . . . . @ . @ . . . 
. . . . . . @ . . . . @ . . . . . . . @ . . . . . . @ . . . . . 
@ . . . . . @ . . @ @ . . . @ . . . . @ . @ @ . . . . @ . . . . 
@ @ . @ . . . @ . . . @ . . . . . . . . . . . . . . . @ . . . . 
@ . . . @ . . . . . . . . @ . @ . . . . . . @ . . . @ . . . . . 
. . . . @ . . . @ . @ @ . . . . . . @ . . . @ . . @ . . . . . . 
. . @ @ @ @ . . . . . @ . . . . . . . @ . . . . . . . . . . . @ 
. . . . . . . . . . . . . . . . . @ . . . . . . @ . @ . . . . . 
@ @ @ . . . . . . @ . @ . . . . . . @ @ . . @ . . . . . . @ . . 
@ . . . . . . . . . . @ . . . @ . . . . . . . . . . . . . . @ . 
. @ . . . @ @ . . @ . . @ @ @ . . . . . @ . . @ . @ . @ . . . . 
@ . . @ . . @ . . . . . . . . . @ . . @ . @ . . @ . . . . . . @ 
. . . . . . @ . . . @ . . . . . . . . @ . . . @ . . . . . @ . . 
. @ . . . . @ . . . . . @ . . . @ . . . . . . . . . . . . . . . 
. @ . . . . . . . . . . . . . @ . . @ . . . . . . . . . . @ . . 
. . . . . . @ @ . . @ . . . . . . . @ . . . . . . . . . @ . . . 
. . . . . . . . . @ @ . . . . . . . . @ @ @ . . . . . . @ . . . 
. . . . . . . @ . @ . @ . . . @ . . @ . . . . @ @ . . . . . @ . 
. . @ . @ . . . . @ @ @ . . . . @ . . . @ . . . . . . . @ . . . 
@ @ . . @ . @ . . @ . . @ . . . . . . . . . . @ . . . . . . . . 
@ . . . . . . . @ @ . . @ @ @ @ . . . . @ . . . . @ . . @ . . . 
@ . . . @ @ . . @ . . @ @ . @ @ . @ . . . @ @ . . . . . . @ @ . 
. . . @ . @ . . @ . . . . @ . . . . . . @ @ @ . . . . . . . @ . 
. . . . . . . . . . . . . @ . . . . @ . . . . . . . @ . @ . . . 
. . . . . . @ @ . . . . @ . . . . @ . . . @ @ . . . . . . . . . 
. . @ . . . . . @ . @ . . @ . . @ . . @ . . . . . . @ . . . . . 
50
23 3 0 23
14 13 29 25
29 19 16 25
14 23 28 4
19 2 15 25
19 19 31 16
31 23 7 13
6 9 28 19
17 3 25 14
11 18 2 4
29 8 20 1
6 0 28 1
1 18 2 29
24 0 9 0
20 29 14 30
2 5 21 31
11 16 7 31
10 27 12 7
30 21 1 26
26 25 27 21
31 21 16 28
26 26 30 25
0 0 20 13
21 14 12 28
28 10 4 9
10 0 15 2
16 3 6 1
7 22 19 25
7 16 24 11
5 30 24 28
30 18 17 21
0 28 14 3
5 25 15 24
5 31 7 14
6 14 2 21
7 5 7 27
18 24 14 10
28 19 4 20
23 10 13 15
10 16 24 22
12 6 0 3
5 18 6 31
5 29 17 11
2 7 19 30
27 25 15 22
10 14 29 22
24 16 27 30
23 21 19 23
18 3 13 25
8 9 20 23
