32 32
. . . . @ . . . . . @ . @ @ . . . . . . . . . @ . . . . . @ . @ 
. @ . @ . . @ . . . . . . . @ . @ . . . . . . . @ . . @ . @ @ . 
. . . . . . . . . @ . . . . . . . . . . . . . . @ . . . . . @ . 
@ . . . . . @ @ . . . . @ . . . . . . . @ . . @ . . . . . . . @ 
. . . . @ . . . . . . . . . @ @ @ . @ . @ . . . @ . . @ . . . . 
. . . . . . . @ . . . . . @ . @ . . . . @ . . . . . . . . . . @ 
@ . . . . . . . @ . . @ . . . . . @ . @ . . . . . . . . @ @ . @ 
@ . . . . . . . . . . @ . @ @ . . @ . . . . . . . . . . . . @ @ 
. . . . . . @ . . . . . . . . . . @ . @ @ @ . @ . . @ . @ . . . 
. . . . @ . . @ . @ . . . . @ . @ . . . . . @ . @ . . . . . . . 
. . . . @ . . . @ @ . . . . . @ @ . . @ . . . . . . . . . . . . 
. @ . . . . . @ . . @ . @ . . . . @ . . . . . . . . @ . . . @ . 
. . . @ . . . . . . . . @ . . . . . . . . . . . @ . . . . . . . 
@ . @ . . . . . . . . @ . . . . . . . @ . . . . @ . . . . . . @ 
. @ . . . @ . @ . . . @ . . . . . . @ . . . . @ . . . . . . . . 
. . @ @ . @ @ . @ @ . . . . . @ . . @ . . . @ . @ . . . @ . . @ 
. @ . . @ . . . . . . . . . . . . @ . . @ . . . . . . . @ . . . 
. . @ @ . . @ . . . . @ . . . @ . . . . @ . . @ . . . . . . . . 
. . . . . @ . . . . . @ @ . . . . . . . . . . @ @ . . . . @ . . 
. . . . . . . . . . . @ . . . @ . . . . @ @ . . . . . . . . . . 
. . . . . . . . . . . . . . @ . . . . . . @ @ . . . . @ . . @ . 
. . . . . . . @ @ . @ @ . . . . . @ @ . . . . . . @ . @ . . . @ 
. @ . . . . . . . . @ . . . . . @ @ . . . . . . . . . . . @ . . 
@ . . . @ . @ . . @ . . @ . . . . . . . . . @ . . . . . . . . . 
. @ . . @ . . . @ . . . . . @ . . . . . . . . . . . . . . . . . 
. . @ @ . . . . . . . . . . . . . . . . . . . . . . . @ @ . . @ 
. . . . . . @ . . . . @ . . . . . . . . @ . . . . . . . @ @ . . 
. . . . . @ . . . . . . . . . . @ . . . @ . . . . @ . @ . . . . 
@ . . . . . . . @ . . . . . . @ . . . . @ . . . . . . @ . . . @ 
@ . . @ @ . . . . . @ . . . . . . @ . @ . . . . . @ @ . . . . . 
. @ . @ . . . @ @ . . . . . . . . . . . . . . @ @ . . . @ . . . 
. . . . @ . . . . . @ . . . @ @ . . . @ . . . . . . @ . . . @ @ 
50
10 1 6 16
21 22 1 13
1 20 6 14
10 5 14 27
3 22 29 9
0 0 13 30
3 8 13 22
23 22 21 28
28 13 30 17
3 14 16 21
20 22 7 19
18 22 24 20
22 13 4 18
24 8 1 6
15 26 30 15
11 9 21 13
4 15 0 14
24 24 20 30
26 24 13 28
9 18 28 18
21 17 16 11
28 21 2 8
4 22 5 30
15 27 0 31
23 7 24 29
23 11 3 6
26 1 6 18
17 27 13 1
13 10 29 7
18 23 20 23
11 24 5 9
6 28 20 22
21 0 2 3
15 22 15 13
25 0 25 15
24 0 7 31
30 3 9 14
5 9 13 29
19 19 29 31
17 20 21 10
18 24 29 8
26 23 7 0
21 26 9 30
31 23 6 22
23 27 5 20
14 11 18 3
30 18 5 17
8 23 7 17
15 29 17 25
30 17 26 23
