32 32
. . . . . . @ @ . . @ @ . . . . . @ @ . . . . . @ . @ . . . @ @ 
@ . . @ . . . @ @ . . . . . . . . . @ @ . . . . . . . . . . . . 
. . . . . . . . . . . . . . . . @ . @ @ . @ . . . @ . . . . . @ 
. . . @ . . @ @ . @ . . . . . . @ . @ . . . @ . . . . . . . . . 
. @ . . . . . . . @ @ . . . . . . . @ . . . . @ . . . @ . . @ . 
. . @ . . . . . . @ @ . . . . . . @ . @ . . . . . . . . @ @ . . 
. . . @ . . @ . . . . . . . . @ . . . . . . @ . @ . . . . . . . 
. . . . . . @ @ . . @ . . . . . . . . . @ . . . . . @ . @ . . . 
. . . @ . . . . @ . . . . . @ . . @ @ @ @ @ . . . @ . . . . . . 
. . . . . . . . . @ . . . . @ . . . . . @ . . @ @ @ . . . . . . 
. . . . . . @ @ . . . . . . . @ . . . . @ @ . . . . @ @ . @ . . 
. . . . . . . . . . . . . @ . . . . . . . . . . @ . . @ . @ @ . 
@ . . @ . . . @ @ . . . . . . @ . . . . . . . . @ . . . . . . . 
@ @ . . . . . . . . @ . @ . . @ . . . . . @ . . . @ . . . . @ . 
. . . . . . . @ . . . . . @ . . @ . . . . . @ . . . . . @ . . . 
. . . . . @ . . . . . . . . . . . @ . . . . . . . @ . . . @ @ . 
. . . . . . . . . . . . . . . . . . . . . @ . @ . . . . . . . @ 
. . . . . . . . @ . . . . . . . . . . @ @ . . @ . . . . . . . . 
@ @ . . . . @ . . . . . . . . . @ . . . @ . . . . . . . . . @ @ 
. . . . @ . . . . . @ . . . . . @ . . @ @ @ @ . . . . . . @ . @ 
. . . . . . @ . . . . . . . . . . . . . @ . @ . . . . @ . @ . . 
. @ . . @ . . . . . . . . . @ . . . . @ @ . . . . . @ . @ . . . 
. . . . . . . @ . . . . . @ . @ . . . . . . . @ @ . . . . . . . 
. @ . @ . . . . @ @ . . . . . . . . . . . . @ . . . . . . @ . . 
. @ @ . . . . @ . . . . . . . @ . . @ . . . @ . . . . . . . @ . 
@ . . . . . . . @ . . . @ . . . . . . @ . . . . @ . . . . . . . 
. . . . . . . . . @ . @ . . . . . . . . . . . . @ @ . . . . @ . 
. @ . . . . . . @ @ . . . . . . @ . . . . . . . . . @ @ . . . . 
. . . . . . . . . @ . . . . . . . . . . @ @ . . . . @ . @ . . . 
@ . @ . @ . @ @ . . . @ . @ . . . . . . @ . . . . @ . @ . . @ . 
@ . . . . @ . . . . . . @ . . . @ @ . . . . . @ . @ . . . . . . 
@ . . . @ . . @ . @ . . @ . . . . . @ . . . . . . . . . . . . . 
70
20 30 17 21
0 17 0 24
25 25 24 19
16 20 24 8
21 3 28 31
9 0 30 14
28 15 3 5
29 0 11 7
9 11 24 13
22 16 29 21
4 0 13 23
27 9 13 26
7 18 30 5
16 1 11 9
11 18 0 9
10 24 28 8
2 10 14 19
5 28 7 8
14 26 19 9
30 22 24 17
0 28 31 21
0 0 3 2
5 21 10 26
20 16 18 27
22 4 30 31
1 20 25 16
30 27 8 5
13 10 8 10
23 23 18 22
11 1 14 27
5 31 12 6
28 24 13 4
31 24 16 6
1 12 5 26
14 23 2 11
10 2 15 31
4 24 26 11
23 0 5 0
15 18 18 7
28 30 16 9
18 14 8 21
6 12 4 1
26 4 15 25
9 14 28 15
9 25 3 26
15 16 4 8
11 3 17 22
5 26 22 0
13 9 31 26
16 6 27 13
26 2 2 22
15 3 21 7
21 15 23 12
23 5 4 15
28 18 31 17
25 4 28 2
3 10 12 10
30 12 11 17
15 11 19 14
11 13 21 9
5 2 8 6
2 19 23 3
8 21 18 16
29 25 15 8
10 22 28 22
26 18 0 2
21 20 19 4
4 18 5 20
15 7 25 6
8 5 17 18
