32 32
. . . . . . . . . . . . . . . @ . . . . . . . @ . @ . . . . . . 
. . . . . . . . . . . . . @ @ @ . . . . . @ @ . . . . . . @ . . 
. @ @ @ . . @ . . @ . . @ @ . . . . . . . . . . . . . . . . . . 
. . @ . . . . . . . . . @ . . . . . . . . . . @ . . . @ . . . . 
. . . . . . . . . . . . . . . . . . . . . @ . @ . . @ . . . . . 
@ . . @ . . @ @ @ @ @ . . @ @ . . . . . . . . . . . . . . . . . 
. @ . . . @ . . . . . . . . . . . . @ . . . @ . . . . . . . . . 
. . @ . . . . . . . . . @ . . @ @ @ . . . . . . . . @ . . . . . 
. . . . @ . @ . . @ @ . @ . . @ . . @ . . . . . @ @ . @ . . . . 
. @ . . . @ . . . . @ . . . . . . . @ . @ . . . . . . . @ @ . . 
. . . . . . . . . . @ . . . . @ . @ . . . @ . . . . . . @ . . . 
. . . . . . . @ . @ @ . . . . . . . . @ @ . . . . @ . @ . . . . 
. @ . @ . . @ . . . @ @ @ . . . . . . . . . . . . @ . . @ . . . 
@ . . . . . . . @ . . . . . . . . . . . . @ . . . @ . . . . . @ 
. . . @ . . . @ . . @ . . . . . . . . . . @ . . . @ @ . . . . . 
. . @ . . . . @ . . . @ . . . . . . @ @ @ . . . . . . . . . . . 
. . . @ @ @ . . . @ . @ . . @ . @ @ . . . . @ . @ @ . . . . . @ 
. @ . . . @ . . @ . @ . . @ @ . . . @ . @ @ . . . . . . . . . . 
. @ . . @ @ . . . . . . . . . . . . . . . . . . @ . . . . . . . 
. . . . . . . . . @ @ . . @ . @ @ . . . . . . . . . @ . . . . . 
. . . . @ . . @ . @ . . . @ . . . . . . . . . . @ . . . . @ . . 
. @ @ . . @ . . . @ . . . . . . . . @ . . @ . @ . @ @ . . . @ . 
@ . . . . @ . . @ . . . . . . . . @ . @ . . . . . . . @ @ @ . @ 
. @ @ . @ @ . . @ . . . . . . . . @ . . . . @ . . @ @ . . @ . . 
. . . . . . . . . @ @ . . . . . . . . . . @ . . . . . . . . . . 
. . . @ . @ . . . . . . . . @ . @ . @ . . . . @ . . . . @ . . . 
. . . . @ @ . . . . . . . @ @ . . . . @ . . . . . . . . . . . @ 
@ @ @ . . . @ . . . @ . . . . . @ . @ . . . . . . @ . . . @ . . 
. . . . . . @ . . . . . . . . . . . . . . . . . . @ . @ . . . . 
. . . . . . . . . . . . . . . . . . . . . . . @ @ . . . . . . @ 
. @ . . . . . . . . . . . . . @ . . . . . . . . . . . @ . @ . . 
@ . . . . @ . . . @ . . . . . . . . . . @ . . . @ @ . . @ . . . 
60
24 1 2 28
20 22 2 26
10 18 26 27
2 6 7 10
19 27 30 25
1 25 31 20
26 13 13 24
7 29 11 18
14 19 14 6
22 3 2 10
3 18 2 0
15 20 17 11
25 9 12 22
13 15 21 29
2 31 25 4
29 10 13 0
2 14 7 7
31 17 1 1
26 16 24 14
2 22 10 4
7 10 31 19
14 13 20 8
3 4 14 27
28 3 30 16
14 24 20 5
16 0 28 11
15 14 15 9
31 27 11 10
22 10 7 25
18 11 30 0
29 12 1 15
10 21 28 0
21 19 31 14
4 24 2 9
9 7 25 18
1 3 16 24
22 29 1 31
11 4 31 31
9 25 12 20
28 21 12 11
11 18 7 3
15 11 21 19
20 23 22 2
31 19 6 23
26 24 13 11
17 6 17 5
11 26 27 0
5 14 10 29
4 2 29 11
2 11 1 14
23 11 12 13
16 4 8 26
20 27 11 19
31 1 27 20
11 24 11 13
22 24 4 13
13 24 18 0
24 7 7 18
24 15 11 30
22 21 7 24
