32 32
@ . . . . . . . . . . . @ @ . . . . . . . . . . . . . . . . . @ 
. @ . @ . . . . @ @ . . . . . @ . . . . . . . . @ . . . . . . . 
@ @ . . @ . @ . @ . . . . @ . . @ . . . . . . . @ . . @ . . @ . 
. . . . . . . . . . . . . . . . . @ . . . . . @ . . @ . @ @ . . 
. @ . . . . . . . @ @ . . . . . @ @ . . . . . . . . . . . . . . 
. @ . . . . @ . . @ . @ @ . . . . @ . @ . . . . . . . . . . . @ 
. . . . . @ . . . . . . . @ . @ . . . . @ @ . . . @ . . . . . @ 
. . . @ . @ . . . . . . . . . . . . . . . . . . . . . . . . . . 
. @ . . . . . . @ . . . . . . @ . . . . @ . @ . . . @ . @ . . . 
. . . @ . . . @ . . @ . . . . . . . . . . @ . . . . . . . @ . . 
. . . . . @ . . . . . . . . . . @ . @ . . @ . . @ . @ @ . . . . 
. . . @ . @ . . . . . @ . . . . . @ . . . . . @ . . . . . . . . 
. . . . . . @ . . @ . . . . . . @ @ . . . . . . . . . . . . @ . 
. . . . @ . . . . . . . . . . . . . . . . @ . . . . . @ . @ . . 
@ . . . . . . @ . @ . @ . . . . @ . @ . @ . . . . . . . . . . @ 
. @ . . . @ @ . . . . . . . @ . . . @ @ . . @ . @ . . . . . . . 
@ @ . . . . . . . . . . . . . . . . . . . @ . . . . @ . . @ . @ 
@ @ @ . . @ . . . . . . . @ @ @ . @ @ . @ . . . . . . . . . . @ 
. . . @ . . . . @ @ . . . . . . . . . @ . @ . . . . . . @ . @ @ 
. @ . . . @ . @ . . . . . . . . . . @ . @ . . . @ . @ . . @ . . 
. . . . . . . . . . . . . . . . . . . . . @ . @ . @ . . @ . . . 
. . . @ . @ @ @ . . . . . @ . . . . . . . . . . @ . . . . . @ . 
. @ @ . . . . @ @ . . . @ . . . . . . . . . . . . . . . . . . . 
. @ . @ . . . . . @ . . @ . @ . . . @ @ . . . . @ . . . @ @ . @ 
. . . . . . . . . . . . . . . @ . . . @ . . . . . . . @ . . . . 
@ . . @ . . . . . @ . . @ . . @ . . . . . . . @ @ @ . . . . . . 
. . . . . . @ @ . . . @ @ @ . . @ . . . . . . . . . . . . . @ . 
. . . @ . . . . . . @ . . . @ . . . . . @ . . . . . . @ . . . . 
. . . . . . . . . . @ . . . . . . . . . . . . . . . . . . . @ @ 
. . . . . . . . . @ . @ @ . @ . . . . . . . . . @ . . . @ . @ . 
@ @ . . @ . . . . @ . . . . . @ . . @ . . . . . . . @ . . . . . 
. . . . . . @ . . . . . . . . . @ . . @ . . . @ @ @ . @ . . @ . 
50
31 8 18 9
25 8 14 25
14 28 5 31
8 21 20 29
23 12 2 14
0 23 12 12
0 31 4 12
15 19 8 0
23 24 19 8
20 16 11 6
3 0 28 9
4 7 2 0
31 19 4 3
24 5 24 6
15 10 29 28
13 18 13 19
2 4 12 19
13 31 12 31
16 30 21 1
6 24 20 4
14 20 24 24
15 2 2 13
0 21 20 20
17 9 18 1
15 11 27 30
29 28 18 7
13 8 19 9
6 22 17 7
14 6 14 26
21 31 19 29
18 9 31 9
1 13 7 20
21 21 6 10
7 0 18 25
13 12 16 19
22 25 5 4
1 28 20 31
1 26 7 7
28 9 31 13
30 30 27 26
31 29 12 8
23 27 13 12
4 31 17 28
6 19 30 1
22 13 8 7
30 6 27 28
11 9 20 2
1 12 28 1
27 3 20 28
5 23 14 30
