32 32
. . . @ . . . @ . @ . . . . . . . . . . . . . . . . . . . @ . @ 
. . . @ . @ . . . . . . . . . . @ @ . . . . . @ . @ . @ . . . . 
. . . . . @ . . . @ . . . . . . . . . . . . . . . . . . . @ . . 
@ . . . . . . . . @ . . . . . . . @ . . . . . . @ . @ . . . . . 
@ . . @ . . . @ . . . . @ . . . . . @ @ @ . . @ . @ @ . @ @ . . 
@ . . . . . @ . . . . . . @ . . . @ @ . @ . . . @ @ . . @ @ . @ 
. . @ . @ . . . . . . . @ . @ @ . . . . . . . . . . @ . . . . @ 
. . . . . . . @ . . . . . . . . . . . . . @ . . . . . . . @ . . 
. @ . . . . @ . . @ @ . . @ @ . . . @ @ . . . . . . . . @ . . . 
. . . . @ . . . . . . . . . . . . . . . . . . @ . . . @ . . @ . 
. @ . . . . @ . . . . . . . @ . . @ . . . . . @ . . . . . . . . 
@ . . . . . . . . . . . . . . . . @ . . . . . . @ @ @ . . . . . 
. . . . . . . . . . . . . . . . . . . . . . . @ . . . . . . . . 
. @ @ . @ . . . @ . . . @ . . . . . @ . . . . . . . . . . . . . 
. . . . . . . . . . . @ . . . . @ . . . . @ . . . . . . . . @ . 
@ . . . . . . . @ . . @ @ . . . . . @ @ . . . @ . . . @ @ @ @ @ 
. . . . . . @ @ @ . . . . @ . . . @ . . . @ . . . . @ . @ . @ @ 
@ . . @ . . . . . . . . @ @ . . . . . . . . . . . @ . . . @ . . 
. . . . @ . . . . . . @ . @ . . . . @ . @ . @ . . . . . @ . . . 
. @ . . . . . . . . . . . @ @ . . @ . . . . . @ . @ . . . . . . 
. . . . . @ @ . @ . . . . . . . . . . . . . @ . . . . . . . . . 
@ . . @ @ . . @ . . . . . . @ . . . . @ . @ . . @ @ . @ . . . . 
. . . @ . . @ . . @ . . . @ . . @ . . . . . . @ . . . . . @ . . 
. . . . @ . @ . @ @ . . . @ . . . @ . @ . @ . . . . . . . . . . 
. . . . . . . . . . . . . . . . . . . . @ . @ . . . . . . . . . 
. . . . . . . . . . . . . . . . . . @ . . . . @ . . @ @ @ . . . 
@ . . . . . . . . . . . . . . . . . . . . . . . . @ . . . . . @ 
. @ @ . . @ . . . @ . . . . @ . . . . . . . . . . @ . . @ @ . . 
. . . . . @ @ . . . @ @ . . @ . . . . . . . . . . @ . . . @ @ . 
. . . @ . @ . . . . . @ @ . . . . . @ @ . @ @ . . . . . @ @ . @ 
. . . . @ . . . . . . . @ @ . . . . . . . . . . . . . . . . . . 
@ @ . @ . . . . @ . . . . . . . . . . . . . . @ . . . @ . . @ . 
10
27 11 20 16
18 26 18 3
9 15 1 7
2 4 26 31
15 28 7 29
24 16 22 26
31 20 24 13
1 6 6 4
26 13 29 9
28 7 23 30
