32 32
. @ . . . . . @ @ . . . . . . . @ . . @ @ . @ . . . . . . @ . . 
. . . . . . . . . @ . . . . . . . . @ . . . . @ @ . . . . . @ @ 
. . @ . . . @ . @ . . . . . . . @ . . . . . . . . . . @ . . @ . 
. . . . . . . . @ . @ . @ @ . . @ . . . @ . . . @ . . . @ @ . @ 
. . . . . @ . . . . @ . . . . @ . . . @ . . . . . . . . @ . @ @ 
. . . . @ @ . . . . . . . . . . @ . . . . @ . . . @ . . . . . . 
. . @ . . @ . . @ . @ . . . . . . . . @ . . . . . . . @ @ . . . 
. . . . . . . . @ . . @ . . . . . . . . . @ . . . . @ . . @ @ . 
. @ . @ . @ . . @ . . . . . . . @ . @ . . @ @ . . . . @ . . . . 
@ . . . @ @ @ . . . . . . @ . . . . . . . . . . . @ @ . @ . . . 
@ . @ . . . @ @ @ . @ . . . . @ . @ . . . . . . . . @ @ . @ . . 
. . . . . . . . . . . . . . . . . . . . . . . . @ . . . @ @ . @ 
. . . . . . . . . . . . . @ . @ . . @ . . . . . . . . . . . . . 
. . . . . . . . . . . @ @ . @ . . . . . . . . . . . . . . . @ . 
. . @ . . . @ @ . . . . . @ . . . @ . @ @ @ . . . @ . . . . . @ 
. . @ . . . . . @ . @ . . . . @ . . . . . @ @ . . . . . @ . . . 
. @ . . . . . . . . . . @ . . . . . . . . . . . . . @ . @ . . . 
. . . . . . . . . . @ @ . . @ . . . . . . . . . . . . . . . . . 
. . . . . . @ @ . . . . . . @ @ . . . . @ . . . . @ . . . . . . 
. @ @ . . . @ . @ . @ . . . . . @ . . . . . . . . . . . . . . . 
. @ . . @ . . . . . @ . . . @ . @ . . . . @ @ . . @ . . @ . . . 
. @ . . @ . . . . . . . . . . . . @ . . . @ . . . . . . . . . @ 
@ . . . . @ . . . . . @ @ . . . . @ . . . . @ . @ . . . . . . . 
. . . . . @ . @ @ . . . . . @ . . . . . . . . . . @ . . . . . @ 
. @ . . . . @ . . . . . . . . . . . . . . . . . . . . . . . . @ 
. . . . . . . @ @ . @ @ @ @ . @ . @ . . . . . . . . . . . . @ . 
. . . . . . . . . . . . . . @ @ . . . . . . . . . . . @ . . . . 
@ . . . . . . . . . @ . . . . @ . . @ . . . @ . . . . @ @ . . . 
@ . @ . . . . . . . @ @ . . . @ . @ . . . @ . . @ . . . . . . . 
. . . . . . . . . . @ . . . . . . @ . . . @ . . @ . @ . . . . . 
. . . . . . . . . @ . . @ . @ . . @ . . . . @ . . . . @ . . @ . 
. . . . @ . . . . . . . . . . . @ . . . . @ . . . . . @ . @ . . 
40
23 29 25 8
6 25 31 10
22 31 31 22
5 21 8 12
31 29 14 8
2 11 4 27
6 22 1 30
22 9 16 22
22 7 3 6
23 3 9 24
29 16 8 24
20 15 20 8
9 21 29 27
3 29 4 28
3 4 19 12
5 3 5 1
6 11 29 2
3 10 20 2
10 31 0 1
28 8 1 9
16 24 10 13
22 3 23 19
28 5 6 12
24 31 3 4
26 2 21 24
22 12 12 19
1 15 17 18
28 28 5 11
21 6 1 17
0 2 7 1
26 4 13 21
4 14 27 21
14 8 18 9
30 24 16 11
12 29 1 10
5 2 16 17
10 1 31 20
6 15 30 9
12 21 1 13
24 19 18 10
