32 32
. @ . . . . . . . . . . . . . . . . @ . . . . . . . . . . @ @ . 
. . . . . . . . . @ . @ . @ . . . . . . . . . . @ @ . . @ . . . 
. . . @ . . . . . . . . . . . @ . . . . @ . . . . . . . . . . . 
. . @ . . . . @ . . . . @ . . @ . . . . . . @ @ . @ . . . . . . 
. . . . . . . @ . . @ . . @ . . . . . . . @ @ @ . . . . @ @ @ . 
@ . . . @ . . . . . . . . . @ . . . . . . . . . . . . . . @ @ . 
. . . . @ . . . . . . @ . @ . . . . @ @ . @ @ @ @ . . . . . . . 
@ . . . . @ . @ . . . . . . @ . . @ . . . . @ . @ @ . . . . @ . 
@ . . . @ . @ . . . . . . @ @ . . @ . @ . . @ . @ . @ . @ . . . 
. @ . . . . . . @ . . . @ @ . . . @ . . . . . @ . . . . . @ . . 
. . . . . . . . . . . . . . . . . . . . . . . @ . @ . . . . . . 
. . . . . @ . . . . . . . . . . . . . . . . . . . @ . . . . . . 
@ . . @ . . . . @ . @ @ . . . . @ . . . . . . . . . . @ . . . . 
. . . . . . . . . . . . . . . . . @ . . . . . . . @ . . @ . . . 
. . . . . . . . . . @ @ @ . . . . @ @ . . @ . . . . . . . . @ . 
. . . . . . . . @ . . . . . . . . @ . . @ . . @ . @ . . . . . . 
@ . . . @ @ @ @ . . . . . . @ . . . @ @ . @ . @ . @ . . . . . . 
. . . . @ . . . . . . @ . . . . . . . . @ @ @ . . @ . . . . . . 
. . . @ . . . . . @ @ . @ . . @ . . . . . @ . . . . . . . . . . 
@ . . . @ . @ . . . . . . . . . . . . . . . . . . . . . . . @ . 
. . . . . . . . . . . . . @ . @ . @ . . . . . @ . . @ . @ . . @ 
. . @ . . @ . . . . . . @ . @ . . . . . . . . . . . . . . . . . 
@ . . @ . . @ . @ . . . . . . . . . . . . @ . . . . @ . . . . . 
@ . . . . . . . . @ . . . . . . . @ . . . . . . . @ . . . . . . 
. . . . . . . @ @ . . . . . . . . . @ . . . . . @ @ @ . @ @ @ . 
@ . . @ . . . . @ . . . . @ . . . @ . . . . . . . @ @ . @ . . . 
. . @ . . . . . . . . . . @ @ . . . . . . . . . . . . . . . @ . 
. @ . @ . . @ @ . . @ . @ . . . . @ . . . @ . . @ . @ . . . . . 
. . . . . . . . . . . . @ . @ @ . . . . . . . . . @ . . @ @ . . 
. @ . . . . . . @ . . @ . . . @ . . . . . . . . . . @ @ . . . . 
. . @ . @ @ . @ . @ @ . . . . . . . . @ . . @ @ @ . . . . @ . . 
. . . . @ . . . @ . . @ . . . . @ . . . . @ . . . @ . . . . . . 
30
11 10 0 15
30 16 20 21
24 15 5 26
27 6 16 7
21 0 21 2
19 9 14 11
20 26 15 7
15 24 21 24
27 10 29 7
24 29 10 24
24 18 3 5
14 30 20 19
4 22 8 13
2 15 24 15
9 5 6 14
29 17 14 13
1 6 26 28
1 12 25 29
5 18 12 5
6 15 4 10
25 5 8 19
8 1 10 8
31 10 24 0
22 15 4 7
29 19 5 12
15 22 0 24
3 11 19 29
15 13 29 31
7 26 16 24
21 29 6 1
