32 32
. . @ . @ . @ . . . @ . . . . . . . @ . . @ . . . . . @ @ . . . 
. . . . . . . . . @ . . @ . . . . . . @ . . . @ . @ . . . . . . 
. . . . . . . . . . . . . . . . . . . . . . . . @ . . . . . @ @ 
. . . . . . . . . . . . @ @ . . . . . . @ . . . . . . . . . . @ 
. . @ . . @ . . . . . . . . @ @ . @ . . . . . @ . . @ . . . . . 
@ . . . . . . . @ . @ @ . @ . . . . . @ . . . @ . . . . . . . @ 
. @ . @ . . . . . @ . @ . @ @ . @ . . . @ . . . . . @ . . . . @ 
. . . . . . @ @ . . . . . @ . . @ . . . . . . . . @ @ . . . . . 
@ . . . . @ . . . . . . . . . . . @ . . . . . . . . @ . . . . . 
. @ . . . . . . @ @ . . . . . . . . @ . @ . @ . . . . . . . . . 
@ . . . . . . @ . . @ . . . . . . . . . . . . . @ . . . . . . @ 
. @ @ . . . . . @ . @ @ . . @ @ . . . . . . . . . @ . . @ . . . 
. . . . . . . @ . @ . @ @ . . . . . @ . . . . . . . . . . @ . @ 
. . . . . . @ . . . . . @ @ . . . @ . . . @ . . @ . . . . . . . 
. @ . . @ . . . . @ . . . . @ @ . . . . . . . . . . . . . . . . 
. @ @ . . . . . . . . . . . . . . . . . . . @ . . . @ @ @ . @ @ 
. . @ . . . . . . @ . . . . . . @ . . . . . . @ . @ . . . . @ . 
. . . . . . @ . . . . . . . . . . @ . . . . @ . @ . . . . . . . 
@ . . . . . . . . @ . . . . . . . . . . . . . . . . . @ . . . . 
. . . . @ . @ . . . . . . . . @ @ @ . . . . . . . . . @ . . . . 
@ @ . . . . . . @ . . . . . @ @ @ @ . . . . . . . @ . . . @ . . 
. . . . . @ . . . @ . . . . . . . . @ . . . . . . . . . . . . . 
. . . . . . . @ . @ . . . . . . . @ . . . @ . . . . . @ @ @ . @ 
. . . . @ . . @ @ . . . . . . . . . . . . . . . . . . . . . . . 
@ . . . . . . . . . @ @ @ . . . . . . . . . @ . . . @ . . . . . 
. . . @ @ . . . @ . @ . . . @ . . @ @ . @ @ . . @ @ . @ . @ @ . 
. @ . . . . . . . . . . . . @ . . . . . . . . @ . . @ . @ . . @ 
. @ . . . . . . . @ . . . . @ . . . . . . . . . @ . . . @ . . . 
@ . @ @ . . . . . . . . @ . . . . . @ . @ . . . . @ . . . . . @ 
. . . . . . . . . . @ . . . . @ . . . . . . . . . . . . @ @ . @ 
. @ @ . . . . @ @ . . @ . . . @ @ @ . . . . . . @ . . . . @ @ . 
. @ . . . . . . @ . . @ @ . . . . . . . . . . . . . . . @ . @ . 
20
22 4 24 22
8 3 14 29
14 18 27 13
16 14 16 23
4 8 31 20
24 3 4 5
20 29 3 24
13 25 8 24
22 8 14 5
13 21 9 17
30 18 15 25
0 13 14 22
30 20 17 3
31 21 18 15
26 13 23 20
27 11 21 11
21 3 11 15
7 19 7 1
3 11 29 0
19 26 3 30
