32 32
. . @ . . . . . . @ . . @ @ . @ . . . . . . . . . . . . . . . @ 
. . . . . . @ . . . . . . . @ . . @ @ @ . . @ . . . . @ @ . . . 
. . . . . . @ @ . . @ . . . . . . @ . @ . . . @ . . . @ . . . @ 
@ . . . . . @ @ . @ . . . . . . . @ . . . @ . . . . . @ @ @ . . 
@ . . @ . . . . . @ . . . @ . . . . . @ . . . . . . . . . . . . 
. . . . . . . . . . . . . . @ . . . @ . . . @ @ . @ @ . . . . . 
@ . . . . . . @ . . @ @ . . @ . . . . . . . . . . @ . . @ . . . 
. . . @ . . . @ . . . . . . . . . . . . . . @ . @ . . . . . . . 
. . . . . . . . . . @ . @ . . . . . . . . @ . . . @ . . . @ @ . 
. . @ . . @ . . @ @ @ . @ @ . . . . . @ . . . . . . . . . . . . 
@ . . @ . . @ . . . . . . @ . . . . . . . . . . @ @ . . @ . . . 
@ @ . @ . . . . . . . . . . . . . . . . . . . . . . . @ . . @ . 
. . . . @ . . . @ . @ . . @ @ . . . . . @ . . . . . . . . . . . 
. @ . . . . . . . . . . . . @ . . . . . . . . . . . . . . . . @ 
. . . @ @ @ . @ . @ @ . . . . @ . . . . . . . . @ @ . . . . . . 
@ . . . . . . @ @ @ . . . . . . @ . . @ . . . @ . . @ @ @ . . . 
. . . . . . . @ . . . . . . . @ . . . . . . @ . . . . . @ . . . 
. . . . . . @ . . . . . @ . . @ . @ @ . . . . @ . . @ . . . @ @ 
. @ . . @ . . . . . . . . . . . . . . . . . . . . . . . . . . . 
. . . . . . . . . . . @ . . . . . @ . . . . . . . . @ . . . . . 
. . . @ . @ . @ @ . @ . @ . . @ . . @ . . . . . . . . . @ @ . . 
. . . @ . . . . . . @ . . . . . . . . @ . . . @ . . . . . . . @ 
. . . . . . . . . . . . @ . @ . . . . . . . . . . . . . . . @ . 
. . @ . @ @ . . @ @ . @ @ . . . . @ . . . . . . . @ @ . . @ . . 
. . . . . . . . @ . . . . . . . . . . . . . @ @ . . . . . . @ . 
. . . . . . . . @ . . . @ . . . . @ @ . . . @ . . . . . . . . . 
. . . @ @ . . . @ . @ . . . . . . @ @ @ . . . . . . . . . . . . 
. . . . . . . . . @ @ . @ @ @ . . @ . @ . . . . . . . @ . . . @ 
. @ . . . . . . . . . . . . . . . . . @ . . . . @ . . . . . . . 
. . @ @ . @ . @ . . . . @ . . . . . @ . @ . . @ . @ . . . . . . 
. . @ . . . . . . @ @ . @ . @ . . . . . . . . @ . @ @ . . . . . 
. . . . . @ @ . . . . . . @ . . . . . . . . @ . . . . @ . . . . 
50
21 12 27 8
18 27 17 7
1 29 14 10
5 12 3 0
6 6 11 12
21 13 17 16
25 21 12 31
6 24 20 24
8 21 17 9
15 2 25 21
17 31 27 0
14 14 1 19
0 24 10 18
22 26 9 8
28 26 16 17
30 25 21 11
0 28 4 28
18 3 7 12
17 8 12 3
17 6 23 0
2 27 1 7
30 12 30 10
23 9 9 18
1 16 26 0
15 15 24 16
9 18 27 6
2 18 16 14
21 1 17 22
2 7 8 1
0 29 23 19
24 17 9 31
13 30 31 5
21 31 24 19
3 25 25 13
18 15 27 29
12 10 31 12
10 4 2 10
3 17 29 4
16 18 6 23
4 1 29 2
14 15 13 21
31 28 6 8
13 25 2 4
12 11 8 2
8 30 10 24
29 26 30 6
10 19 9 6
31 7 7 1
26 13 26 22
7 21 18 14
