32 32
. @ @ . . @ . . . . . @ . . . @ . . . . . . . . . . . @ . . @ . 
. @ . . . . . . . . . . . . . . . . @ . . . @ . . . . @ . @ . @ 
. . . . . . . . . . . @ . . . @ @ . . . . . . . . . . . . @ @ . 
. . . @ . . . @ . . . . . . . . . . . @ . @ . . @ . . . . . . . 
. . @ . @ . . . @ . @ . . @ . @ . . . . . . . . . . . . . @ @ . 
. @ . . . . . @ . . . @ . @ . @ @ @ @ . . . @ . @ @ @ . . @ . . 
. . . @ . . . . . . . . . . . . . @ . . . . . . . . . . . @ @ . 
. . . . . . @ . . . @ @ . . . . . . @ . . . . . . @ @ . . . @ . 
@ . . . . . . @ . . @ @ . . . . . @ @ . . . . . . . . . @ @ . . 
. . . . . . . . . @ . . . . @ . . . . @ . . . @ . . . @ . . . . 
. @ @ . . . . . @ . . . @ . @ . . . . . @ . . . @ . . . . . . . 
. . . . . @ . . . . . . . @ . . . . . @ . . . . . . . . . . . . 
. . . . . . . . @ . . . @ . . @ @ . @ . . . . @ . . . . @ . . . 
. @ @ . @ . . @ . @ . . . . . . . . . . . . . . . @ . . . @ . . 
. . . . . @ . @ @ . . . . . . . . . . . . @ @ . . . . . . . @ . 
. . . . . @ @ . . . @ @ . . . . . . . . . @ @ . . . @ . . . . . 
. . . . . @ @ . . @ . @ . . . @ . @ . . . . . . . . . . @ . @ . 
@ . . . . @ . . . . . . . . . . . . @ . . . . . . . @ . . . . . 
. . @ @ . . . . @ . . . . . . . . . . . @ . . @ . . @ @ . . . . 
. @ @ . . . @ . . . . . . . . . . . . . @ . . @ . . . . @ . . . 
. . . . . . . . @ . . . . . @ . . @ @ @ . . . . . . . @ @ . @ . 
. . @ . . . . . . . . . @ @ @ . . . . . . @ . . . . . . . . . @ 
. . . . . . . . . . . . . @ . . . . . . . . . @ . . . . @ . . . 
. . . . . @ . . . . @ . @ . @ . . . @ . . . . @ @ . . . . . @ . 
. . @ . . . . @ . . @ . . . @ . @ @ . . . . . . . . . . . . @ . 
. @ . . . . @ . . . . . . . . . . @ @ . @ . . . . . . . . . @ @ 
. . . . . @ . . @ @ . . . . . . . . . . . . . @ . . . @ @ @ @ @ 
. . . . . . . . @ . @ . . . @ . . . . . . @ . . . . . . . . . . 
. . . . . @ . . . @ . . . . @ . . . . . . . . . . @ @ . @ @ . . 
. . . . . . . . . . @ . @ . . @ . @ . . . . . . @ @ . @ . . . . 
. . . @ . @ . . . . . . . . . . . . . @ . . . . . . . . . @ . . 
. . . . @ . . . . . . @ . . . . . . . @ . . . . . . . . @ . . . 
10
9 2 4 0
13 9 3 13
27 12 7 20
16 31 21 13
9 23 13 28
4 25 31 19
21 11 6 24
14 11 5 10
3 25 29 29
31 16 26 25
