32 32
. . . . . . @ @ . . @ . . . . . . . . . . . . . . . . . . . @ . 
@ . . @ . @ . . . . . @ @ . . @ . . . . . @ . . . . . . . . . @ 
@ . . . . . . @ . . . . . . . . @ . @ @ . . . . . @ . . . . . . 
. . . . . . . @ . . @ . . . . . . . . . . . . @ @ @ . . . . @ . 
@ . . . . . . . @ @ . @ . . . . . . @ . . . . . . @ . . . @ . @ 
. . @ . @ @ . . . . . . . @ . . . . . . @ . . . . . . . . . . . 
. @ @ . . . . . . . . . . . . . @ . @ @ . . . @ . @ @ @ . . . . 
. @ . . . . . . . @ @ . . . . . . . . . . . @ . . . @ @ . . . . 
. . . @ . . @ @ . @ . . . . . . . @ @ @ . . . . . . @ . . . . . 
@ . . . . . . . @ . . . . . . @ . . . @ . . . . @ . @ . . . . . 
. . . . . @ . . . . . . @ . @ . . @ . @ . . @ . . . . . @ . . . 
. . . . . . . . . . . . . . . . . . . . . . @ . . . . . . . . . 
. . . @ @ . . @ . . . . . . . . . . . . . . . @ . . . . . . . . 
@ . . . . . . . @ . . . . . . . . . . . . . @ . . . @ . @ . @ . 
. . . @ @ @ @ . . . @ @ . . . . . @ @ . . . . @ . . . . . . . . 
. . . . . . . @ . . @ . . . . @ . . @ @ . . @ . @ . . . . . . @ 
@ . . . . . . @ . . . . @ . . . @ @ . . . . . . . . @ . @ . @ . 
. . . . . . . @ . . @ . @ . . . . . @ @ . . . . . . . . . . . . 
. @ . . @ . . . . . . . . . . . . . . . . . . . @ @ . . . . . @ 
@ . . . . . . . . . . @ . . @ . . . @ @ . . . . @ . @ . . . . . 
. . . . . . . . . . @ . . . @ . . @ @ . . . . @ . . . . @ . . . 
. . . . . . . @ . . . . . . . . . . . @ . . . @ . @ . . . . . @ 
@ . @ @ . . . . . . . . . @ . . . . @ . @ . . . . @ . . . . @ . 
. . . . . @ . . . @ . . @ . . . . . . . . @ . . @ . . . . . . . 
. . . . . . @ . @ . . @ @ . . . . . . . . . . . . . . . . . . . 
. @ . . @ . . . @ @ . . @ . . . . @ . . . @ @ . . . . . . . . @ 
. @ . . . . . . . . . . . . . . . . @ . @ . . . . . . . . @ . . 
@ @ . . . . . . @ . @ . . @ . . . . . . . . . @ . . . . . . . . 
. . . . . @ @ @ . . . @ @ . . . . @ . . @ . . . . . @ . . . . . 
. . . @ @ @ . . . . . @ . . @ . . . . . . . @ . . @ @ . . . . . 
. @ . . . . . . @ . . . . . @ . . @ . . @ . . . . . . . @ . @ @ 
. . . . @ @ . . . . . . . . . . . @ . . . @ @ @ . . . . @ . . . 
40
21 27 5 9
5 15 29 15
5 21 25 16
22 9 25 8
21 29 12 21
22 2 21 28
14 18 7 24
20 9 28 23
30 14 16 28
15 14 28 22
0 15 9 12
6 27 12 3
26 12 2 28
25 8 4 9
1 20 14 12
15 0 23 2
4 17 7 20
3 9 18 29
7 27 2 8
15 13 29 7
24 1 0 17
14 13 14 0
18 18 17 23
27 2 19 25
9 18 30 11
29 3 23 28
21 6 30 5
31 29 3 0
3 28 9 6
4 27 10 5
14 2 1 15
25 15 16 7
6 3 12 15
6 4 7 31
12 18 2 24
11 21 19 26
3 4 13 4
9 11 30 15
14 6 30 1
23 19 14 25
