32 32
@ . . . . . . . . . . . @ @ . @ . . . . . . . . . @ . . . . . . 
@ . @ . @ . @ . . . . . @ . . @ @ . . . . . @ . . @ . . . . . . 
. . . . . @ . @ . . @ . @ . . . @ . . . . . . . . . . @ @ . . @ 
. . . @ . . @ . @ . . . . . . . . . . . . . . . . . @ . @ @ . . 
. . . . . . . . . . . @ . @ . . . . . . . . . . . . . . . . . . 
. @ . @ . @ . . . . . . . @ . . . . . . . . . . @ . . . @ . . . 
. . @ . @ . . . . . @ . . . . . . . . . . . . . . . . @ . . . . 
. @ . @ . . . @ . . . . . . . . . @ . . . . @ . @ . . @ . . . @ 
@ . . @ @ . . . @ @ @ @ . . . . . @ . . . . . . . . @ . . . @ . 
. @ @ . . @ . . @ . @ @ . @ . . . . . . . . . . . . . . . @ @ . 
. . . . . @ . . . . . . . . . . . . . . . . . @ @ . @ . . . @ . 
. . . . . @ . . . . . @ @ . . . @ . . . . . . . . . . . . . @ @ 
. . @ @ . . . @ . . . . . . @ . . . @ . . @ . . . . . @ . . . . 
. @ . @ @ @ . . . @ . . . @ @ . @ . . . . . @ . . . . . @ . . @ 
. . . . . . . . @ . @ . @ . . . . . @ . @ . @ . @ . @ . . . . @ 
. . . . @ . . . . . . . . . . . . . @ . . @ . . . . . . . . @ . 
. @ . . . . . . . . . . . . . . . . . . . @ @ @ . . @ @ . . . . 
. . . . . . . . . . . . . . . . . . . . . . @ @ . . @ . . . . @ 
@ . @ . . . . . @ . @ . . . . @ . @ . @ . . . . . . . . . . . . 
. @ . . . . . @ . . . @ . @ . . . . . . . . . . . . . . . . . . 
. . . . @ . . . . . . . . @ . . . . @ . . . . . @ . . . . @ . . 
. . . @ @ @ . . @ . @ . . . . . @ . @ . . . . . @ @ @ . . . . . 
. . . @ . . . @ . @ . . . @ . . . . . . . . . @ . . . . . . . . 
. . . . . @ . @ . . . . . . . @ . . . . . . @ . . @ . . . . . . 
. . @ . . @ @ . @ . @ . . @ . . . . @ . . @ @ . . . @ . . . . . 
. @ @ . . . . . . . . . @ . . . @ . . . @ . @ . . @ . . . @ . . 
. . . . . . @ . . . . . . . . @ . . . . . . . . . . . . @ . . . 
. . . . . . @ . . @ . . @ @ . @ . . . . . . . . . . . . @ . . . 
. . . @ . . . . . . @ @ . . . . @ . . . . . . . . . . . . . . . 
. . . . @ . . . @ . @ . . . . . . . . . @ . @ @ . . @ . . . . . 
. . . . . . . @ . . . . @ @ @ . . . . . . . . . . . . . . . . . 
. . . . . . @ . . . . @ . @ @ . . @ . . . . . . . . . . @ @ . . 
70
24 2 7 9
18 1 6 4
14 15 0 30
24 17 14 26
23 14 30 12
13 18 29 17
13 25 10 4
16 6 2 28
5 7 2 2
3 30 20 26
16 26 26 25
9 25 2 10
8 5 4 22
9 14 20 24
26 7 18 30
9 3 17 13
26 4 15 17
1 0 12 10
22 19 19 2
26 1 6 21
27 13 15 22
0 19 26 9
16 10 27 31
25 29 8 0
3 20 30 5
2 20 20 4
25 28 9 6
14 19 0 28
0 20 9 4
15 16 1 21
23 4 29 14
22 27 4 14
19 28 24 1
12 29 17 19
26 23 9 9
4 23 17 20
16 27 6 9
6 0 14 5
24 3 0 16
5 0 1 22
24 6 5 8
8 22 28 9
0 9 27 0
21 28 16 12
19 6 6 11
17 4 7 14
20 22 4 25
11 2 12 15
19 25 21 5
11 24 20 13
24 31 26 13
2 15 11 21
26 6 9 15
8 2 9 30
31 12 16 10
5 29 24 31
31 20 12 8
5 16 0 10
29 2 25 8
11 21 6 23
21 6 25 24
16 18 9 3
11 12 28 14
24 8 22 15
15 11 27 25
14 18 3 9
4 7 20 16
25 18 14 3
27 15 18 2
2 13 27 21
