32 32
. . . . . . @ . @ . @ . . . . . . @ . . @ . . . @ . . . . @ @ . 
. . . . @ . . . . . . . . . . @ . . . . . . . . . . @ @ . . . . 
. . . @ . . . . . @ . . @ . . . . . . @ . @ . . . @ @ . . . . . 
. . . . . . . . . @ . . . . . @ . . . . . . . . . @ . . . . . . 
. . @ . . @ @ . . . . @ . @ . . . @ @ . . . . . @ . . . . . @ . 
. . . . . . . . @ . . @ . . @ . . . . . . . @ . . . . . @ @ . . 
. . . @ . . @ . . . . . . . @ . @ @ . . . . . . . . . . . . . . 
. . . @ @ @ . . . . . . . . . . @ . @ . . . @ @ . @ . . . . @ . 
. . @ . . @ . . . . . . . . . . @ . . . @ @ . . @ . . . . . . . 
. @ . @ . . . . . . . @ @ . . . . @ @ . . . @ . . . @ @ . . @ @ 
. @ . . . . . @ . @ . . . . . . . . . . @ . . . @ . @ . . . . . 
. . . . . . . . . @ . . . . . . . . . @ . . . . . . . . . @ . . 
. . . @ @ . . . . . . @ . . . . @ @ . . . . . @ . . . . . . . . 
. . . . . @ @ @ . @ . . @ . . . . . . . . . . . . . . . . . . . 
. . . . . . . @ . . . @ . @ . . . . @ . . @ @ . . . . @ . @ . . 
. . . . . @ . . . . @ . . @ @ . . . . . @ . . . . . @ . . @ @ . 
. @ . . . . @ . . . . . . . . . . . . @ . . . . . @ . . . . @ . 
. . @ . . @ @ . . @ . @ . . . . . . . . @ . @ . . . . . . . . . 
. . . . @ . . @ . . . . @ . @ . . @ . . . . . @ . . . @ . @ . . 
. @ . . @ . . . @ . . . @ . @ . . @ . . . . . . . . . . @ . . . 
. . . @ . . . . . . @ . . @ . . . . . . . . . @ . @ . @ . @ @ . 
. . . . . . . @ . . @ . @ . @ . @ @ . . . . . . . . . @ . . @ @ 
. . . @ . @ . . . . . . . . . . . @ . . . . . @ . . . . . . . . 
. . . . . . . . . . . . @ . @ . . . . . . . . . . . @ . . . . . 
. @ . . . . . . . . . @ . . @ @ @ . . @ . @ @ @ . . . . . . . @ 
. . . . . . . . . . . . . @ @ . . . @ . . @ . @ . . . . . . . . 
. . . . . . . . . . . . . . . . . . . . . @ . . @ . . . . @ @ . 
. . . . . @ . . @ . . . . . . . . . . @ . @ . @ @ @ . . . . . . 
. . . . . . . . . . . . . . . . @ @ . . . . . . . . . . . . . . 
@ . . . . @ . . . . . . . @ . . . . @ . . . . . . . . @ . @ . @ 
. . . . . . . . . . . . . . . . @ . . @ . . . . @ . . . . . @ . 
@ . . . @ @ @ . . . . @ . . . @ . @ . @ . . . . @ . . @ . . . . 
30
3 11 8 29
11 25 0 12
6 24 31 6
25 18 20 12
18 17 6 1
6 22 7 1
4 0 22 25
26 22 11 26
26 25 26 12
10 28 19 15
23 13 9 28
31 30 17 15
9 0 18 27
25 6 23 31
4 22 31 3
31 23 9 0
14 10 7 6
18 11 24 16
20 26 13 27
10 7 6 15
19 25 29 3
26 20 28 7
8 14 18 8
29 16 15 30
20 3 5 21
15 17 26 18
25 21 10 18
22 0 8 4
2 24 15 19
12 8 11 19
