32 32
. . @ . . . . . . @ . . . . . . . . . . @ . . . . . @ . . @ . . 
. . @ . . . . . . @ @ . . . @ . . @ . . . . @ . . . . . . . . . 
. . . . . . @ . . . . . . . @ . @ . @ . . . . . @ . . . @ . . . 
. @ . . . . . @ . . . . . . @ . . . @ . . . . @ . . @ @ . @ . . 
. . . . . . . . . . @ . . . . . . . . . . . . . . @ . . . . @ . 
. @ . . . . . . . . . . . @ . @ @ . . . . . . . . . @ . . . @ @ 
. . @ . . . @ . . . . . @ . @ . @ @ . . . . . . . . . . @ @ . . 
. . . . . . . . @ @ . @ @ . . . . . . . . . . @ . . . . . . . . 
. . . . . @ . . . . . . @ . . . . . @ . . . @ . . . . . . . @ @ 
. @ . . @ . . . @ . . . . . . @ . . . . . . . . . . . . . . . . 
. @ . . . . . @ . . . . @ . . . . . . . . . . . . . . . @ . . . 
. . . @ . @ . . . . . . . . . . . @ . . . . . . . . . . . . . . 
@ . . . . . . . . . @ . . . . . @ . . . . . . @ . . . @ @ . . @ 
@ . . . . . . . @ @ . . . . . @ . . @ . @ . . . . . . . . . @ . 
. @ @ @ . . . . . . . . @ . . . . . . . . @ . . . . . . . . . . 
@ . @ . . @ . . . . . . . . @ . . . . . @ . . . @ . . . . . . . 
. . . . @ @ @ . . . @ . . . . . . . @ . . . . @ @ @ . . . . . @ 
@ . @ . . @ @ @ . . @ @ . . . @ . . . . @ . . . . . . . . . . . 
. . @ . . . @ @ . . . @ . @ @ . @ . . . . @ . . @ . . @ . @ . . 
. . . . . @ @ . . @ . . . . . . . . . . . . . . @ . . . @ @ @ . 
. . . . . . . @ . . . . . . . . . . . @ . . . @ . . . . . . @ @ 
. @ . . @ @ . . . . . . @ . . . . . . @ @ . . . . . . @ . . . . 
. . . . . . . . . . . . . @ . . . . . . . . . @ . . . . . @ @ . 
. . . . . @ . . . . . . . . . . @ . . . . . . @ . . . @ @ @ . . 
@ . . . . . @ @ . . @ @ . @ . . . . . . . . . . . . @ . . . @ @ 
. @ . @ . . . @ . . . . . @ . . . . @ . . . . @ . . . . @ . @ . 
. . . . . . . . @ . . @ @ @ . @ . @ . . . @ . . . . . . . @ @ . 
. . . . . . @ . . @ . . . . . @ . . . . . . . . . . . . @ @ . @ 
@ . . . . . . . . @ . . . . . . . @ . @ . . @ @ @ @ . . . . . . 
. . @ @ . . @ . . . . @ . . . . @ . . @ . . . @ . . . . . . . @ 
. @ . . . . . . . . . . . . @ . . . . . . @ . . . . . . . . @ . 
. . . . . . . @ . . . . . . . . @ . . . . . . . . . . @ . @ . . 
20
3 20 7 23
2 30 25 12
17 9 3 24
15 14 7 14
22 19 28 11
28 21 27 26
21 13 8 24
29 21 5 0
22 13 18 4
21 11 30 28
2 26 23 10
24 29 14 23
22 6 31 28
21 1 5 20
1 11 17 8
7 15 24 27
0 3 28 9
4 28 19 1
19 15 0 29
27 16 5 22
