32 32
. . . . . . @ @ @ @ . . @ . @ . . . . . . . . . . . . . . @ @ @ 
. @ . . . . . . . . @ . . . . . @ . . . @ . . . . . . @ . . . . 
@ . . . . . . . . @ . . . @ . . . @ . @ @ . . @ . @ @ @ . . . . 
. @ . . @ . . . . . . @ . . . . . . . . . . @ . . . . . . . . . 
. . . . . . . . . . . @ . . . . . . . . . . . @ . . @ @ . . . . 
@ . . . @ . . . . . . . . . . @ . . . . . . . . . . . . . . . . 
. . . . . . . . . @ @ . . . . . @ @ @ . . . . . . . . . . . @ . 
@ . . . . . . . . . @ @ . . @ . . @ . @ @ @ . . . . . . . . . . 
. . . . . @ . . . . . . . @ . . . @ . . . . . @ @ . @ @ . . . . 
. . @ . . . . . . @ . . . . . . . . . . @ . . . . . @ . . . @ . 
. . . @ . . . . . . . @ @ . . @ @ . . . . . . . . . @ . @ . . @ 
. . . . . . . . . . . . . . . . . . @ . . . . . . @ . . . . . . 
. . @ . . . . @ . @ . . . . . . . . . . @ . . . . . . . @ . @ @ 
@ . . . . . @ . . @ . . @ . . . . . @ . @ . . . . . . @ . . . . 
. . . . . @ . . @ @ . . . . @ . . @ . . . . . . @ . . @ @ . . . 
. . . . . . . @ . . . . . . . . . . @ . . . @ . . . @ . . @ . . 
. . @ . @ . . @ @ . . . . . . . . . . . . . . @ @ . . . . . . . 
. . . . @ @ . . . . . @ @ . . . . . . . . . . . . . @ . . . . . 
. . . . @ @ . . . . . . . . . . . . . @ . @ . . . . . . . . . . 
. @ . @ . . . @ . . @ . . @ . . . . . . @ . . . . . . . . . . . 
. @ . . . . . . . . . . . @ . . @ . . . . @ @ . @ . . . . . . . 
. . . @ . . . . . . . . @ . . . . . . . . . @ . @ . . . . . @ @ 
@ @ . . . . . . . . . @ . . . . @ . . . . @ . . . . . . @ . . . 
. . . . . . @ . . . . . . . . . . . . @ . . . . . . . . . @ . . 
. . . @ . . . . . @ . . . . . @ . . . . . . @ . @ @ @ . . @ @ . 
@ . . . . . @ @ . . . . . . . . . . . @ @ @ . . . @ . . . . . . 
. . . . . . @ . . . . . @ @ @ @ @ . . . . @ @ . . . . . . . @ . 
. @ . @ . . @ . . . . . . . . @ . . . . . . . . @ . . . @ . . @ 
@ . @ @ @ . . . @ @ . . . @ @ . @ . . @ . . @ . . @ . . . . @ . 
. . @ . @ . . . . . @ @ . . . . . @ . . @ @ . . . . . . . . . . 
. . @ . . . . @ . . @ . . @ . . . . . . . @ . . . . . @ . @ . . 
. . . @ . . . . . . . . . . @ . @ . . . . . . . . . . . @ . . @ 
20
6 29 25 27
20 20 22 13
27 28 3 9
20 6 1 16
29 13 27 21
20 22 31 6
22 16 19 15
10 22 29 27
7 29 26 12
18 18 8 8
21 17 0 18
30 29 9 16
7 4 16 12
19 3 7 26
20 0 4 15
2 23 4 20
19 20 20 4
22 1 7 5
15 1 19 26
18 5 30 10
