32 32
. . . . . . . . . . . @ . . @ . @ @ . . . . . . . @ . . . . . @ 
. . . . @ . . @ . . . . . . . . . . @ . . . . @ . . . . @ . . @ 
. . . . . . . @ . . . . . . . @ @ . . . . . . . @ . @ . . . . . 
. . @ . . . . . . . . . . . . . . . . @ . @ . . @ . . . . . . . 
. . . . . . @ . @ . . @ @ . . . . . . . @ . . . . . . . . . @ @ 
. . . . . . . . . @ . . . . . . . @ @ . @ . . @ @ . . . . . . . 
. . . . . . . . . . . . . . . . . . . . . . . . . . @ . . . . . 
@ . @ . @ . . . . . . . . . . . . . . . . @ . @ @ . . . . @ . @ 
. . @ . . . . . . . . . . . . . @ . . . . . . . . . . @ . . @ . 
. . . . . . . . . . @ . . . @ . . . . . . . . . . . . . . . @ . 
@ . . @ . . @ @ . . . . . . . . . @ . . . @ . . @ . . . . @ @ . 
. . . . . . . . . . @ . . . @ . . . . . . . . @ . . @ . . . . . 
. @ . . . . . @ . . . . . . . . . . @ . @ . . . . . . @ . . . . 
. . . . . . . . @ . . . . . . . . @ . @ . . . . . . . @ . . . . 
. . @ . . . . . . . @ . . @ . . . @ @ . . . @ . . @ . . . . @ . 
. . . . . . @ @ . @ . . @ @ . @ . . . . . @ @ @ . . . . . . . . 
@ @ . . . . . . . . @ . @ @ . @ . @ @ @ . . . @ . . . @ . . . @ 
. . . @ . . . . @ . . . @ . . @ . @ . . . . . . . . . . . . . @ 
. . . . . . . . . . @ . . . . . @ . @ . . . @ @ @ . @ . . . . . 
. . @ . . . . . @ . @ . . . . @ . . . . @ . . . . . . @ . . . . 
@ . . . . @ . . . . @ . @ . . . . . @ . . . . . @ . . . . @ . . 
. . . . . . . . . . . . . . . @ @ . @ . . . . @ . . . . . . . @ 
@ . . . . . . . . @ @ . . . . . . @ . . . . @ . . . . . . . . @ 
@ . . . . @ . @ . . @ . . . . . . . . . . @ @ . . . @ . . @ . . 
. . . . . @ @ @ @ . . . . . . . . . . . . . @ . . . . . . . . . 
. . @ . . . . . . . . @ . . @ . @ . . . . . . . . . @ . . @ . . 
. . . . . . . @ @ . . @ . @ @ @ @ . @ . @ . . . . . @ . . . . . 
. @ @ . . . . . . . . . . @ @ . . . . . . @ @ . . @ . @ . @ . . 
@ . @ . . . . . . . . . . . . . @ . . . . . . @ . . . . . @ . @ 
. . . . . @ . . . . . . . . . . . . @ . . . . @ @ . @ . . @ . . 
@ . . . . @ @ . . . @ . . @ . @ . . @ . . @ @ . . . . . . . . . 
. . . . . @ @ . . . @ . . . . . . . . . @ @ @ @ . . . . . . . . 
70
24 21 13 5
0 9 5 9
19 25 29 14
17 8 6 7
5 19 2 29
29 5 12 29
24 8 21 1
16 16 16 19
11 31 28 29
24 6 8 27
20 6 4 2
20 15 18 0
28 2 28 7
30 6 10 29
23 9 9 17
12 8 12 13
21 6 31 19
1 24 12 5
25 2 19 17
29 21 22 10
23 26 25 2
25 10 6 1
30 11 22 0
15 14 27 15
7 5 26 13
16 20 11 15
5 22 9 2
30 12 1 9
15 24 11 10
12 31 0 24
9 24 19 20
22 12 17 23
11 22 10 15
18 2 18 8
29 2 24 12
7 16 8 30
28 20 17 25
3 5 23 26
5 26 14 19
3 31 20 28
0 21 29 31
0 19 19 14
13 29 11 8
16 27 16 9
30 19 3 13
26 7 3 5
6 6 20 6
30 16 15 13
4 3 30 13
27 26 20 29
13 31 5 13
8 23 21 2
29 4 22 12
12 19 5 18
25 16 14 18
2 18 26 22
7 21 17 30
1 5 30 18
10 2 31 18
1 7 3 28
14 5 25 28
29 24 14 15
4 0 4 18
3 4 25 19
24 17 5 6
9 20 2 18
29 26 4 5
8 18 28 12
11 6 25 4
0 14 3 11
