32 32
. . . . . . . . @ . @ . . . @ . . @ . @ @ . . . . . . . . . . . 
. @ @ . . @ . . @ . . . . . . . . . . . . . @ . . @ . . . . . . 
. . . . . . . . . . . @ @ . . . . . . @ . . @ . . . @ . . . . . 
. . . . . . . @ @ . . . . . . . . . . . @ . @ . . . . @ @ . . @ 
. . . . . . . . . . . . . @ . @ . . @ . . @ . . @ @ . @ . @ . . 
. . . @ . . @ . . @ . . . @ . . . . . @ . . @ . . . . . @ . @ . 
. @ . . . . . . . . . @ . @ . . . . . . . . . . . . . . . . . @ 
. . . . . . . . . . . . @ . . @ . . . . . . @ . . . @ @ @ . . @ 
. . . . . . . . . . . @ . . . . . . @ @ @ @ . . . . @ . . . . @ 
@ . . . @ . . @ @ . . . @ . @ . . . . . . . @ . . . . . @ . . @ 
. . . . @ @ . . @ . . . . . . . . . . @ @ . @ . @ . . . . @ . . 
. . @ . . . @ . . . . . . . . @ . @ . . . . . @ . . . . . . . . 
. @ . @ . . @ . . . @ @ . . . . . . . . . . . . @ . @ @ . . . . 
. . . . . . . . . . @ . . . . @ . . . . . . . . @ . . @ . . . . 
. @ . . . . . . . . @ . . . . . @ . . . . @ . . . . . . . . . . 
. . . . . @ . . . . . . . . . . . . . . . @ @ . . . . . . . @ . 
@ @ . @ . . . . . . . . . . . . . . . . . . . . . . . . . . . . 
. . . @ . . . . . . . . . . . . . . . . . . . . @ . @ . . . . . 
. . . @ @ . . . . @ . . @ . . . . . @ . . . . . . . @ . . . . . 
. . . . . . . . . . @ . . . @ . . . @ . . . . . . . . @ @ . . . 
. . . @ . . . . . . @ . . @ . . . . . . @ . . . @ @ @ . @ @ @ @ 
. . @ . . . . . . . . @ . @ . . . . . @ . . . . . . . . . . . @ 
@ . . @ . @ . @ . . . . @ . . @ @ . . . . . @ . . @ @ . . . @ . 
. @ . @ @ . @ . . . @ . . @ . . . . . @ . . @ . . . @ . . . @ . 
@ . . . . . @ @ . @ . . @ . @ . @ . . . . . . . . . . . @ . . . 
. . . . . . @ . . . @ . . . . . . @ . . . @ . . @ . . . . . . . 
. . . @ . . . . . . @ . . . . @ . . . . . . @ . . @ . . . @ @ . 
. . . . . . . . . @ . . @ . . . . . . . . . . . @ . . @ @ . . . 
@ . . . . . @ . . . . . . . . . . @ . . @ @ . . . . . . . . . . 
. . . . . . @ . . . . . . . . . @ . . @ @ . . . . . . @ @ . . @ 
. . . . . . . . . . . @ . . . . . @ . @ . . . . . . @ . . . @ . 
@ . . . . . . . . @ . . @ . . . . @ . . . @ . . . @ . @ . @ . . 
60
28 6 19 26
3 9 14 13
18 24 25 29
15 0 17 22
2 0 26 28
2 7 14 14
27 21 2 23
19 26 16 16
16 0 5 2
4 0 11 23
21 23 11 28
25 16 7 30
12 30 18 5
8 25 17 13
15 29 12 23
1 9 23 6
19 9 30 0
13 10 12 30
2 28 8 2
0 21 27 6
25 23 7 27
29 21 29 12
0 6 4 14
17 20 21 26
25 12 16 9
17 2 15 10
29 18 24 30
8 2 9 8
13 9 17 19
31 18 21 22
4 20 0 30
9 0 8 25
0 7 16 19
6 8 8 13
30 8 18 30
20 31 27 20
5 6 27 1
9 16 13 10
14 2 11 26
21 24 12 17
10 18 28 13
0 4 10 31
12 19 23 26
28 26 19 19
29 0 11 18
17 15 24 24
6 2 6 30
23 18 30 16
14 10 3 4
26 11 5 27
14 18 29 14
26 5 30 27
21 21 4 13
24 30 3 9
7 31 25 8
16 18 22 29
7 28 6 7
11 15 6 8
12 28 2 9
19 13 12 16
