32 32
. . @ . . @ @ . . . . @ . . . . . . . . . . . . @ . . . . . . . 
. . . . . . . . . . . . . . . . . . . @ @ . . . . . . . . . . . 
. . . . . . . . . . . . . @ . . . . . . . . . . @ . . . . . . . 
@ . . . . . . @ . @ . . . . . . . . . . . . . @ . . . . . . . . 
@ . . . . . . . . @ . . @ . @ . @ . . @ @ . . @ . @ . . @ . . . 
. . . . . . . . . . . . . . @ @ . . . . . @ . . . . @ @ . . . . 
. . . . @ . @ @ @ . @ . . . . . . @ @ . . . . . @ . . . @ @ . . 
. @ @ . @ . . . . . . . @ . @ . . . . . . . . . @ @ . . . . . . 
@ . . @ . . . @ . . . @ . . . . . . . . . . . . . . . . . . . @ 
. . . . . . . . . . . . . . . @ . . . . @ . . . . . . @ . . @ . 
@ @ . @ . . . . . . . @ . . . . . . @ . . . . . . . . . . . @ @ 
. . . . . . . . . . @ . @ . . . . . @ . . @ . . . . . . . . . . 
. . @ @ @ . . . . . . . . @ . . . @ . . . . @ . @ . . . . @ . . 
. . . . . . . . . . . . . . . . . . @ . . . @ . . . . . @ . . @ 
. . @ . @ . @ @ @ . . @ . . . . @ . @ . . . @ @ . . @ . @ @ . . 
@ @ . . . @ . . . @ . . . . . . . . . . . . . . @ . . . @ . . @ 
. @ . . . . . @ . . . . . . . @ . @ . @ @ @ . . . . @ . . . @ . 
. . . . . . . . . . . . . @ . @ . @ . . . . @ . @ . . @ . . . . 
. . @ @ @ @ @ . @ @ . . @ . . . . . . . . . . . . . . . . . . @ 
@ . @ . @ @ . . . . . . . @ @ @ @ . . . . . @ . . . . . . . . . 
. @ . . . . . . . @ . . . . . . . . @ . . . . @ . . . . @ . @ . 
@ @ . @ . @ . . @ @ . . . . . . @ . . . . . . . . . . . . . . . 
@ . . . . . . @ . . . . @ @ . . . . @ . . . . . . . . . . . . . 
. . . . . . . . @ . . . . . . . . @ . . @ . . . . . . @ @ . @ @ 
. . . . . . . . . . @ . . . . . @ @ . . . . . @ . @ @ . @ . @ . 
. @ . @ . @ @ . . . . . . . . . @ @ . . @ . . . . . . . . . . . 
. . . . . . . @ . . . . . . . @ . . @ @ @ . . . . . . . @ . . @ 
. . . @ . . @ . @ . . . . . . . . . . . . . . @ . . . . . . . . 
@ . . . @ . . @ . . . . . . . . . . . . . . . . . . @ . . @ . . 
. . . . . . @ . @ . @ @ @ . . . . . @ . . @ . . . @ . . @ . . . 
. . . . . . . @ . . . . . @ . . . . . . . . . . . . . . . . . . 
. . @ . . . . . . . . . . . . . . @ . @ @ . @ . . . . @ . . @ . 
50
5 8 19 9
17 15 6 23
6 1 20 0
16 29 15 25
24 13 19 29
27 10 10 9
28 7 23 2
7 11 4 9
26 12 11 31
29 11 12 12
15 6 10 5
18 15 14 1
30 25 5 10
21 21 13 31
20 7 22 5
19 25 23 11
12 27 24 9
17 20 9 16
23 26 0 13
31 21 21 3
27 29 1 8
24 26 23 17
0 13 29 10
16 5 30 28
0 14 3 28
27 20 8 4
11 23 14 8
23 1 20 21
19 9 17 5
11 26 7 5
31 20 16 10
30 29 25 31
5 26 3 31
13 7 23 18
11 4 6 10
11 31 12 3
13 13 28 8
7 25 22 25
2 24 4 13
4 16 26 30
22 27 19 25
5 10 30 29
14 28 21 12
0 6 16 6
31 3 16 22
21 25 12 27
10 8 23 15
29 15 27 10
25 9 1 31
3 23 0 6
