32 32
@ . . . . . . . . . @ . @ . . . . . . . @ @ . . @ . . @ . @ . . 
. . . . @ . . . . . . @ . . . . @ . @ . . . . . . . . @ . . @ @ 
. . @ . @ . @ @ . . @ @ . . . . . @ . . . @ . . . . . @ . . . . 
@ . . . . . @ . . . . . . . @ . . . . . . . @ . . . . @ . . . . 
. . . . . . . . @ . . . @ . . . @ . . . . @ . . . . . . . . . @ 
. . @ . . . @ . . @ . . . . @ . @ . . . . . . . . . . . @ . . . 
@ . . @ @ . . @ . . . . . . . . . . . . . . @ . . . . . . . . . 
. . . . . . . @ . . . . . . . . . @ . . . @ . . . . @ . . . . . 
. . . . @ @ @ @ . . . . . . . . @ @ . . . . . . . . @ @ . . . . 
@ . . . . . . . @ . . . . . . . . . . @ . . . . . . . . . . . . 
. @ . . . . @ . . . . . . . . . @ . . . . @ . . . . . . . . . . 
. . . . @ . . . . . . . . . . . . . . @ . . . . . . . . . . . . 
. @ . @ . . @ . . @ . @ . . @ . . @ . . . . . . . @ . . . . . . 
. @ . . . . . . . . . . . @ @ . . . . . . . . . . . @ . . . . . 
. @ @ . . @ . . @ . . . . @ . . @ @ @ @ . . . . . . . . . . . @ 
. . . . . . . . . @ @ . . . . . . @ . . . . . . . . . . . @ . @ 
. . . . @ . . @ . . . . . @ . . @ @ . . @ . . . . . . @ . . . . 
@ . . @ . . . . . . . . . . @ . . @ . . . . @ . . @ . . . @ . . 
. . . . . @ @ @ . . @ . @ . . . . . . . . . @ . . . . . . . . @ 
. . . . . . . . @ . . . . . @ . @ @ @ . @ . . . . @ @ @ @ . . . 
. . . . . @ . . . . . . . . . @ . . @ . . . . . . . . . . . . . 
. . . . . . @ . . . . @ @ . . @ @ . . . . . . . . . . @ . . . . 
@ . . . @ . . . . . . . @ . . . . . . . . . . . @ @ . . . . @ . 
. @ . . . @ . @ @ . . . . @ . . . @ . . . @ . . . . . . . . . . 
. . . . @ . . . . . . . . . . . @ . . . . @ . @ . . . . . . . . 
. . . @ . . . @ . . @ . . . . . @ . . . . . . @ . @ @ . . @ @ @ 
. . . @ . . @ . . . . . @ . . @ @ @ . . . @ . . . @ @ . @ . @ . 
. . . . . . . @ . . @ . @ . . . . . . @ . @ @ @ . @ . @ . . . . 
. . . . . . . . . . . . . . . . . . @ . . . . . @ . . . . . @ @ 
. . @ . . . . @ @ . @ . . . . . . @ . @ . . . . . @ . . . . . @ 
. @ @ @ . @ . . @ . . . . . . @ . . . . . . . . . . . . . . . . 
. . . . . . . . . . . . . . . . . . . . . . @ . @ @ . @ . @ @ . 
20
31 21 8 11
7 30 21 16
23 28 25 15
0 10 7 3
6 30 3 15
29 20 27 20
21 9 4 13
20 27 8 10
2 19 13 20
31 12 2 20
14 22 17 1
17 0 5 22
17 31 24 14
2 3 27 22
1 15 17 6
27 15 10 23
29 23 5 28
30 4 15 0
26 23 6 1
18 7 26 20
