32 32
. . @ . . . . . . . . . . . . . @ . . . @ . . . . . . . . . . . 
. . @ . . @ . . . . . . . @ . @ . . . . . . . . . @ . @ @ @ @ @ 
. . @ @ . . . . @ . . . . @ . . . . . . . . . . . . @ . @ . @ . 
. . . . . . . @ . @ . . . @ @ . . . @ . @ . . . . . . . @ . . @ 
. . . . . . . . . . @ . . . @ @ . . . . @ . @ . . . . . . . @ . 
. . . . . . @ . . . . . @ . . . . @ . . . . @ @ . . . . . @ @ . 
. @ . . . . . . . . . . . @ . . . . . . . . . . @ . . . . . . . 
. . . . . . . . . . . . . . . . . . . . @ . . . . @ . . @ . . . 
. . . . . . . . . . . . . . . . . @ @ . . @ @ . . @ @ . @ . . . 
. . @ . . @ @ . @ . . . . . . @ . . . . @ . . . . . . . . . . . 
. . @ . . . . . @ @ . . . . . . . . . @ . . @ . . . . . . . . . 
. . . . . . . . . . @ . @ . . . @ . @ . . @ . . . @ . . @ . . . 
. @ . . . . . . . . . @ . @ . . . @ . . . . @ . . . . . . . . . 
. @ @ . . . . . @ . . . . . . @ . . @ . @ . . @ . . . . . . . . 
. . . @ @ @ @ @ @ . . . . . . . @ . . @ . . . @ . @ . . . . . @ 
. . . @ . . . . @ . . @ . . . . . . @ . @ . . . . . . @ . . . @ 
. . @ . . . . . . . . . . . . . . @ . @ . . . . . . @ . @ . @ . 
. . @ . . @ . @ . @ . . @ . @ . . . . . @ . . . . . . . . . @ . 
. . . @ . @ @ . . . . . . . . . . . . . . . . . . . . . @ . . . 
@ . . . . . . . . @ . . . . . @ . . @ . @ . @ @ @ @ @ . . @ @ . 
. @ . . . . . . @ . . . . . . . @ @ . . . . . @ @ . . . @ . . . 
. . . . . @ . . . . @ . . . . . . @ @ . . @ @ . @ . . . . . . . 
. . . . @ @ . @ . . . . . . @ . . @ . . . . . @ . . @ @ . . . . 
. . . . . @ . . . . @ . . . @ @ . . . @ @ @ @ . @ . . . . . . @ 
. . . . . . . . . . . . @ . . . . . . . @ . . . . . . . . . @ @ 
. . . . @ . . . . . @ . @ . . . . . . . . . @ . . . . . . . . @ 
. . . @ . . . @ . . . @ . . . @ . . . @ . . . @ . . . . . . . . 
. . . . . @ . . . . . . . @ . . . . @ . . . . @ . . . . @ . . . 
. . . @ . @ . . . . . . . . . . . . . @ . . . . @ . . @ . . . . 
. @ . . . @ @ . . . . . . . . . . . . @ . . @ . . . . . @ . . . 
. . . @ . . . . . . . . . . . . @ . . @ @ . . . . . . . . . . . 
@ . . @ . . . . @ . . . . @ . . . . . . @ . . . . . . . . . . . 
50
15 15 5 7
25 27 1 17
5 15 2 8
0 13 27 7
8 3 2 18
19 25 26 17
31 26 7 28
15 18 6 16
1 26 17 27
12 16 22 9
2 22 7 21
29 2 6 17
6 19 7 6
25 25 28 21
12 14 17 31
1 23 10 7
30 12 16 5
18 30 22 31
25 23 29 18
0 28 5 25
25 6 7 8
17 31 10 10
7 28 26 20
29 20 31 21
6 31 5 31
24 7 18 6
11 9 25 29
4 9 14 15
21 15 24 10
3 19 28 12
31 18 14 31
12 15 1 10
9 14 17 1
19 20 4 27
28 17 15 15
5 19 30 21
26 17 30 25
0 3 10 15
2 15 18 4
17 0 0 28
12 22 3 19
9 28 18 5
23 29 27 12
14 19 22 6
18 6 20 6
27 12 31 22
14 12 28 26
0 23 24 5
21 20 30 18
21 16 12 31
