32 32
. . . @ . . . . @ . . . . . . . @ . . . . . @ . . @ . . . . . . 
. . @ @ @ . . . . . @ @ . @ . . . . @ . . . . . @ . . @ . . . . 
. . . @ @ . . . . . . @ . . . . . . . . @ @ . . . . . @ . . . . 
. . . @ @ . . . . . . . . . @ . . . . @ @ . . @ @ . . . @ @ . @ 
. . . . . . . . @ . . @ . @ . . . . @ @ @ . . . . . . . . . . . 
. . . . . . . . . @ . . . . @ . . @ . . . . . . . . . . . @ . . 
@ @ . . @ . . . . @ . @ . . . . . . . . . . . . . . . . . . . . 
. @ . . . . @ @ @ . . . . . @ . . . @ . @ @ . . . . . . . . . @ 
. . . . . . . . . . . . . @ @ @ . . . . . . @ . . @ . . . . . . 
. @ @ @ @ @ . . . . . . . . @ . . . . . @ . . . . . . . . . @ @ 
@ . . . . . . . . @ @ . @ . . @ . . @ . . . . . . . . . . @ . . 
. . . . . . . . . . . . @ @ . . . . @ . . . . @ . . . @ . @ . . 
. . . . @ . . . . . . . @ . . . . @ @ . @ . . @ . . @ . . . . . 
. . . . . . . . . @ @ . . . . . . . . @ @ . . . . . . . . . . @ 
. . . . @ . . . . . . . . . . . . . @ . . . . @ . @ . . . . . . 
. . . . . . . . . . . . @ . . . . . . @ . . @ @ @ . . . . @ . . 
. . . . . . @ . . . @ . . . . @ @ . . . @ . @ . . . . . . @ . . 
@ . . . . . @ . . . . . . . . . . @ @ . @ . . @ . . @ @ . @ . . 
. . . . . . @ . . . . . @ . . @ . @ . . . @ . . . . . . . . . . 
. . . @ . @ . @ . @ . . . . . . . . . . @ . . . @ @ . @ . @ . . 
. . . . . . . . . . @ @ @ . . . @ . . . . . . . @ . @ . @ . . . 
@ . . . . . . . . . @ . . . @ . @ . . . . . @ . @ @ . . . @ . . 
. . @ . . . . . @ . . @ . @ @ . . @ . . . . @ . . . . . . . . @ 
. . @ . . @ @ @ . . . @ . . . . . @ . . . . . . . . @ @ . . . . 
. . . @ . . . . . . . . . @ . . . . @ . . @ . . . . . . @ @ @ . 
. . . . . . . . . . . . @ . . . . @ . . . @ . . . . . . . . . . 
. . . . . . . . . . . @ . . @ . . . . . . . . . . @ . . . @ . . 
. . . . @ . . . . . . . . . . . . @ . @ . . . . . . . . @ . . . 
. . . @ @ . @ . . . . . @ . . . . . . . . . . . . . . . . . . @ 
. . . . . @ . . . . . . . @ @ @ . . . @ . . @ . @ . . . . @ . . 
. . . . . . . . @ . . . . . . . . . . . . @ . @ . . . . . . . . 
. @ . . . @ . . . @ @ . . . . . . . . . . . @ . . . @ . . . . . 
30
16 18 9 27
11 19 18 5
8 14 28 29
27 20 25 29
25 24 4 11
21 27 10 9
14 30 7 9
15 28 9 22
25 29 31 15
6 0 0 8
24 2 26 19
31 8 13 2
7 3 4 29
13 19 16 9
25 18 3 13
31 5 27 12
16 7 10 12
6 19 14 11
10 30 24 26
28 13 17 30
18 5 0 11
22 28 31 30
10 17 11 17
11 15 22 7
30 4 6 19
9 4 24 8
30 5 6 9
12 27 18 23
11 9 8 6
27 30 21 6
