32 32
@ @ . @ . . @ . @ . . . . . . . . @ . . . . . @ . . . . . . . . 
@ @ . . . . . . . @ . . . . . . @ @ @ . . . . @ . . @ . . @ @ . 
. . . . . @ . . . . @ . . . . @ @ . . . . . @ . . . . . . . . . 
. @ . . . . . . @ . . . . . . . @ . . . @ @ . . . . . @ @ . . . 
. . @ . . . @ . . . . . . @ @ . . . . . . . . . . . . . @ . . . 
@ @ . . . . . . @ @ . . . . . . . . . . . . @ . . . @ . @ . @ . 
. . . . . . . . . @ @ . . @ . @ . @ . . . . . @ @ . . . . . . @ 
. @ . . . . . . @ . . . . . . @ . . @ . . . . @ . @ . . . @ @ . 
. . . . . @ . . . @ . . . . . @ . . . . . . . . . . . . . . . . 
. . . . . @ . . @ . @ . . . . . . . . . . . . . . @ . . . @ . . 
. . . . @ . @ @ . . . . @ . . . . . . . @ . . . . . . . . @ . @ 
. . . . . @ . . . . . . . . . . . . . . @ . . . @ . . . . . . . 
@ . . . . . . . . . . . @ . . . . . . . . . . . . . . . . . . . 
. . . . . @ . . . . . @ . . . . @ . @ . @ . @ @ . . . . . . . . 
. . . . . @ @ . . . . . . . . . . . . . . . . @ . . . . . . . . 
. . . @ . . @ . . . @ @ . . . . . . . @ . . . . . . . . . . . . 
. . . . . . . . @ . . . . . . . . @ . . @ . . . @ . . . . . . . 
. . @ . . . . . . . . . @ . . . . @ @ . @ @ . . @ . . @ . . . . 
. . . @ @ . . . . . . . . . . . . . . @ . @ . . . . . . . . . . 
. @ @ . @ . @ . . . . @ . . . @ @ @ . @ . . . . @ . . @ . @ . . 
. @ @ @ . . . @ . . . . @ . . . @ . . . . . . . @ . @ . . @ . . 
. . . . @ . @ . . . @ . . . @ . . . @ . . @ . . . . . @ . . . . 
@ . . @ . @ . . . . . . . . . . @ . . . . . . @ . . . @ . . . . 
@ @ . . @ . . . . . . . @ . . @ . . . . . . . @ . . . . . @ . . 
. . . @ . . . @ @ . . . . . . . . . @ . . . . . . @ @ . . . . . 
@ @ . . . @ . @ . . . . @ . . . . . @ . @ . . . . . . . . . . . 
. . . . . . @ @ . . . . . . . . @ . . . . @ @ . . . . . . . . . 
. . . . . . . . . . @ . . . . . . @ . . . . . . . @ . @ . . . . 
. . . . . . . . . . @ . . . @ . . @ @ . . . . @ @ . . . . @ @ . 
@ @ . . . @ . . . . . . @ @ . @ . . . @ . @ . . . . . . . . . . 
. @ @ . . . . . . . . . . . @ @ . @ . @ . @ . @ . @ @ . . . . . 
@ @ . . . . . . . . . . . . . . @ . . . @ . . . . @ . @ . . . . 
80
10 14 27 29
24 7 22 30
13 25 31 15
15 20 2 24
8 10 10 5
17 24 16 14
11 0 9 29
23 17 30 16
23 18 19 24
4 16 10 1
7 13 19 4
26 14 19 17
12 30 20 2
20 15 14 9
10 8 21 13
15 9 20 18
10 7 25 3
24 9 15 25
27 14 26 10
9 28 27 5
29 24 23 24
0 15 8 8
14 0 2 18
0 10 16 4
13 1 28 7
15 31 30 20
28 7 17 9
28 17 21 31
2 10 15 14
17 10 22 28
31 26 14 24
1 28 15 4
29 17 9 27
30 26 4 0
25 3 16 25
16 24 7 30
14 3 23 10
7 7 19 9
22 12 7 18
27 12 25 29
6 5 15 10
1 22 30 17
22 31 14 16
3 17 3 21
3 7 9 30
2 3 31 8
4 5 9 25
2 25 31 23
17 3 11 27
15 10 16 17
27 23 19 6
5 1 13 21
7 6 27 18
13 11 30 0
4 20 31 26
15 15 13 18
15 12 11 29
17 25 11 24
22 29 24 3
0 8 5 21
1 10 4 16
13 20 11 26
16 8 2 27
2 16 2 1
8 4 29 21
9 21 31 21
9 0 18 12
22 24 29 6
28 9 4 20
17 31 15 27
7 5 10 31
16 14 20 12
18 3 29 15
15 14 4 29
21 31 23 26
2 5 30 6
5 4 0 27
23 15 31 5
7 17 18 4
10 25 2 12
