32 32
. @ . . . . @ . . . . . . . @ . @ . . @ . . . . . . . . . . . . 
. @ . . . . . . . . @ . . . . . . . . . . . @ . . . @ @ @ . . @ 
. @ . . . . . . . . . . . . . . . . @ . @ . @ . . @ . . @ @ . . 
. . . @ . . . . . @ . . . . . . . . . . . @ . . @ . . . . . . . 
. . . . . @ . . @ . . . . @ . @ . . . . . . . . @ . . . . . . @ 
. . @ @ . . @ . . @ @ . . . @ . . . @ @ . . . @ . . @ . . . . . 
. . . . . @ . @ . . . . . . . . . @ . . . . . . @ . @ . . . . @ 
. . . @ @ . . . . . . . . @ @ . . . . @ . . . @ . . . . . . . @ 
. . . @ . . . . . . . . . . . . . @ @ . . . . @ . . . . . . . @ 
. . @ . . . . . . . . . . . . . @ . . . @ @ @ . . . . . . . . . 
. . . . . . . . . . . @ . . . . . . @ @ @ . . . . @ @ @ . . @ . 
. . . . @ . . . . . . . . . . . @ . @ . . . . . @ @ . . @ @ . . 
. . . @ . . . . . @ . . . . . . . . . . . . @ . @ . . . @ . . . 
@ . . . . . @ . @ . . . . @ @ . . . . . . @ . . . . . . . @ @ . 
. @ . . . . @ . . @ . . . . . . . . . . . . . . . . . . . . . . 
. @ @ . . . . . . . @ . . . . . . . . . . . . . . . . @ . . . @ 
. @ . . @ @ @ @ . . . . . . . . . . @ . . . . @ . . . . . @ . @ 
. . @ . . . . . . @ @ . . @ @ @ @ . . . . . . . @ . . . @ . . . 
@ . @ . . @ . . . . @ . @ . . . . . . . . @ . . . @ . @ . . . . 
. . . . . . . . . . . . . . @ . . . . . @ . . . @ . . . . . . @ 
. . . . @ @ . . @ @ . . . . . . @ . . . . @ . @ @ . . . . . . . 
. @ . @ . @ . @ . . . . . . @ . . . . . . . . . . . @ . . @ . . 
. . . . . . . . . . @ . . . . . @ @ . . . . . . @ . . . . . . . 
. . . . . . . @ . . @ . . . . @ . . . . . . . . @ . . . @ . . . 
. . . . . . . . @ . . . . . . . . @ . . . @ @ . . . . @ . @ . . 
. . . . . . @ . . @ . . . . @ . . . . . . . . . . . . . @ . . . 
. . @ @ . . . . . . . @ . . . . . . @ . . @ . . . . . @ . . . . 
. . . . . @ @ @ . . @ . . @ @ @ . . . . . . @ . . @ . . . . . . 
. . . . . . . . . . . . . @ . . . . . . . . . . . . . @ . . . . 
. @ . @ . . @ @ . @ . . @ . . . . . . . . . @ @ . @ . . @ . . . 
. . @ . . . . . . . @ @ . @ . . @ . . . . . . . . . . . . . . . 
@ @ . @ . @ @ . @ . . @ . @ . . . . @ . . . . . . . . . @ . . . 
80
15 15 18 14
19 27 19 17
22 28 1 6
19 6 6 2
2 7 26 8
17 12 9 9
26 19 0 29
30 14 8 16
1 12 0 14
11 4 17 31
30 5 28 30
25 22 13 10
1 8 14 8
21 25 29 15
5 19 26 0
2 2 31 24
0 7 26 4
0 1 23 9
8 18 7 12
25 16 25 4
3 19 30 26
4 15 11 9
20 8 25 7
0 8 8 21
14 31 11 15
31 10 11 1
18 4 1 23
30 30 22 31
16 1 28 0
26 28 1 9
13 8 9 6
28 19 28 8
29 12 14 20
10 6 16 13
31 23 19 9
22 5 25 1
16 13 27 0
16 10 24 31
0 24 26 16
24 28 20 5
4 17 27 29
23 1 31 5
7 17 28 16
8 10 29 28
8 15 11 2
27 17 25 24
21 12 26 20
26 22 19 3
10 2 27 17
18 13 6 1
1 23 0 5
25 30 10 12
23 27 7 26
5 7 2 16
31 0 7 18
26 15 6 8
30 8 27 31
5 11 6 23
16 2 19 8
11 5 2 6
19 20 19 14
15 5 5 25
3 17 12 28
12 4 12 10
3 23 26 27
25 7 9 22
27 8 16 4
22 19 13 25
19 4 24 8
15 24 22 6
0 30 0 15
6 28 17 0
7 30 8 9
29 26 8 6
24 2 4 23
1 13 5 2
25 28 25 23
20 28 24 27
19 30 17 9
28 4 29 0
