32 32
@ . . @ . . . . . . . . @ @ . . . . @ . @ @ . . . . . . . . . . 
. . . . . . . . @ . . . . @ @ @ . . . . @ @ . . @ @ . . . . . . 
. . . . @ . . @ @ . . . @ @ . . . @ . . . . . @ . . . . . @ . . 
. . . . . . @ . . . @ . . . @ . . . . . @ . . . . . . . . @ . . 
@ . . . . @ . . . . @ . . . . . @ . . . . . . . . . . . . . . . 
. @ . . . . . @ @ @ . . . . . . . . . . . . @ . @ . . @ . . . . 
. . . . @ . . @ . . . . . . @ @ . . @ . . . . @ @ . . . . . . @ 
. . . . @ . . . . . @ . @ @ . . . . . @ . . @ @ . . . . . . . . 
. . . . . . . @ . . . . . . . . . . . . . . @ . . . @ . . . . . 
@ . . . . . . @ . . . . . @ @ @ @ . . . . . . . . . . . . . @ . 
. @ . . @ . @ . . @ @ . . . . @ @ @ . . @ . . . . . . . . . . . 
@ . . . . . . . . . . . . . @ . . @ . . . . . . . . . . . . . . 
. . . . . . . @ . . @ @ . . @ . . . . . . . . . . @ . @ . . @ . 
. . . . . . . . . . . . @ . @ . . . . . . . . . . . . . . @ . . 
. . @ . . . @ . . . @ . . . . . . @ . . @ . . . . . . . . @ . . 
@ . . . @ . . . . @ . . . . @ @ @ . . . . . . . . . . . . . @ . 
. . . . . . . . . . @ . @ . . . . . . @ . . . . @ . @ . . . . . 
. @ @ . . . . . @ . . . . @ . . @ . @ . . @ . . . . @ . . . . @ 
. . . @ . . . . . @ . . . . . . . @ . . . @ . . . @ . . . . @ . 
@ . @ @ . @ . @ . . . . . . @ . . . . . @ . . @ . . . @ @ . . . 
. @ . . . . . . . . . . . . . @ @ . . @ @ . . . . @ . . @ . . . 
. . . . . . . . . . . . . . . . . . . @ . @ . . . . . . . . @ @ 
. @ . . . . . . . . . @ . . . . @ . . . . . . . . . . @ . . . @ 
. . . @ . . @ . . @ . @ @ . . @ @ @ @ . . . . . . . . . . . . . 
@ @ . . . @ . . . @ . . . . . . . @ . . . @ . . . @ @ . @ . . . 
. . . @ . . . . . . . . @ . . . . . . . . @ @ . . @ . . . . @ . 
. . . . . . . . . . @ . . . . . @ . . . . . . . . . . . @ @ . . 
. . . . @ . @ . . . . . . . . . . . . . . @ . . . . . . . . . . 
. . . . . . . . . @ . . . . . @ . . @ @ . . . . . . . . . . @ . 
@ @ . . @ . . . . . . . . @ @ . . . . . @ . . . . . . . . . . . 
@ . . @ . . . . . . . @ . . . . . . . @ @ . @ . @ . . . . @ . . 
. . @ . . @ @ . . . @ @ . . . . . . . . @ . . @ @ . . . . . . @ 
30
0 22 8 19
30 30 30 6
4 20 13 16
20 13 26 2
1 21 23 22
30 14 17 12
5 7 20 9
3 13 26 27
12 9 6 16
3 21 29 10
11 21 12 12
4 3 27 24
18 24 30 20
6 9 0 31
0 21 31 7
18 20 30 5
16 8 27 17
14 16 11 15
21 19 23 17
4 17 22 9
5 1 26 15
17 8 25 21
0 16 25 4
13 27 18 18
21 15 6 7
24 26 10 17
19 10 0 22
14 26 21 2
14 22 28 15
31 1 27 21
