32 32
. . @ . . . . . @ . . . . . . . . . . . @ . . . . . . . . @ . . 
. . . . . . . . . @ @ @ . . @ @ . . . . . . @ . . . . @ . . . . 
@ . . . . . . . . . . . @ . . . . . . . @ . . . . . . . . . . . 
. . . . . . . . . . . . . . . . . . . . @ . @ . @ . . . . . . . 
. @ . . . . . . . . . @ . . . . . . . . . . . . . . . . @ . . . 
. . @ . . . . . . . . . . . . . . . . . @ @ . . . @ . . @ . . . 
. . . . . . . . . . . @ . @ @ . . . . . . . . . . @ . . . . . . 
. . . . . . . . . . . @ . @ . . . . . @ . . . . . . . . . . . . 
@ @ @ . . @ . . . . . . @ . . . . @ . . . . . @ . . @ . . . . . 
. . . . . . . @ . . . . @ @ . . . . @ . @ . . . . @ @ . . @ . . 
. @ . @ . . . . . . . . . @ . @ @ . . @ . . . @ . . @ @ . . . @ 
. @ . . . @ . . . . @ . @ @ . . . @ . . . . . . @ . . @ . . . @ 
. . . . @ . @ . @ . @ . . . . @ . . . . @ . . . . . @ @ . @ . @ 
@ . . . . . . . @ . @ . . . @ . . . . . @ @ . @ . . . @ . @ @ . 
. . . . . . . . . . @ . . @ . . . . @ . @ . . . @ . . @ . . . . 
. . . . @ . . . @ . . @ . . . . . . @ @ . . . . @ . . . . . . @ 
@ . @ . . . . @ . . . . @ . . @ . . . . . . . . . . . . . . . @ 
@ . . . . @ . . . . . . . . . @ . . . . . . . . . @ . . . . . @ 
. . . . @ . @ . @ . . @ @ . . . @ . . . . . . . . . . . @ . . . 
. . . . . . . . @ . . . @ . . . . @ . . @ . . . . . . . . @ @ . 
. . . @ . . . . . . @ . @ @ . . . . . . . . . . @ . . @ . . . . 
. @ . . . . . . . . . @ . . . . @ . @ . . @ . . . @ . . . . . . 
. . . @ . . . . @ . @ . . @ @ @ . . @ . . . @ . . . . . @ . . . 
. . . . @ @ . . . @ . . . . @ . @ . . . @ . . . . . @ . @ @ . . 
. . . . @ @ . . . . . @ . . . . . @ . . . . . . . @ . . . . . . 
@ . . @ . @ @ . . . @ @ . @ @ . . . . . . . . . . . . . . . . . 
. . . . . . @ @ . . . @ @ . . @ . . @ @ . . . . . . . . . . . . 
@ . . . . . . @ @ @ . . . . . @ . . @ . . . . @ . . . . . . . . 
@ . @ . . . . . . . . @ . . . . . . . . @ . . @ . . . . . . . . 
. . . . . . . . @ . . @ . . . @ . @ . @ . . . @ . @ . @ . . . . 
. . . . . . . . . @ . . . . @ . . . . . @ . . @ . . . . . . . @ 
. . . @ . . @ . . . @ . . @ . . . . . . . . . . @ . . . . . . . 
90
19 6 0 29
15 14 4 10
0 31 23 18
24 27 5 10
14 21 18 8
2 14 17 31
14 5 31 3
1 7 25 31
20 22 21 10
29 24 20 25
27 8 15 7
31 0 1 12
25 22 16 14
28 26 22 16
14 9 16 11
10 2 4 0
22 4 21 29
28 9 18 18
17 3 24 2
21 4 15 3
10 26 29 24
0 12 28 7
12 22 14 10
7 0 1 16
12 4 4 30
30 7 19 16
19 30 12 0
27 28 2 12
5 14 6 6
11 2 30 9
30 17 0 24
14 14 17 21
16 24 30 22
23 1 26 31
29 18 3 2
30 18 5 1
17 31 13 5
6 14 16 27
26 28 17 2
29 15 21 14
1 15 24 24
3 3 3 27
20 1 4 8
27 0 13 13
16 3 30 25
19 14 8 1
3 6 3 30
18 17 6 3
26 31 7 6
27 25 13 12
1 20 19 30
17 4 29 8
29 8 6 20
4 8 21 30
11 0 22 14
0 1 0 19
16 26 23 24
31 8 15 28
24 18 12 6
0 20 27 3
26 11 7 8
13 24 10 7
28 15 20 27
15 23 6 7
0 10 11 10
17 28 26 14
31 31 31 27
2 15 30 21
27 27 24 17
18 25 20 16
25 0 5 7
2 4 9 29
3 12 9 6
1 26 2 20
7 21 6 13
23 12 2 17
30 25 21 17
22 25 26 11
16 22 13 16
19 21 26 19
28 16 4 16
27 7 13 0
24 30 16 4
9 22 16 17
0 29 5 18
11 19 15 15
18 12 24 25
10 16 8 4
7 30 31 7
9 17 7 3
