32 32
. . . . . . . . @ . . . . . . @ . @ @ . . @ . . . . . . @ . . . 
. . . . @ @ . @ . . . . . . . . . . . . . . . . @ @ @ . . @ . . 
. @ . . . . . . @ . . . . . . . . @ . @ . . @ . . . . . @ . . . 
. @ @ . @ . . . . . . . @ . . . . . . . . . . . . . . . . . . . 
@ . @ . @ . . . . . . . . . . . @ . . @ . @ . . . . . . . . . @ 
. . @ @ . @ . . . . @ @ . . . . . . . . @ . . . . . @ . . . . . 
. . @ . . . . . @ . @ @ . . @ @ . . @ @ . . . . . . . . . . @ . 
@ . . . @ . . . . . . @ @ . . . . . . @ . . @ . . . . @ . . @ . 
. @ . . @ . @ . @ . . . . . . . @ . . . @ . . . . . . . @ . @ . 
. @ . . . . . @ . . . . @ . . . @ . . . . @ . . . . . . @ . . . 
. . . . . . . . @ @ . . @ . . @ . . @ @ . . . . . . . @ . . . . 
. . @ . . . . . . . . . @ . @ . . . . . @ . . . . . . . . . @ . 
. . @ . . . @ . . . . . . . @ . . @ . @ . . . . . @ . @ . . . . 
. @ . @ @ @ @ . . . . . @ @ @ . . . @ . . . . . . @ . . @ . @ @ 
@ . . @ . @ . . @ @ . . . . @ . . . . @ . . . . . @ . . . . . . 
. . @ . . . . . . . @ . . . . @ . . . . . @ . . . . . . . . @ . 
. . . . . . . . . @ . @ . . . . . . @ . @ @ . @ . . @ . . @ . . 
. . . . . . . @ . . . . . @ . . . . . . . @ . . . @ @ . . @ . . 
. . . . @ . . . @ . @ . @ . . . . . . . . . . . . @ . . . . . @ 
. . . . . . . @ . . . . . . . @ . @ . . . . . . . . . . @ . . . 
. . . . . . . . . . . . . . @ . . @ @ @ . . . @ . . . @ @ . . . 
. @ @ . . @ . . . @ . . . . . . @ . . . . . . . . . . . . @ . . 
. . . . . @ . @ . . @ @ . . . . . . @ . . . . . . . . . . . @ . 
. . . . . . @ . . . . @ @ . . . . . . . . . @ . @ . . . . . . . 
. . . . . . . . . . . . @ . . @ . . . . . . . . . . . . . . . . 
. . . . . . . . . @ . . @ @ . @ . . . . . . . . . . . @ . . . @ 
. @ . @ . . . . @ . . . @ . . . @ . . . . . @ . . . @ . . . . @ 
. . . . . . . . . . @ . @ . . . . . . @ . . . . . @ . @ @ . @ . 
@ . . @ . . . . . . . . . . . . . . @ . . . . . . . . . . . . . 
. . . . . . @ @ @ @ @ . . . . . . . . . . @ . . . . . . . . . . 
. @ . . . . @ . . . . . @ . . . . . . . . . @ . . @ . . . . . . 
. . @ . . @ . . . . . @ @ . . . . . . . . . . . . . . . . . @ @ 
70
31 1 25 3
23 24 15 14
5 27 14 18
14 18 28 16
19 16 1 0
22 9 25 19
1 0 22 9
16 3 25 10
4 26 8 1
7 3 29 29
30 5 28 11
3 15 17 31
12 16 1 31
23 19 16 7
18 31 2 2
20 13 7 31
10 13 9 4
8 31 9 11
13 9 22 16
30 14 27 28
14 1 29 19
17 4 1 17
24 31 4 0
15 27 5 18
31 0 21 28
29 14 21 14
17 28 15 8
15 5 30 26
9 19 22 27
2 2 29 14
27 8 9 8
27 23 21 10
23 12 26 14
13 1 13 26
31 23 15 20
13 28 27 14
8 30 2 0
30 18 12 15
4 31 16 12
4 30 18 19
13 19 28 4
19 9 26 27
15 13 19 0
23 6 27 17
24 18 0 25
1 22 8 23
28 22 7 14
24 6 17 23
14 16 25 7
20 17 21 1
16 13 6 25
2 7 20 23
4 10 1 18
1 28 31 6
11 14 11 25
17 31 28 10
14 24 25 22
25 28 20 15
7 0 29 25
14 8 26 7
20 23 24 21
16 20 5 16
10 19 22 8
4 23 27 22
9 6 2 29
22 0 7 18
4 6 4 21
27 13 2 1
10 0 6 3
27 3 30 2
