32 32
@ @ . . . . . . . . . . . . . . . . @ . . . @ @ . . @ . . . . @ 
. . @ . . . . . . . @ . . . . . . @ . . . . . . @ . . . . . @ . 
. . . @ . . . . @ @ . . . . . . . . . . . . . @ @ @ . . . . . . 
. . . @ . . . . . @ . . . . . . . . . . . . . . . @ . . @ . . . 
@ . @ . . @ . . . . . @ . @ . . . . . @ @ . @ . . . . . @ . . . 
. . . @ @ . . . . @ @ . . . . . . @ . . . . . @ . . . @ . . . @ 
@ . . . @ . . . @ . . . . . . . . . @ . @ . . . @ . . . @ . . . 
. . . . . . . . @ . . . @ . . . . . . . . . @ . @ @ . . . @ @ . 
. . . . @ . . . . . . . . . . @ . . . . . . . @ . . . . . @ . . 
. . . . . . . @ . . . . . @ . . . . . . . @ . @ . . . . . @ . . 
. . @ @ . . @ . . @ . @ @ . @ @ . . . . . . @ . . . . . . . . . 
. . . @ . . . . . . . . @ . . . @ @ . . . . . @ @ @ @ . @ @ . . 
. . . . . . . . . . @ @ . . . . @ . . . @ . @ . . . . . . . @ . 
@ . . @ . . . @ . . . . . @ . . @ . . . @ . . . . . @ . @ . . . 
. @ . . . . . . . @ . . . . . @ . . @ . . @ . @ . . . . . @ . . 
. . @ @ . . . . . . . . . @ @ . . . . . . . . . @ . . . . . . . 
. . . . . . . . . . . . . . @ . . . . @ . . . . . . . . @ . . . 
. . . . . . . . . . . . . . . . @ . . . . . . . . . @ . . . . @ 
. . . @ . . . @ @ . . . . . . @ @ . . . @ . . @ . . . . . . @ . 
. . . . . . . . . . . @ . . . . . . . . . . . @ . . . . . . @ . 
. . @ . . . @ @ . . @ @ @ . . @ . . . . . . @ . . @ . . . . @ . 
. . @ . @ . . @ . . . . . @ @ . . @ . . @ . . @ . . . . . . . . 
. . @ . . . . . @ . . . . . . . @ . . . @ . @ . . . . . @ . . @ 
. @ . . . . @ . . . @ @ . . . . . . . @ . . . . . . @ . . . @ . 
. . @ . . . . @ . . . . . . . @ . @ . . . . @ . . . . . . . . . 
. . . . . . . . . @ . . . . . . . . . . . . @ . . . . . . . . . 
. . . . . . . . . . . . . . . . . . @ . @ . @ . @ . . @ @ @ . . 
. . . . . . . @ . . . . . . @ @ . . . @ . . . . . . @ . . . . . 
@ @ . @ . . . . . . . @ . . @ @ . . @ . . @ . . . @ @ . @ . . . 
. . @ . . . . . . . . @ . . . . . . . @ @ . @ . . . . . . . . . 
. @ . . . . @ @ . . @ @ . . . @ . . @ . . . . . . . @ @ . . . . 
. . . . . . . . . . . . . . @ @ . . @ . . . . . . . @ . . . . . 
50
28 2 22 19
3 26 22 17
8 4 11 7
9 19 18 22
26 22 30 22
3 0 22 3
10 0 6 26
0 26 7 11
5 22 8 14
5 9 19 18
6 6 1 25
12 3 18 1
27 28 31 23
29 2 15 19
30 8 28 19
3 6 10 8
18 12 28 9
16 10 0 21
23 1 3 30
25 10 17 2
0 27 12 17
6 4 27 12
19 28 13 2
25 13 29 13
30 15 29 15
19 2 21 23
24 30 22 11
24 20 29 12
6 11 10 3
10 31 28 8
19 21 27 28
15 9 7 1
17 16 10 31
28 23 3 8
4 27 10 7
17 3 1 13
21 23 10 19
24 13 14 19
8 21 9 28
8 10 18 3
15 15 14 3
31 2 1 5
4 3 8 8
10 24 13 7
23 10 5 27
21 19 9 7
8 24 24 3
7 14 7 3
12 22 29 2
29 19 20 31
