32 32
. . . . . . . . . . @ . . . . @ . . . . . @ . . . . . . . . @ . 
. . . @ . . . . . . . . . . . . . . . . . . . . @ . . @ . . . . 
. @ . . . . . . . @ . . . . @ . . . . @ . . @ . . . . @ . . @ . 
. . . . . . . . . . @ @ . @ . . . . @ . . . . @ . . . . . . . . 
. . . @ . . . . . . . . @ @ . . . . . @ . . . . . @ . . @ . . . 
. @ @ . @ . . . . . . . . . . . @ . . . @ . . . . . . . . . . . 
. . @ @ . . . . . . . . . . . @ @ . . . . @ @ @ . . . @ . . @ . 
. . . . @ @ @ . . @ . . . . . . . @ . . . . . . @ . @ @ . . . @ 
. . . . . @ . . . . @ . . . @ . . . @ @ . . . . . . . . . . . . 
. . @ . . . . . . . . . . . @ @ . . . . @ . . @ . @ . @ . @ . . 
. @ . . . . @ . . . . . @ @ . . . . . . . . . . . . @ . . . @ . 
. . . . . @ . . . @ . . . . . . . . . @ @ . . . . . @ . . @ . . 
@ . . . . . . @ . . . . . . . . . . . . @ . . . @ . @ . . . . . 
. . . . . . . . . . . . . @ . . @ . . . . @ @ . . . @ . . @ . . 
. @ . . . . @ . . @ . . . . . . . . @ . . . @ @ . . . @ . . . . 
@ . . . @ . . . . . . . . . . . . @ . @ . . @ @ . . . @ @ . . @ 
. . . . . . . . . . . @ . . . . @ . . . @ . . . . . . . . . @ . 
@ . . . . . . . . @ . . @ @ . . . . . . . . . @ . . . . . . . . 
. . . . @ . . . . . . . . . . . @ . . . @ . @ . . . @ @ . @ @ . 
. . . . @ . @ . . @ . . . @ . @ . @ . . . @ . . . . . . @ . . . 
. . . . . . . . . @ . . . . . . . @ @ . . @ . . . . . @ . . @ . 
. . . . . . @ . @ @ . . . . . @ @ . . @ . @ . . . . . @ . . @ . 
. . . @ . . . . . . . . . . . . . . . . . . @ . . . . . @ @ . @ 
. @ . . @ . @ . . . . . . . . . . . . . . . . @ . . @ . . . . . 
. . . . . . . @ @ . . . . . @ . . . . . . . . . . . @ . . . . @ 
. . . . . . . @ . @ . . @ @ @ @ . . . . . . . @ . . . . . @ . . 
. . @ . . . . . . . . . . . . . . . . . @ . . @ . . . . . . . @ 
. . . . . @ . @ . . . . . . . . . . . . . . . . . . . @ . . . @ 
. . . . . @ . . @ @ @ @ . . . . . . . . . . . . . . . . . . . . 
. . . . @ . . @ . . . . . . . @ . . . . . @ . . . . . . @ @ . @ 
. @ . . . . @ . @ . @ . . . . . . . @ @ @ @ . @ @ . . . . . @ @ 
. . . . . . . . . . . @ . @ . . . @ . @ @ @ . @ . @ . . @ . . . 
60
18 22 14 19
11 13 0 19
22 1 29 10
27 4 6 24
25 27 2 4
0 30 7 9
3 17 15 22
18 9 22 1
8 16 9 4
5 25 8 16
18 27 13 11
24 15 26 5
20 19 11 13
6 26 1 7
27 13 5 9
21 11 10 26
24 18 16 25
22 11 27 28
20 17 9 13
3 25 11 8
12 28 3 11
29 16 28 11
27 16 16 28
2 21 8 6
0 1 2 25
25 1 29 4
15 22 0 21
18 23 27 30
28 16 3 28
17 8 17 14
4 24 9 3
13 15 12 23
28 3 21 14
6 5 5 18
30 28 25 14
27 19 24 0
8 1 6 0
12 9 12 20
1 29 14 30
2 4 1 29
10 27 4 24
17 30 29 20
12 20 9 22
22 17 18 28
8 17 4 11
0 11 5 3
28 12 12 11
3 15 25 8
6 12 26 3
14 17 17 16
28 24 28 6
6 11 30 3
11 15 22 21
3 20 10 17
24 16 0 3
8 13 17 4
7 3 17 21
22 23 13 28
4 4 25 28
25 5 0 0
