32 32
. @ . . . . . @ . . . . . . . @ . . @ . . . @ . . @ . . . . . . 
. . . @ . . @ . . . . . . . . . . . . . @ . . . . . . . . . . @ 
. . . . @ . . . . . @ @ @ . @ . . . . @ . @ . . . @ . @ . . . . 
@ . . . . . . . . . . . . . @ . . . . @ . . . . @ . @ . @ . . . 
. . @ . . . . @ @ @ . . . . @ . . . . . . . . . . . . @ . . . . 
. . @ . . @ . . . . . . . . . . . . . . @ @ @ . . . . . . . . @ 
. . . . . . @ . . . @ . @ . . . . . . . . . @ . . . . . . . . . 
. . . @ . . . @ . @ . . . @ . . . . @ . . . . . . . . @ . . . . 
. @ @ . . . . . . @ @ . . @ . @ . . . . . @ . @ . @ . @ . . . . 
@ . @ . . . . . . @ . @ . . . . . . . . . . . . . . @ . . @ . . 
. @ . . . . . @ . @ . . . @ . @ . . . @ . . . . . . @ . . @ . . 
. . . . . . . @ . . @ . . @ . . @ . . . . . . . @ . @ . @ . . . 
. . . @ . . . . . . . . @ . . @ @ . . . @ @ . . . . . . . . . @ 
. @ . . . @ . . . . . . @ . . @ @ @ . . . @ . . . . . . . . . . 
. . . . . . . . . . . . . @ . @ . . . . . @ . @ @ . . . . . @ . 
@ @ @ . . . . . . . @ . . . . @ . @ . . . . . . . . . . . . . . 
. . . . . . . . @ . . . . . . . @ @ @ . . @ . . . . . . @ @ . . 
@ . . . . . . . . . . . . . . . . @ . @ @ . . @ . . . . . . @ . 
. . . . . . . . . . . . . @ @ . . . . . . . . . @ . . . @ . . . 
. . . . . @ @ . . . @ . . . @ . @ . @ . . . . @ . . @ @ . . . @ 
. . . . . . . . @ . . . @ . . . @ . . . . . . . . . @ . @ . . . 
@ . . . . . . . . . @ . . @ . . . . @ . . . @ . . . . . . . . . 
. . @ . . . . . . . . . . . . . . . . . . . . . . . @ . . . . @ 
. . . . . . . . . . @ . . . . . . . . . . . @ . . . . . . . @ . 
. . @ @ @ @ @ . . . @ . @ @ . . @ . . . . . . . . . . . . . . . 
. . . @ @ . . . . @ . . . . . . . . . . . . . . . . . . . . . @ 
. . @ . @ @ . @ . . . @ . . . @ . . . . . . @ @ . @ . . . @ . @ 
@ . . . . . . . @ . . . . . . . . . @ @ @ @ . . @ . . . . @ . . 
. . . . . . . . @ . . @ . @ . . . . . . . . . . . . . . . . . . 
. @ . @ . . . . . @ . . . . . . @ @ . . . . . . @ . . @ . . . . 
@ . . @ . . . . @ . . . . @ . . . @ @ . . @ . . @ . . . @ . . . 
. . . . @ . . . . . . . . @ . . . . . @ . . @ . . . @ . . . @ . 
80
28 1 16 15
2 29 3 11
1 2 20 10
14 22 5 14
22 11 1 20
20 23 28 9
12 9 28 31
5 29 5 27
27 16 29 28
15 24 24 31
14 0 27 20
24 10 12 23
1 6 27 16
17 1 6 12
6 23 24 16
27 15 18 23
20 14 17 27
5 11 24 23
27 6 14 14
30 25 28 21
24 17 17 21
4 22 11 6
10 9 14 7
14 23 3 2
4 12 16 3
14 9 30 30
13 5 31 3
12 22 14 11
12 18 30 27
21 31 0 20
24 31 27 1
15 30 30 26
27 24 23 16
30 12 20 16
7 14 30 13
7 8 6 22
26 29 3 5
13 15 8 2
26 8 18 4
28 27 14 20
19 16 31 27
0 10 15 30
22 1 28 7
25 7 20 22
16 30 2 11
30 15 8 19
0 8 3 19
23 1 22 10
1 17 14 28
26 16 29 6
4 7 11 20
25 24 20 21
11 5 26 14
13 20 27 21
3 22 2 10
31 3 0 11
7 1 8 9
8 3 8 23
0 6 21 21
23 28 2 1
2 11 21 4
18 11 30 6
15 5 23 22
12 17 5 22
24 26 6 4
31 18 30 0
23 3 27 22
2 14 4 21
20 9 4 11
29 6 12 8
0 13 31 28
14 5 27 30
1 7 3 28
0 29 20 18
19 7 9 1
2 19 10 28
21 22 29 23
6 5 27 31
3 17 7 9
17 26 29 1
