32 32
. @ . . . . . . . . . . . . . . . . . . @ . . . . . . . . . . . 
. . . . . @ @ . @ . . @ . . @ @ . . . . . . . . . . . @ . . @ . 
. . . . . . . . . . . . . . . . . @ . . . . . @ . . @ @ @ . . . 
@ @ . . . . . . . . @ @ . . . . @ . . . . @ . . . . . . @ @ . . 
. . . @ . . . . @ @ @ . . . . @ . . . . @ . . @ @ . . . @ . . . 
. @ . @ @ . . . . . . . @ . . . . . . . . . . . . . . . . . . . 
. . . @ . . . . . . . . . . . . . . . . . . . . @ . . @ . . . . 
. . . @ . . . . . . @ . . . @ @ . @ . . . . . . . . @ . . . @ @ 
. . . . . . . . @ . . . . . . @ . . @ @ . . . . . . . @ @ @ @ . 
. . . @ . . . @ . . . . @ . . . . . . . @ . . . . . . @ . . . . 
. . . . @ . . . . . . . . . @ . . . @ . . @ . @ . . . . . . . @ 
. . @ . . @ . . @ @ @ . @ . . . . . . @ . . . . . . . . . @ . . 
. . @ @ @ . @ . . . @ . . . . . @ . . . @ . . . . @ . . @ @ . . 
. . . . . @ @ . . . . @ @ . . . @ . . . . @ . . . . . . . . . . 
. @ @ . . @ . . . @ . . @ . . . . . . . . . . . . . . . . . . . 
@ . @ . . @ . . . . . . . . . . . . @ @ @ . . . . . @ @ . @ . . 
. . . @ . . . . . . . . . @ . @ . . . @ . . . . @ @ . . . . @ . 
@ . . . @ . . . . . . @ . . @ @ . . . . . . @ . . . . . . . . . 
@ . . . . . . . . . . @ . . . . . . @ . . . . @ @ . . . . . . . 
. . . . . @ . . @ . . . @ . @ . . @ . @ . . @ . . . . . . . @ . 
. . . @ . . . . . . @ @ . . . . . . @ . . . . . . @ . . . . @ . 
. . . . . . . . . . . . . . . . . . . . . . @ . . . . . . . . @ 
. . . . @ @ . . . . . . @ . . . . @ . . @ @ . . . . . . . . . @ 
. . . . . . @ . . . . @ . . . . . . . @ . . . . . @ . . . . @ . 
. . . . . . . @ . . @ . . . . . @ . . @ . . . . . . . @ . . @ . 
@ . . . @ . . . . . @ . . . . . . . . @ . . . @ @ . . . . . . . 
@ . . . @ . . . . . @ @ . . . . . @ . . . . . . . @ @ . . . . . 
. . . . . . @ . . @ . . . @ . . . . @ @ . . . . . . . . . . . . 
. @ . . . . @ @ @ . . . . . . . . . . . . . . . @ . . . . . . . 
. . . @ . @ . . . . . . @ . . @ . . . . @ . . . . . @ . . . . @ 
@ . . . . @ @ @ . . . . . . . . . . . . . @ . . . . . . . . @ . 
. @ @ . . . . . . @ . . . . @ @ @ . . @ . @ @ . . . @ . @ @ . . 
10
19 28 26 10
27 11 0 13
10 30 30 3
25 0 21 23
8 10 22 22
8 7 6 8
13 1 25 25
24 9 1 24
10 22 8 30
18 11 31 17
