32 32
. . . . . @ . . . @ . . . @ . . . . @ @ . . . . . . . @ @ . . @ 
. . . . . . . @ . . . . @ . . . . . . . . @ . . @ . . . . . . @ 
. @ . . . . . @ . . . . @ . @ . . . . @ . . @ . . . . @ . . . . 
. . . . . . . . . . . . . @ . . . . . @ . . @ @ . @ . . . . . @ 
. . . . . @ . . @ @ . . . @ . . . . . . . . . . . . . @ . @ @ . 
@ . . . . . @ . . . . . . . @ . . @ . . . . @ . . . . . . @ . . 
. . . . . . . . . . . . @ . . . . . . . . . . . . . @ . . . @ @ 
. . @ . . . . . . . . @ . @ . . . . @ . . . . @ . . . . . . . @ 
@ . . . . . . @ @ @ . . . . . . . . . . . . . . . @ @ . . . . . 
. . @ . . @ . . . . @ . . . . . . . . . . . @ . . . @ . . . . @ 
. @ @ @ @ . . . . @ @ . @ . . @ . . . . . . . . . . . . @ . . . 
. . . . @ @ . @ . . . @ . . . . . @ . @ . . @ . @ . @ . @ . . . 
. @ @ . . . . . . . . . . . . . . . @ . . . . @ @ . . @ . . . @ 
@ . @ @ . . @ . . . . . @ @ @ . . . @ . . . @ . @ . . . . . . . 
@ . . . @ . . . . . @ @ @ . . . . . . @ . . @ @ . . . . . . . . 
. . . . . . @ . . . . . . . . . . . . . @ . . @ @ . . . . . . . 
. . . . . . . . @ @ . . . . . . . . . . . . @ . . . . . @ . . . 
. @ . . . . . @ . @ . @ . . . . . . @ @ . . . . . . . . @ . . . 
. . . . . . . . . . . . . . . . . . . . . . . . . @ . . . @ @ . 
. . . . . . . . . @ . @ . . . . . . . . . . @ . . . . . . . @ . 
. . . . . . . . . . . @ . @ . . . . . . . . . . . @ . . . . . . 
. @ . . . . . @ @ . . . . . . @ . . . . . . . . . . . . . . . . 
. . . . . . @ @ @ . . . . . . . . @ . . . @ . . . . @ @ . . . @ 
. . . @ @ . @ . . . . . . @ @ @ . . @ @ . . . . . . @ . @ . . @ 
. . @ . . . . . . . . @ . . @ . . . . @ . . @ . @ @ @ . . . . @ 
@ . . . . . . . . @ . . . . @ . . . . . @ . . . . . @ @ . . . . 
@ @ . . @ @ . . . . @ . @ . . . . . . . . . . @ . @ . . . . . @ 
. @ @ . . . . . . . @ @ . . . @ . . . @ . . . . . . . . . @ @ . 
. . . . . . . @ . . . . . . . . . . . . . . . . . . . . . . . . 
. . @ . . . . . . . @ . . . . . . . . . @ . . . . @ . . . . . . 
. . . @ @ . . . @ . . . @ . . . . @ . . . . . . . . . . @ @ . . 
. . . @ @ . . . . . @ . . . . . . . @ . . @ @ . @ . . . . . . . 
70
18 22 20 13
27 26 27 31
2 25 18 21
23 5 0 10
31 28 7 0
1 9 6 30
15 0 29 3
26 28 29 1
6 1 29 31
29 15 16 19
4 3 19 25
20 16 29 8
23 0 30 22
2 8 9 13
23 4 13 9
12 19 23 0
22 18 1 9
27 9 24 16
8 25 26 19
29 2 14 17
18 8 2 25
21 23 11 22
0 16 9 26
8 19 22 12
15 11 17 3
14 30 1 30
16 16 16 27
26 4 9 11
6 26 2 17
30 2 31 14
15 19 17 10
24 23 7 5
20 23 24 9
9 28 3 14
31 14 27 30
13 31 12 31
10 18 25 2
23 16 15 1
8 13 4 28
29 29 20 30
18 3 18 6
8 17 29 24
0 28 17 31
22 25 23 11
4 1 2 3
6 20 9 14
13 16 29 14
9 31 16 26
16 31 30 11
21 10 16 13
19 30 16 29
27 16 27 18
30 20 2 2
2 26 17 15
12 12 15 24
3 12 24 30
8 11 26 10
23 9 4 22
29 24 13 11
28 5 31 11
0 9 23 21
20 9 18 27
16 3 25 10
30 0 28 31
4 19 4 8
10 1 19 5
6 9 28 25
22 23 6 24
11 18 14 14
11 23 17 17
