32 32
. . @ . @ . . . . . . . . . . @ . . . . . . . @ . . . . . @ @ @ 
@ . @ . . . . . . . . . . . . @ . . . . @ . . . . @ @ . . . @ . 
. . . . . . . . . @ @ . . . . @ . @ . . @ . . . @ . . . . . . . 
@ . . @ . . . @ . . . @ . . . . . . . . . . @ @ . . . . @ . . . 
. . . . . . @ . . . . . . . . . . @ . @ . . @ . . . . @ . . . @ 
. . . . . . @ . . . . . . @ . . . @ . . . . @ . . . . . . . . . 
. . . . @ . . . . @ . . @ . . @ . . . @ . . . @ . . . . . . . . 
. . . . . @ . . . . . . . @ . @ . . @ . . . . . . . . . . . . . 
. @ . . . . . . . . . . . . . . . @ . . . . . . @ . . . . . . . 
. @ . @ . . . @ . . . @ . . . . . . . . . . @ @ . . @ . . @ . @ 
@ . . . . . @ . @ . . . @ . . . . . . . . . . . . @ . . . . . . 
. . @ . . . . @ . . . @ . . . . . . @ . . @ . . . @ . . . . . . 
. . . . . . . . . @ . . . . . . . @ . . . . @ @ . . . . @ . @ . 
. . . . . . . @ . . . . . . . @ . @ . . . @ . . . . . . . . . @ 
. @ . . . . . . @ @ . . @ . @ @ . . . . . @ . . . . . . . . . . 
. . . . . . @ @ . . . @ . . . . @ . . . . . . . . @ @ . . . . . 
@ . . . . . . @ @ . . . @ . . . @ . . @ . . . . . . . . . . @ @ 
@ . . . @ . . . @ . @ . . . . . . . . . . . @ . . . . . . . @ . 
. . . . . @ . @ . @ . @ . . . . . . . @ . @ . . . @ . . . . . . 
. . . @ @ . . . . @ . @ @ @ . . . . . . . . . . . . . . . . . . 
. . . . . @ @ . . @ @ @ @ @ . @ . . . . . . . . @ . . . @ . . @ 
. . @ @ . . . . . . . @ . . . . . @ . . . . . @ . . . . . . . . 
. @ . . . @ . . . . @ @ . @ . . @ . @ . @ @ . . . . @ . . . . . 
. . . @ . . . . . . . . @ . @ . . . . . . @ @ . . . @ @ . . . . 
. . @ @ . . @ . @ . . . . . . . . . . . @ . . . @ . . @ . . . . 
. . @ . @ @ . . . @ . . @ . . . @ @ . . . . . @ . . . . . . @ . 
@ . . . . . . . . . . . @ . . @ . . . . . . . . @ . . @ @ . . . 
. . @ . . . . . . . . @ . . . @ . . . . . . . . . . . . . . @ . 
@ @ . . . . . . . . . . . . . . . . . @ . . . @ . . . . . . @ @ 
@ . . . . . . . @ @ @ . . . . . . . . . . @ . . . . . . . . . . 
. @ . . . . . . . . @ . . . . . . . . . . @ . . @ . . . . @ @ . 
. . . . @ . . . @ . . . . . @ . . . . @ . . . . . . @ @ @ . . . 
40
3 10 8 22
28 16 30 8
19 7 4 24
13 29 19 19
11 31 5 19
12 30 8 5
23 18 0 18
24 28 18 0
7 17 11 17
1 1 24 1
28 19 4 8
20 30 21 10
11 26 22 1
12 21 19 23
25 27 6 3
11 0 0 9
6 25 3 7
5 13 14 4
7 20 28 2
25 5 16 21
19 9 11 25
25 28 13 23
28 29 28 16
5 4 4 2
7 23 4 14
29 3 2 31
23 27 25 25
24 17 28 11
16 7 28 5
7 21 10 6
13 18 27 9
29 24 9 22
14 0 31 24
2 31 22 13
20 31 2 2
23 29 13 16
21 8 29 16
20 19 13 28
9 10 14 22
6 0 28 22
