32 32
. . . . . . @ . . . . . . . . . . . . . @ . . @ . . . @ . . . @ 
. . @ . @ @ @ @ . . @ . . . . . . . . . . . . @ . . . . @ . @ @ 
. @ . . . . . @ . . . . . . . . @ . . . . . @ . . . . . . . . . 
@ . . . . . . . . . . . . . @ @ . . . . . . . . . @ . . . . . . 
@ . @ . . . @ . . . . . . . . . . . . . . . . @ . . . . . . . . 
. . @ . . . . @ . . . . . . . . @ @ . . . . . . . . . @ . @ . . 
. . @ . @ . . . . . . . . . . . @ . . . . . . . . . . @ . . . . 
@ . . . . . . . . . . . @ @ . . @ . . @ . . . . . @ . @ . . . . 
. . . . @ . . . . . . . . . . . @ . . @ @ . . . . . . . . @ . . 
. @ . . . . @ . . . . . . . @ . . . . . @ . . . @ @ @ . . . . . 
. . . @ . . . @ . . . . . . . . . . . . . . . . @ @ . . . @ . . 
@ . . . . . @ @ . @ @ . . . . . . . . . . . . . . @ . @ . . . . 
. . @ . @ @ @ . @ . @ . . . . . . . . . . @ . . . . . @ . . . . 
. . . . . @ . . . . . . . . @ . . @ . . . . @ . @ . . @ . . . . 
. . . @ . . . . . . . . . . @ . . . . . @ . . . . . . . . . @ . 
. . @ . . . . . . . . . @ . . . . . . . @ . . . . . . . . . . @ 
. . . . . @ . @ . . . . . . . . . . . @ . . . @ . . . . . . . @ 
. . . @ . . . . . . @ @ . . . . . . @ . . . . . . . @ . @ . . . 
. . @ @ . . . . . @ @ . . . . . . . . . . . . . . . . . @ . . . 
. . . . . . . . @ . @ @ . . . . . @ @ @ . . . . @ . . @ @ . . @ 
. . @ @ . @ @ . . @ . @ @ . . . . . @ @ @ . @ @ . . . . . . . @ 
. . . . . . . . . . . . . . . . . @ @ . . . . . . . . @ . @ . @ 
. . . . . . @ @ . . . . @ . @ . . . . . . @ . @ . @ @ . . . . . 
. . @ . . . . . . . . . . @ . . . . . . . . . @ . @ . . . . . @ 
. . . . . . . . . . @ . . @ . . . . . . . . . . . . . @ . . . . 
@ @ @ . . @ . @ . . . . @ . . . . . @ @ @ . . @ . . @ . . . . @ 
. . . @ . . . . @ . @ . . @ . . @ . @ . @ . . . . . . . . . . . 
. . . . . . . . . @ @ @ . @ . . . . . . . . . @ @ . @ @ . . . . 
. . . . . . @ . . . . . . . . @ @ . . . @ . @ . . @ . . . . @ @ 
. . . . . . . . . . . . . @ @ . . . . @ . . @ . @ . . . . @ @ . 
@ . . . . . . . . @ . . . . . . . . . . . . . . . . @ . . . . . 
@ . @ @ . . . . . . @ . . . @ . @ @ . @ . . . . @ . . . . . . . 
70
6 18 9 31
21 5 28 25
8 28 9 17
8 11 13 5
4 7 7 7
24 4 13 14
20 5 30 2
15 13 6 19
12 11 10 15
2 13 0 12
22 21 12 14
4 26 23 13
5 21 1 24
22 22 11 6
2 16 19 4
11 2 19 1
23 14 28 31
14 19 27 14
16 16 22 22
18 7 27 8
8 31 24 0
31 2 23 29
12 9 24 5
11 22 20 13
8 18 5 8
1 16 31 7
11 12 24 14
17 1 26 2
31 7 21 31
22 16 28 21
8 13 5 17
19 6 31 11
30 7 17 28
18 9 3 28
11 25 3 16
13 17 8 18
22 30 1 29
6 25 20 22
17 6 4 27
2 27 12 2
19 24 8 28
28 14 9 9
20 11 4 19
7 27 0 27
13 2 0 26
24 5 16 10
9 3 12 21
26 16 0 28
16 19 10 28
3 7 26 3
28 8 23 7
14 7 8 27
0 21 24 1
18 14 31 17
14 12 8 30
18 3 24 20
6 10 13 16
17 3 18 31
4 19 14 1
29 6 14 20
4 28 1 19
12 5 8 13
13 10 28 11
25 29 3 0
27 30 23 8
24 2 21 26
12 3 12 4
21 13 8 9
29 13 17 30
5 4 0 18
