32 32
. . . . . . . . . . . . . . @ . . . . . @ . . . . . . . . . . . 
. . . . @ @ . . @ . . . . . . . . @ @ . . . . . . . . . . . . . 
. . . . . . . . . . . . . . . @ @ . . . . . . . . . @ . . . . . 
. . . . . . . . @ . . . . @ . . . . . . . . . . . . . @ @ . . . 
. . . . . . @ @ . @ @ . . . @ @ . . . . . . . @ . . @ . . . . . 
. . @ . . . . @ . . . . @ . . . @ . . . . . . . . @ @ . @ . . . 
@ . . . . . @ . . . . . . . . . . @ @ . . . @ . . . . . . . . . 
. . . @ . . @ . . @ . . @ . . . . @ . . . . . @ . @ . . . . . . 
. . . . . . @ . @ . . . . . . . . . . . . . . @ . . @ . . @ . . 
. . . @ . . . . . . @ . @ . @ . . . . @ . . @ . . . . . @ . . . 
. . . . . . . . . @ . . . . . . @ . . . . . . . . . . . . . . . 
. . . . @ . . . . @ . . . . @ . . . . . @ . . @ @ . . . . @ . . 
. . @ . . . . @ . . . . . . . . . . @ . . @ . . . . . . . . . . 
. . . @ . . . . . . . . . . . @ . @ . . . . . . . @ . @ @ . . @ 
@ @ . . . . . . . . . . @ . . . . . . . . . . . @ @ . . . . @ . 
. . @ . . . . . . . @ @ . . . . . . . @ @ . . . . . . . . . . @ 
. . . . . . . . . @ . . . . @ . @ . @ . . . . . . . . . . @ . . 
. . . . @ @ @ @ . . @ @ . . . . . . . . @ @ . . @ . . . . . . . 
. . . . . . . . . . . . . @ . @ . . @ . . . . . . . . . . . . . 
. . . . . . . . . . . . . . . . @ . . . . @ . . . . @ @ . . . . 
. @ . . . . . @ . . . . @ . . . @ . . . @ @ . . @ . . @ @ . . . 
@ . . . @ @ . @ . . . . . . . @ . @ @ . . . . . . . . . @ @ @ @ 
. . . . @ . . . . . @ . . @ . @ @ . @ . . @ . . @ @ @ @ . @ . . 
. . . . . . @ . . @ . @ . . . . . @ . . . . @ . . . . @ . . . . 
. . . . @ @ @ . @ . . . . . . @ . . @ . . . . . . @ @ . . @ @ . 
. . . . . . @ . . . @ @ @ @ . . . @ . . . . @ . . . . . . . @ . 
@ . . . . . . . . . . . . . @ . . . . @ . . @ . . . . . . . . . 
. . . . . @ . . . . . . . @ . @ @ . . . . . . @ @ . . . . @ @ . 
@ . @ . . . . @ . . . . . . . . . . @ . . . . . . . @ . . @ . . 
. @ . . . . . @ . . . @ . . @ . . . @ @ . . . . . . . . . @ . @ 
. . . @ . . . @ @ . . @ . . . . . . . . . . . . @ . @ @ . . . @ 
@ @ . . @ . @ @ . @ . @ . . . . . . . . . . . . . . . . . @ . . 
30
29 18 14 30
20 7 23 1
22 19 31 20
14 1 29 23
29 20 31 10
28 1 2 14
7 2 30 4
6 27 28 26
25 11 4 10
5 7 27 15
21 31 1 16
27 24 9 28
20 12 2 16
10 30 6 13
27 10 2 25
1 15 23 30
5 20 11 28
20 13 3 4
19 13 12 24
31 17 0 10
26 0 14 6
7 3 8 20
31 23 15 10
19 25 19 1
14 6 21 16
14 5 22 0
25 10 27 17
23 3 14 3
0 24 8 10
0 25 7 7
