32 32
. . @ @ @ . . . . . @ @ . . @ @ . . @ . @ @ @ . . . @ . . . . . 
. . . . . . . . . @ . . @ @ . . . . @ . . . . . . . . . . . . @ 
. . . . . . @ . . . @ . @ . . . . . . . . . . @ . . @ . @ . . . 
. . @ @ . . . . . . . . . . . . . . @ . . . . . . . @ . . . . . 
. . @ . . . . @ @ @ @ . . . . . . . @ . . . . . @ . . . . . . . 
@ . @ . @ . . . . . . . . . . . . @ . . . . . . . . . . . @ . . 
@ . . . @ . . . . . . @ @ . . . . . . . . @ . @ . . . . @ . . . 
. @ . . . . . @ . . . . . . . . . @ . . . . . @ @ . @ . @ . . @ 
. . @ . . . . . . . @ . @ . . @ . @ . @ @ . . . @ @ . . . . . . 
. . @ . . . . . . . . . . . . . @ . . . . . . . . . . . . @ . . 
. . . . . . . . . . . . @ . . . @ . . . . . . . . @ . . . . @ . 
. @ @ . . . . . . . . . @ . @ . . . . @ . . . . @ @ . @ . . . . 
. . @ . . . . . . . . . . @ . . @ . @ . . . @ . . . . . . @ @ . 
. @ . . . . . . @ . . . . . . . . @ @ . . @ @ @ . . . . @ @ . . 
. . @ . . . . . @ . . . . . . . @ . . @ . . . . . . @ @ . . . @ 
. . . . . . . @ . @ . . . . . . . . . . . . @ . . . . . . . @ . 
. . . @ . . . . . . . @ . . @ . . . . . @ . . . . . . @ . . . @ 
. . . . . . . . . . . . . . . . . @ . @ . . . @ . . . . . . @ @ 
. . . . . . . . @ . @ . . . . . . . . . @ . . . @ . . . @ . . . 
. . . . . . . . . @ . . . . @ . @ . . . . @ @ . . . . . @ . . . 
@ . . @ @ . . . . . . @ . @ . @ @ . . @ . . . . @ @ . . . @ @ @ 
. . . . . . . @ . @ . . . @ . @ . . . . @ @ . . @ . . . @ . . @ 
. . . . . . . @ . . . . . . . . . . . . @ . . . . . . . . . . @ 
. . . . . . . . . . . . . . @ @ @ @ . . . . . . . . @ . . . . . 
. @ . . . . @ . . . . @ . @ @ . . . @ . . . . . . . @ @ . . . . 
. @ . . . . @ . . @ . . . . @ . . . . @ . @ . . . . . . . . . . 
. @ . @ . . . . . . . . . @ . . . . . . . . . . . . . . @ . . . 
. . . . @ . . . @ . . . . . @ . . . . . . . . . . . @ @ @ . . . 
. . . . . @ . . . @ @ . . . . . @ . . . . . . . . . @ @ . . . . 
. . . . @ . . . . . . . . @ @ . . . @ . . @ . . @ . . @ @ . . . 
. . . . . . . . @ . . . . . . . @ @ . . . . . . . . . . . @ . . 
. @ . . . . . . @ . . . . @ . . @ . . . . . @ . . . . . . . . . 
40
3 13 21 8
11 23 5 7
4 10 19 30
31 23 20 19
20 31 23 14
20 24 13 30
18 15 15 12
11 14 18 2
1 1 29 24
6 14 13 22
9 23 28 20
27 3 10 19
30 8 16 7
15 28 27 8
9 12 5 30
0 18 2 7
11 17 9 8
15 6 4 3
10 30 12 18
0 8 8 7
12 15 24 16
21 28 10 27
17 3 7 2
23 9 30 3
22 30 1 8
9 8 11 31
24 24 30 31
25 21 31 10
28 17 0 23
24 16 0 17
8 22 4 21
15 3 26 15
26 18 14 8
0 31 5 2
29 2 14 7
20 13 9 31
8 28 6 20
0 14 16 1
30 9 30 26
13 22 13 13
