32 32
@ @ . . @ @ . . @ . @ @ . . @ @ . . . . @ . . . . . . @ . . . . 
@ @ . . . . @ . @ . @ . . @ . . . . . . . . . @ . . . . . . @ @ 
. . . . . . . . @ . . . . . @ . . . . . . . @ . @ . . . . . . . 
. . . . . . . @ . . . . @ . @ @ . . . . . . . . . . @ . . . . . 
. . . . . . . @ . . . . . . . . . . . . . . . . . . . . @ @ @ . 
@ . . . . . . . . . . . . . . . . . . @ . . . . . . . @ . . . . 
. . . . @ . . . . . . . . . . . . . @ . @ . . . . . . @ @ . . . 
. . . . . . . . . . . . @ . . @ . . . . . . . . @ . . @ . @ . . 
@ @ . @ . . . . . . . @ . @ @ . . . . . @ . @ . @ @ . . . . . @ 
. . . @ . . . . . . . . . . . . . . @ . . @ . @ . @ . @ . . . . 
. . . . @ . @ . @ @ . @ . . @ . . . . @ . . . . @ . . . . . . . 
@ . . . . . . . . . . . @ . . @ . . . . . @ . @ . @ . . @ . @ @ 
. . . . . @ . . . . . @ @ . . . . . . . . @ . . . . . . . . . @ 
. @ . . . . @ . . . @ . . . . . . . . . . @ . . . . . . @ . . . 
. . . . . . . . . . . . @ @ . @ . . . . . @ . . . @ . @ . . . . 
. . . . @ @ . . . . @ . @ . . . . . @ @ . . . . . . . . . . . . 
@ . . . . . @ . . . . @ . . . . . . . . . . @ . . @ . @ @ . . . 
. . . @ . @ . @ . . . . . @ . . @ . . . . . . . . . . . . . . . 
. . . . . @ . . . . . . . . @ . . . . . . . . . . . . . . . . . 
. @ . . . . . . . @ . @ . . . . . @ . . . . . @ . . . . . @ . . 
. . . . . . . . . . . @ . . @ @ . @ . @ @ @ . . . . . . . @ . . 
. . . . . . . . . . . . . . . @ . . . . . . . @ . . . . . . . . 
. . . . @ . . @ . . . . . . @ . @ @ . . . @ . . . . . . . . . . 
. @ . . @ @ . . @ . . . . . . . . . . @ @ @ . @ @ . . . @ @ . . 
. . . . . @ . . . @ @ . . . . . @ . . . . . @ . @ @ . . . . . . 
. . . @ @ . . . . @ . . . . . . @ @ @ . . . @ . . . . . . . . . 
. . . . . @ . . . . @ . @ . . @ . . . . @ . @ . . . . . . . . . 
. @ . . . . . . . . . . @ . . . . . . . @ . . . . . . . . . . @ 
@ @ . . @ . . . @ . . . @ . . . . . . . @ @ . . . . @ . . . . . 
@ . @ . . . . . . @ . . . . . @ @ . . . @ . @ . @ @ @ . . . . . 
. . . @ . . . . . . . . @ . . . . . . @ . @ @ . . @ . . . . . . 
@ . . . . . @ . . . . . . . . . . @ @ . . . . @ . . @ . @ . . . 
60
6 29 10 19
11 21 13 12
7 12 4 5
31 22 30 28
0 24 10 8
1 12 21 5
29 29 23 29
0 4 28 7
7 18 4 21
15 25 25 31
24 12 15 6
16 6 4 31
3 24 30 0
5 6 21 1
8 4 18 8
19 19 29 1
17 29 25 26
24 16 1 31
10 17 9 11
29 8 2 7
17 21 3 26
17 11 23 30
8 25 4 14
10 10 14 6
20 4 7 30
28 18 15 22
10 19 29 5
0 6 1 4
11 2 26 27
9 2 22 5
18 8 13 31
17 13 23 3
15 30 25 15
28 15 22 0
12 19 14 15
20 2 7 13
30 13 21 27
26 12 14 9
18 14 29 29
27 31 14 24
31 6 29 21
6 2 5 5
23 26 13 2
19 25 26 7
19 12 31 14
19 14 3 3
23 4 27 27
31 25 2 10
30 31 19 21
23 8 6 15
25 25 23 17
18 21 16 19
28 2 0 23
12 25 12 25
5 5 11 30
16 27 16 18
26 7 18 14
14 15 0 27
11 24 29 17
31 21 0 25
