32 32
. . . . . . . . . . @ . @ . . . . . . . . . . @ . . . @ . @ . . 
. . . . . . . . . @ . . . . . . @ . . . . @ . @ . . . . . . @ . 
@ . . . . . . . . . . . . . . . . @ @ . . . . . . . @ . . . . . 
. . . . . @ . . . . . . . @ @ @ . . . . @ . . . @ . . @ . @ . . 
. . @ . . . @ . . . . @ . . . @ . . . . . . . . . . @ . . @ @ @ 
@ . . . . . . . . @ . . . . . . @ . . @ . . @ @ . . . . . . @ . 
. . . . . @ . . @ @ . . . . . . . @ . . . . . . . . . . . . . @ 
. . . . . @ . . . . . . . . @ . . @ . . . @ . . . . . . @ @ . . 
@ . . . . @ . . . . @ . . @ . . . . . @ . @ . . . . . . . . @ @ 
@ . @ . @ . . . . . . . . @ . . . . . @ . @ . . . . . . . . . . 
. . . . . . . @ @ . . . . . . . . . . . @ @ @ . . . . . . . . @ 
. @ . @ . . . . . . . . . . . . . . . @ . . @ @ . . . . . @ . . 
@ @ . . @ . . . . . . @ . . @ . . @ @ . . . . . . . . . . @ . . 
. . @ . . @ . . @ . . . . . . . . . . @ . . @ . @ . . . . . . . 
. . . . . @ @ . @ . . . . @ . . @ . . . . @ . . @ @ . . @ . . . 
. . . . . . @ . . . . . . . @ @ @ . . . . @ . . @ . . . . . . . 
. . . . . . . @ . . @ . . . . @ . . @ . @ . . . @ . . . . . @ . 
. . @ @ . . . . . . . . @ . . . . . . . . . . . . . . @ . . @ . 
. . . . . . . . @ . . . . . . . . @ . @ . . . . @ @ . . . . @ @ 
. . . @ @ . . . . . . . . . . . . . . . . @ . . . . . . @ . . . 
@ @ . . . . . . . . @ . . . . @ @ . @ . . . . . . . . . . . . . 
. . . . . @ @ . . . . . . . . . @ . @ . @ . . . . . . . . . . . 
@ . . . . @ . @ . @ . . @ . . @ . . . . . . . . . @ . . . . . . 
. . . . . . . . @ . . . . . . . . . . . . . . . @ . . . . @ . . 
. . @ . . . . . . . . . . . . . @ . . @ . . @ . . . . . . . . . 
. . . . . @ . . . @ @ . . . @ . @ @ . . . . . . . . . . . @ . . 
. @ . @ . . . @ . . . @ . . . @ . . @ . . . . . . . . . @ . . @ 
@ . @ . . . . @ . . . @ . . . . @ . . . . . @ . . . @ . @ . . . 
@ . @ . . . . . . . @ . . . @ . . . @ . . . . @ . . . . . . . . 
. . . . . . . . . . @ . . . @ @ . . . @ . @ . . @ . . . @ @ . . 
. @ @ . @ . . @ . . . . . . . @ @ @ . . @ . . . @ @ . . @ . @ . 
. @ . . . . . . . . . @ . . . . . . . . . . . . @ @ . . . . . . 
40
12 15 3 23
1 6 13 27
5 26 5 17
21 23 9 12
16 3 19 0
28 25 29 17
16 16 23 3
7 3 10 9
13 7 13 2
18 18 13 17
6 23 17 11
15 28 26 11
31 31 0 23
0 17 25 0
12 3 21 18
18 24 31 30
13 4 6 17
24 2 0 13
26 20 7 28
10 27 13 30
11 10 30 20
12 6 25 23
2 23 29 16
12 9 11 21
17 9 5 30
7 28 8 15
15 1 13 25
21 12 22 28
13 20 26 31
25 20 6 23
4 20 20 15
2 8 4 22
28 9 0 6
6 19 22 7
0 6 12 12
15 18 3 1
1 4 26 17
2 10 4 23
1 21 16 2
25 26 13 31
