32 32
@ . . . . . . . . . . . @ . . @ @ . . . . . . . . @ @ . @ . . . 
. . @ @ @ . . @ . . . . . . . @ . . . . . @ . . . . . @ . . . . 
@ @ . . . . . . @ @ . . . @ . . . . . . @ . . . . . . . . . @ . 
. . . . . . . . @ . . @ @ . . @ . . . . . . . . @ . @ . @ . @ @ 
. . . . . . . . @ . . @ . . @ @ . . @ . @ . . . . . . . @ . . . 
@ . . @ . . . @ . . . . @ . @ . . . . . . . @ @ . @ . . @ . . . 
. . . . . . @ . . . . . . . . @ . . . . . . . @ . . . . @ . . . 
@ . . . . @ . . @ . . . . . . @ . @ . . . . . . . . . . . . . . 
. . @ . @ . . @ . . . . . . . @ . . . @ . . . . . . . @ @ @ . . 
@ . . . . . . @ . . . @ @ . @ . . . . . . @ . . . . @ . . . . . 
. . . . . . . . . . . . @ . . . . @ @ @ . @ . . @ . . . . @ . @ 
. . . . . . . . . . . . . @ . . @ . @ . . . . . . . . . . . . . 
@ . . . . . . . . . . . . . . . . . . . . . @ . . . . . . . . . 
. . . . . . . . . @ . . . . . . . . . . . . . . @ . @ . . . . . 
@ . . . . . . . . . . . . . @ . . @ . . . . . @ . . . @ . . @ . 
. . . . @ . @ . @ . . @ . . . . . . . @ . . @ . . . . . . @ . . 
@ @ . . . . . @ @ . . . @ . . . . @ . @ @ . . . . . . . . @ @ . 
. . . . . . . @ . . . . . . . . . . . . . . . . . . . . @ . . . 
@ @ . . . . . . . . . . @ . . @ . @ . . . . . . . . . . . @ . . 
. . . . . . . . @ . @ . . . @ . . . . . . . . . @ . @ . @ . @ . 
. . . @ @ . . . @ . . . . . . . @ . @ . @ @ . . . @ . . . @ . . 
@ . . @ . . . . . . . . . . . . . . @ . . . . . . . @ . @ . @ . 
@ @ . . . . . . . . . . . . . @ . . @ @ . . @ . . . @ . . . . . 
. . . . . . . . . . . @ . . @ . . . . @ @ . . @ . . @ . @ . . . 
@ . . @ @ . . @ . . . . . . . . . . @ . . @ . . . . . @ . . . @ 
. . . . . . @ . . . . . . . @ . . . . @ . . . . . . @ @ . . . @ 
. . . . . . . @ . @ . . . . . . . . . . . . @ @ . . . @ . . . . 
. . . . . . @ . . . . . . . @ . . . . . @ . @ . . . . @ @ . . . 
. . @ @ @ . . . . . @ . . . . . . . . . . . . . . . @ . @ . . . 
. . . @ . @ @ . . . @ . . . . . @ . . . . . @ . . . . . . @ . . 
@ . . . . @ . . . . . . . . . . . @ . . . . . . . . . . @ . . . 
@ . . . . . . @ . . @ . . @ . . . @ . @ . . @ . . . . . . @ @ . 
60
22 10 25 30
29 26 14 24
4 9 2 12
21 22 25 3
11 7 15 21
16 16 0 20
0 3 4 7
23 9 18 2
24 12 16 8
27 9 12 8
10 7 25 13
19 18 13 6
6 20 9 8
22 6 3 12
24 20 5 22
11 11 3 13
21 11 20 14
13 6 17 0
17 1 8 22
22 2 1 14
11 31 30 5
24 2 13 21
26 20 10 30
27 23 27 29
3 3 24 2
19 9 14 16
13 15 7 23
24 7 25 4
14 11 22 4
5 15 15 10
13 18 6 26
8 1 14 3
1 8 17 12
4 14 9 24
0 11 19 19
1 9 29 30
20 31 10 14
12 31 27 3
18 7 16 16
12 27 21 15
1 30 15 5
19 5 13 16
21 13 31 28
23 20 5 14
31 4 31 16
24 6 10 24
31 28 2 13
28 15 9 28
28 18 25 21
14 8 2 3
16 2 23 7
16 21 21 30
27 22 16 31
6 13 27 19
9 16 2 16
20 9 16 21
30 5 28 2
2 13 1 19
26 6 22 23
5 21 24 23
