32 32
. . . @ . . . . . @ . . . . . @ @ . . . . @ . . . . . . . . . @ 
. . . @ . . . . . @ . . . @ . @ @ @ . @ . . . @ . . . . . . . . 
. . . . . . . . @ . . . . @ . @ @ . . . . . . . . . . . . @ . @ 
. @ @ @ . @ @ . . . . @ . . . . . . @ . . . . . . @ . . . . . . 
. . . . @ . . . . . . . . @ . @ . . . . . . . @ @ . . . . . . . 
@ . . @ . . . . . . @ . @ . . . . . . . @ . . . . . . . . . . . 
. @ . . . @ . . @ . . . . . . @ . . . . . . . . @ @ @ . @ . . . 
@ . . . . @ @ . . . . @ . . @ @ . @ . @ . . @ . . . . . . . . . 
. . @ . @ . . . . . . . . . @ . . . . . @ . @ . . . . @ . . . . 
. . . . . . . . . @ . @ . . . @ . . . . . . . . . . @ . . . . . 
. . . . . @ . @ . . @ . @ . . . . . @ . . . . . . . @ . . . @ @ 
. . @ . . . . . . @ . @ . . . . . . . . . . . . @ . . @ @ . . . 
. @ . . . . . . . . @ . @ . @ . . . . . . . . . . @ . . . . . . 
. @ @ . . . . . @ . . . . . @ . . @ @ . . @ . . . . . . @ . @ @ 
. . . . . . @ . . . . . . . . . . . . . . . . . . . . . . . . . 
@ . @ . . . . . . . . . @ . . @ . . . @ . . . . @ . . . . . . . 
. . . . . @ . @ . . @ . . . . @ . . . . . . . . . @ . . . . . . 
. . . . . @ . . . . . @ . . . . . . . @ . . @ . @ . . @ . . . . 
@ . . . . . . . . . @ . . . . @ @ . . @ . . . . . . . . @ @ . . 
@ . @ . . . . . . . . . . . . . . . @ . . . . . @ @ . . . . . . 
. . . . . . @ . . . . . . . . @ . . . . . @ . @ . . . @ . . @ . 
. @ @ . . . . . . . @ . . . @ . . . @ @ . @ . . . . . . . @ . . 
. . . . . @ . @ . . . . . @ . . . . . . . . . . . . . . . @ . . 
. . . . @ . . . . @ . . . . . . . . @ @ . . . . . @ . . @ . . . 
. @ . . . . @ . . . . . . . . . . . . . . . @ . . . . . . . . . 
. . . @ @ @ @ . . . . . . . . . . . . . @ . @ . @ @ . . . . @ @ 
. . . . . @ . . @ . @ . . @ . . @ . . . . . . @ . . . . . . . @ 
. . . . . @ . . . @ . . @ . . . . . . . . @ @ . . @ . . @ . . . 
. . @ . . . @ . . . @ . . @ . . @ . . . . @ . . . . @ . . @ . . 
@ . . . . . . . @ @ . . . . @ . @ . @ @ . . . . . . . . @ . . . 
. . . . . @ @ . @ . . . . . @ . . . @ . . . . @ . . . . @ . @ . 
. @ . . . . @ . . . . @ . . . . . . . @ . @ . . . . . . . . . . 
10
22 4 31 3
17 3 15 23
3 14 18 1
8 31 12 22
3 9 18 0
20 29 31 11
8 0 4 11
11 6 19 5
17 19 27 4
10 6 25 9
