32 32
. @ . @ . . . . . . . . @ . . . . . . . @ . . . . . . . . . . . 
. @ . . . @ @ . . . . @ @ . . . . @ . . . @ @ . . . . . @ . . . 
. . . @ . . . @ . . . . . . . . . . @ . . . . . . . @ . @ . . . 
. @ . @ . . . . . . . . . . . . . . . @ . . . . . . . . . . . @ 
. . . @ . . . . . . @ . . . . . . . . . . @ . . @ @ . . . . @ . 
@ . . . @ . @ . . . . . . . . . . . . . . . . . . . . . @ . . . 
. . . @ . . . . . . @ @ @ . . . . . @ . . @ @ . . @ . . @ . @ . 
. @ . @ . . . @ . . @ . @ . . @ . . . . @ . . . . . . . @ . . . 
. . . . . . . . . . @ . . @ . . . . . . . . . . . . . . . . . . 
@ . . . . . @ . . . . . . . . . . . @ . @ . . . . @ . @ @ . . . 
. @ . . @ . . . . . . . . @ . . . . . . @ @ . . . . @ @ . . . @ 
. . . . @ . . . @ . . @ @ . . @ . . . @ @ @ . . @ @ . . @ . @ . 
. @ . . . . . . @ . . . . . . . . . @ . @ . . . . . @ . . . . . 
. @ . . . . . . . . . . . . . . . . @ . . . . @ . @ . . . . @ . 
. . . . @ . . . . @ . . . . . @ . . . . . @ @ @ @ . . . @ @ . . 
. . @ @ @ @ . . . @ . . @ @ @ . . . . . . . . . . @ . . . . @ . 
. . . . . . . . . . . . @ . . . . . . . @ . . . . . . . . . . . 
. . . . . . . . @ . . . @ . . . . . . . . . . @ . @ . . . . . . 
. @ . . . @ . . . @ . . . . . . . . . @ . . . . . @ . . @ . . . 
. . @ . . . @ . . . . . . @ . . . . . . . . . . . . . . . @ . . 
. . . . . . . . @ . . @ @ . . . . @ @ . . . . . . . @ . . . . . 
@ . . . . . . @ . . . @ . @ . . . . . . . . . . . . . . @ . . . 
. @ . . . . . @ . . . . . . . . . . @ . . . . . . . . @ @ @ . . 
. @ . @ @ . . . . @ . . . . . @ . . . . . . . . . . . . . . . . 
. . . @ . . . . . . @ . . @ . @ . @ . . . . . . . . . . . @ . . 
. . . . . . . . . . @ @ . . @ . . . . . . . . . . . @ @ @ @ . . 
. . . @ @ @ . @ . . . . . . . . @ . . . . . . . @ . @ . . . . . 
. . @ . . @ @ @ . @ . @ . . . . . . . . @ . . . @ . . . . . . @ 
. . . @ . . . . . @ . . . . . . @ . . . . . . @ . . . . @ . . . 
. . . . . @ . . . . . . @ . . . @ . @ . . . @ @ . . @ . . @ . . 
. . . . . . . . @ @ @ . @ @ @ . @ . . . . . . . . . . . . . @ @ 
@ . . . . . @ . . @ . @ . . . . . . . . @ . @ . . @ . . . . . . 
30
28 0 11 3
31 31 9 29
5 30 11 4
28 13 30 23
0 7 6 8
13 25 15 31
5 31 20 14
0 26 18 10
15 10 19 26
31 20 11 10
30 12 9 17
27 19 15 27
19 23 2 7
20 4 24 8
2 6 3 20
30 24 12 19
30 25 2 31
2 24 26 3
14 18 6 0
30 3 31 0
8 5 8 16
2 17 22 17
0 17 1 20
5 5 9 6
11 4 17 29
2 30 13 25
7 15 8 6
25 2 8 25
11 23 7 15
6 8 22 18
