32 32
. . . . . . . . . . . . . . . . . . . @ @ . . . @ . . . . . . @ 
. . . . . . . . @ @ . . . . @ . . . . . . . . . @ . . . . . @ . 
. @ . @ . . . . . . . . @ . . . . . . . . @ . . . . @ . . . . . 
@ @ . . . . . . . . @ . . . . @ @ . . . . . . . . . . . . . . . 
. @ . . @ . . . . . . . . . . . . . . . . . . . . . . . . . . . 
. . . @ @ @ @ . . . @ . @ . . . . . . . @ . . . . . . . . . @ @ 
. . . . . . . . @ . . . . . . . . . . . @ . . . @ . @ . . @ @ . 
. @ . . . . @ . . . . . . . . . @ . @ . . . . . . . @ . . . . . 
. @ . . . . . . . @ . . @ . . . . . . . . . . . . . . @ . . . . 
. . . . . @ . . . . . @ . @ . . . . . . . . @ @ @ . . . . . . . 
. . . . . . . . . . . . . . . . @ . . . . . . @ . @ . @ . . . . 
. . . . . . . . @ . . . @ . . @ @ . @ . . . . @ . . . @ . . @ . 
. . @ . . . . @ . @ . . . . @ . . . @ . @ . . . . . . @ . . . . 
@ . . . . . . . . . . . . @ . . . . . @ . . . . @ @ . . . . . . 
. . . . . . . . . . . . . . @ . . . . . . . @ . @ . . . . . @ . 
. . . . @ . @ @ . @ @ . @ . @ @ . . . @ . . . . . . . @ . . . . 
. . . . . . . . . @ . . . . . . . . . . @ . . . . . . . . . . . 
. . @ @ . @ . . . . . . . . . . . . . . . @ . . . @ . . @ . . . 
. . @ . @ . . . . . . . @ . . . @ . . . . @ . @ . @ . . . . . . 
. . @ . @ @ @ . . @ . . . @ . . . . . @ . . . . . . . . . . . . 
. @ . @ . . @ . @ . @ . . . . . . . . . @ . . . . @ @ . . @ . @ 
. . @ . . . @ . . . . @ . . . . . . @ . . . . . . . . @ . @ . @ 
. @ . @ . @ . . @ . . . @ . . . . . @ . . . . . @ . . . . @ . @ 
. @ . . . @ . . . . . . @ . . @ @ . . . . @ . . . . @ . @ . . . 
. . . . . . . . . . . . . @ . @ . @ @ . . . . . . . . . @ . . . 
@ . . . . . . . . . . . . . . @ . . . . . . . . @ . @ @ @ . @ . 
. @ . @ . . . . . . . @ . . . . . . . . . . . . . . . @ . . . . 
@ @ . @ . . . . . . @ . . . . @ . . . . . . . . @ . . . . . . . 
. @ . @ . @ . . . @ . @ @ . . . . @ @ @ . . . . . @ . @ . . . . 
. . @ . @ . . @ @ @ @ @ . @ . . . . @ . . . . . . @ . @ . . @ @ 
. . . . . . . . . . . . . @ . . @ @ . . . . . . @ . . . @ . @ . 
. @ @ @ . . . . . . . . . @ @ . . . . @ . . . . . . . . @ . . . 
30
31 23 8 5
17 23 24 24
5 4 29 3
10 22 8 15
21 21 5 24
1 17 25 3
19 3 29 11
14 29 15 31
12 21 0 5
17 19 23 27
17 7 11 6
24 28 16 14
3 9 11 11
28 9 31 14
31 19 16 12
23 6 14 30
25 0 29 15
26 16 14 19
3 6 19 26
18 1 31 6
17 3 11 8
21 24 29 29
20 7 20 7
5 11 5 25
3 0 30 27
16 12 22 24
17 29 18 8
15 22 3 29
18 8 20 23
17 21 0 0
