32 32
. . . . . . . . . . . . . . . . . . . @ . . . @ . . . . . . . @ 
. . . . @ @ . @ . . . . . . . . . @ . . . @ . @ . . . . . . . . 
. @ @ . @ . . @ . . @ @ @ . @ . . @ . . . . . . . . @ . . @ . . 
@ . . @ . . . @ . . . . . . . . . . @ @ . @ . . @ @ . . . . . @ 
@ . . . @ . . . . . . @ @ . @ . . . @ @ . . . . @ . . . . . . . 
. . . . . @ . @ @ . . . . . . . . @ . @ . . @ . . . @ . @ . . . 
. . . . . @ . . . . . . . . . . . . @ . . . . . . . . @ . . . . 
. . . . . @ @ . . . . . . @ . @ . @ . . . . . . . . . @ @ . . . 
. . . @ . . . . . @ . . . @ . . @ . . @ @ . . . . . . . @ . . . 
. . @ . . . . . . @ . . . . . . . . . . @ . . . . . @ . . . . . 
. . . . . . . . @ . . . . . @ . . @ . @ . . @ . . . . . . @ @ @ 
. . @ . . . @ . . . . . . @ . . . @ . @ . . . @ . . . @ @ @ . . 
. . . . . . . . @ . . . @ . . . . . . . . . . . . . . . . . . . 
. . . . . . . . . . . . . . . @ . . . @ . . @ @ @ . . . . . . . 
. . @ . . . . . . . @ . . . . . . . . . . . . . . . . @ . @ @ @ 
@ . . . @ . . . . @ . . @ @ . . . . . . . . . . . . @ . . @ . . 
@ . . . . . . @ . . . @ . . . . . . . . . . . . @ @ . . . . @ . 
. . . . . . . . . @ . . . @ . . . . . . . @ @ . @ @ . . . . . @ 
. . . . . . . . @ . . . . . . . . . @ . @ . . . . @ . . @ . . . 
. . . . . . . . . @ @ . . . . . . . . . . @ . . . . . . . @ @ . 
@ @ . . . . @ . @ . @ . . . @ @ . . . . . . . . . . . . . . . . 
. @ . . . . . . @ . . . . . . @ . . . @ . . . . . . . . . . . @ 
. . . . . . . . . . . . . . . . @ @ . @ . @ . . . . . . @ @ . . 
. . . . . . . @ . . . @ . . . . @ . . @ . . . . @ . . . . @ @ @ 
. @ @ . . . . . . @ . . . . . . @ . . . . . . @ @ . . . . . . . 
@ . . . . . . . . @ . . . . . . . . . @ . . . . . . @ . @ . . . 
. @ . . . . . . @ . . . . . . . . . . . @ . @ . . . @ . . . . @ 
. . @ . . . . @ . . . @ @ @ . . . . . @ . @ . @ . . . . . . . . 
@ . . . . . . . . . @ . . . . . . @ . . . . . . . @ . @ @ . . @ 
. . . . . @ . @ @ . . @ . . . . . . . @ @ . . . . . . . . . @ . 
@ . @ . . . . . . . @ . . . . . @ @ . @ @ . . . . . . . . . . . 
. . . . . . . . . . . . . . @ . . . @ . . @ . . @ . @ . @ . . . 
20
24 21 27 13
0 8 12 5
31 13 12 18
17 18 14 16
21 7 3 6
9 4 23 14
25 27 19 20
23 19 18 0
26 27 31 20
11 24 14 21
11 10 31 1
21 9 26 24
28 19 29 26
15 17 7 8
26 3 4 9
22 7 19 7
17 31 17 20
1 30 30 5
24 20 7 24
23 4 9 3
