32 32
@ . @ @ . . . @ . . . . . . . . @ . . . @ . . . . . . . . @ . @ 
@ . . @ . @ @ . . @ @ . . @ . . . . . @ . . . . @ . . @ . . @ . 
. . @ . . @ . . . @ . . . @ . @ @ . . . @ . . . . . . @ . @ . . 
. . . @ . . . . . . . . . . @ . . @ . . . . . @ @ . . . . . @ . 
. . . @ . . . . . . . . . . . . . . . . . . . . . . . . @ . . . 
. @ . . . . . . . . . @ . @ . . @ . . . . . @ . @ . . . . . . . 
. . . . . . . . . . . . . . @ @ . . @ . . . @ . . @ . . . . . . 
. . . . . . . @ . . . @ . . @ . . . . . . . . . . . . . . . . @ 
. . . @ . @ @ . @ . . . @ . . . . . . . . @ . @ . . . . . . . . 
. @ @ . . . . @ . . . . . . . @ . . . . . @ @ . . @ . . . . . . 
. @ . . . . . @ @ . . . . . @ . @ . . . . . . . . . . . @ . @ . 
. . @ . . @ . @ . . . . @ . . @ . . . . . . . . @ . @ . . . . . 
@ . . @ . . . . @ . . . . @ @ . @ . . . . . . . . . . . @ . . . 
. . . @ . . @ . . . . . . . . . . @ . . . @ . . . . @ . . . . . 
. . . @ . . @ . . . @ . . . . . . . . . . . . . . . . . . . . . 
. . . . . . @ . . . . . @ . . . . . . . . . @ . . . . . @ @ . . 
. . @ @ . . . . . . . . . . . @ . . . . . . . . . . . . . . . . 
. . @ . @ . . @ . . @ . @ . . . . . . . . . . . . . . . @ . . @ 
. . . . . @ . . . @ . @ . . . . . . . . . . . @ . . . . @ . . . 
. @ . . . . . . . @ @ . . @ . @ . . . . . . . . . @ . . . . @ . 
@ . . . . . @ . . . . . . . . @ . . . . . . . . . . . @ . . . @ 
. . @ @ . . . @ @ @ . . . . @ . . @ . . . . . . . . . . . . . @ 
. . @ . . . . @ . . . @ . @ . . @ . @ . @ . . @ . . @ @ @ . . . 
. . . . @ @ . . . . . . . . . . . . @ . . . . . . . . . . . . . 
. . . @ . @ . . . . . @ . . @ . . . . . . . . . @ . . . . . . . 
. . . @ . . @ . . @ . . @ . . . . . @ @ . . @ . . . . . @ . . . 
. . . . . . . . . @ . . . @ . . @ @ . . . @ . . . . . . . . @ . 
@ @ . @ . . . . . . . . . . @ . @ . . . . . @ . . @ @ . . . . . 
. . . . @ . . . . . . . . . . . . . @ . . . @ . . . @ . . . . . 
. . . . @ @ @ . . . . . @ . @ . . . . . @ . . @ . . . . . . . . 
. . . . . . @ @ . @ . . . @ . . . . @ . @ @ . . . . . @ . @ . . 
. . @ . @ . . . . . @ . . @ . . @ . . . . . @ @ . . . @ . . @ . 
50
12 24 1 12
9 28 19 8
18 10 29 31
9 5 13 10
28 9 29 16
8 13 8 31
11 2 18 5
0 26 16 6
14 4 26 30
27 24 9 31
4 1 16 14
19 22 9 28
12 6 28 20
22 12 14 18
7 13 16 25
23 14 8 5
25 14 8 15
26 2 15 1
20 1 5 21
31 22 29 6
17 2 9 0
1 24 26 12
6 21 26 20
29 8 8 0
10 28 19 15
25 10 24 12
2 8 10 23
18 20 20 14
22 30 5 6
25 31 10 9
18 3 12 18
21 11 16 15
27 16 7 28
31 1 25 26
6 0 1 30
26 25 20 13
21 20 21 31
2 1 27 18
22 29 13 24
7 23 15 31
21 25 31 31
26 31 5 3
27 15 7 1
9 9 10 2
21 3 7 18
5 30 24 25
26 21 12 3
19 16 22 18
26 20 10 4
4 27 18 13
