32 32
@ . . . . . . @ . . . . . . . . . . . . @ . . . . . @ @ @ @ @ . 
@ . @ . @ @ . . @ . . . . @ . . @ . . . @ . . . . . . @ . . . . 
@ . @ . . . . . . . @ . @ . . . . . . . . . . . @ . . . . @ . . 
. . @ . . @ . . . . . @ . . @ . . . @ . . . . . . . . . . . . . 
. . . @ . @ . . @ . . . . . . . . . . @ . . . @ @ @ . . . . @ . 
@ . . @ . @ . . . . @ . . @ . @ . . . . @ . . . . . . . . . . . 
. . . . . . . . . . . . . @ . . @ . @ . . . . . . @ . . . . @ . 
@ . . . . . . . . . @ . . . . . . . . . @ . . . . @ @ @ @ . @ @ 
. @ @ . . . . . @ @ . . . . . . . . . . . . . . . . . @ . . . @ 
. . . @ . . . . . . . . @ . . . . . @ . . . . . . . . . . @ @ . 
. . . @ . . . . . . . . . . . . . . . . . . . . . @ . . . . @ . 
. . . . . . @ @ . @ . @ @ . . @ . . . . . . @ @ . . . . . . . . 
. . . . . . . . . . . . . . . . . . . . . @ . . . . . . . . . . 
. . . . . . @ . . . . . . . . @ . . . . @ . . @ . . . . @ . . . 
@ . . . . . . . . . @ . @ . . . . . @ @ . . . . . . . . . . . . 
. . . . . . . . . . . . @ . . @ @ . . . . . . . . @ @ . . @ @ . 
. . @ @ . . @ . . . . . . . . @ . . . . . . @ @ . @ . @ @ . . @ 
@ . @ @ . @ . . @ @ . . . . . . . . . @ @ @ . . . . . . . . . . 
. . . . @ . . @ . . . . . @ . @ @ . @ . . . . . . @ . . . . . . 
. . . @ . . @ . @ @ @ @ . . . . . . . . . . . . . @ . . @ . . @ 
. . . . . . . . . . . . . . . . . @ . . . . . . . @ . . . . . . 
. @ . . . . @ . . @ @ . . . . . . . . . @ . . @ . . . . . . . . 
. . . . . . . . . . @ . . . @ . . . . . . . . . . . . @ @ @ . @ 
. . @ @ . . . . . . . . . . . @ . @ . . . . . . . . . . . . . . 
. . . . . . . @ . . . . . . . . @ @ . @ . @ . . . . . . . @ . . 
. @ . . . . . . . @ . . . . . . . . . . . . @ . @ . . . . . . . 
. . @ . . . . @ . . . . . @ @ @ . . . . . . @ . @ . . . @ @ . . 
. . . . . . . @ @ . @ . @ . . . . . . . . . . . . . . . . . . . 
. @ @ . . . . . @ . @ . . . . . . . . @ @ . . . . @ . . . . @ . 
. . . . @ @ . . . @ . . . . @ . . . . . . . . . @ @ . . @ . . @ 
. . @ . . . . . . @ @ @ @ . . . . . . . . . . . . @ . @ . . . . 
. . . . @ . . . @ . . . . @ . . . . . @ @ @ . . . @ @ . . . . . 
50
30 23 3 25
19 15 17 14
0 4 11 9
24 7 3 29
17 13 1 11
25 23 6 22
20 11 10 15
1 6 30 24
27 19 27 23
28 11 5 0
19 30 26 27
2 7 31 1
21 6 14 30
3 11 22 17
12 24 19 18
29 10 5 30
15 14 0 27
28 15 4 26
0 31 12 17
15 20 31 13
10 10 19 22
15 1 17 7
5 0 1 0
28 20 15 3
18 7 10 3
22 1 26 2
22 24 13 29
18 4 9 15
3 6 19 7
15 24 29 14
1 1 24 18
1 27 19 5
28 5 31 24
26 3 21 25
30 13 1 5
23 24 11 23
17 8 17 2
31 1 10 10
17 21 4 23
27 20 11 0
13 8 0 18
15 19 1 30
16 14 21 29
9 3 22 13
3 7 26 17
5 26 7 5
25 2 23 24
1 23 14 8
11 6 12 5
8 30 6 25
