32 32
. @ . . . @ . . . . . . @ . . @ . . . . @ . . . . . . . . . . . 
. . . . @ . . . @ . . . . @ . . @ @ . . . . @ . @ . @ @ . . . . 
. @ . . . . . @ . . . @ . . . . @ . . . . . @ . . @ . . . . . . 
@ . . . . . . . . . . . . . . . . . . . . . . . . @ . . . . @ . 
. . . @ . @ . . . . . . . . @ . @ . @ . @ . . . . . @ . @ . @ . 
. . . @ . @ . . . . . . . . . . . . . . . . @ . . . @ . . . . . 
. . . @ . . . @ . . . @ . @ . . @ @ @ . . . . . . . @ . . . @ . 
. . @ . . @ . . . . . . . . . @ . . . . . . . @ . . . . . . . @ 
@ . . . . . @ @ @ . . @ . . @ @ @ . @ . . . . . . . @ . @ . . . 
. @ . . . . . @ . . @ . . . . . . . . . . @ . . @ . . . . . @ . 
@ . . . . . @ . . @ . @ . . . . . @ . . . . . . . . @ @ . . . . 
. . . . . . . @ @ . . . @ . . . . . . . . . . . . . . . . . . . 
. . @ . . . . . . @ . . @ . . . @ . . . @ . . . . . . . . . @ @ 
. . @ . . . . . . . . . . . . . @ . . . . . . . . @ . . @ . @ . 
. . . @ @ . . . . @ . . . . . . . . . . @ @ . . . . . . . . . . 
. . . @ . . . . . . . . . . . . . . @ @ . . @ . . . @ . . . . . 
. . . @ @ . . @ @ . . @ . . . @ . . @ @ . @ . . . . @ . . . . @ 
. . . @ @ . . . . . . . . . . . . . . . . . . @ @ . @ @ . @ . . 
@ . . . . . . . . . . @ . . @ . . @ . . . . . . . . . . . @ @ . 
. . . . . . . . @ . @ . . @ @ . . . @ . . . . . . @ @ . . @ @ @ 
. . . @ . . @ . . . . . @ . @ @ . . . . . . . . . . . . . @ . . 
. . . . @ @ . . . @ . . . . . . . @ . @ . . . . . @ . . . . @ . 
@ . . . . . @ . @ . . . @ . . . @ . @ . @ . . . . @ @ . . . . . 
. @ . . . . @ . . . . . . . . . . . @ . . . . . . . . . . . @ @ 
@ . @ . . @ . . . . . . . . @ . . . @ . . . @ . . . . . @ . . . 
@ @ . . . @ . @ . . . . . @ . . . . . . . . . . . . @ . . @ @ . 
@ @ . . @ @ . . @ @ @ . . @ . . . . @ . . . @ . @ . . . . . . . 
. . @ . @ . . . . @ . . . . @ . . . . @ . . . . . @ . . . . . . 
. . . . . . . . . . . . . . . . . . @ . . . . . . . . . . . @ . 
@ . . . @ . . @ . . . . . . . . . . . . . . . . . . . . . . . . 
. . . . @ . . @ . . @ . . . . . @ . . . @ . . . . . @ . . . . . 
. @ . . . . . . . . . . . . . . . . . . . . . . . . . . . . . . 
30
1 22 7 7
15 31 25 5
2 29 29 15
0 0 9 20
30 8 27 14
18 0 23 25
0 7 27 2
7 23 6 5
25 4 23 30
11 20 2 9
21 26 1 8
4 10 17 7
28 5 9 13
24 29 24 7
12 5 10 7
10 8 12 4
29 13 28 7
6 12 10 3
5 6 18 25
9 1 12 24
8 5 7 20
30 11 5 28
21 31 21 29
31 22 18 12
14 11 17 19
13 20 23 6
4 4 6 7
31 18 18 14
20 18 2 20
28 26 10 5
