32 32
. . . . . . @ . @ . @ . . . @ . . . @ . . @ . . . . . . . @ . . 
. . . @ . . . . . . . . . . . . . @ @ . . . . . . . . @ . @ . . 
. @ . . . . . . . . @ . @ . . . @ . . . . @ . @ @ . . . . . @ . 
. . . . @ . . @ @ . @ @ . . . . . @ . . . . . . @ . . . . . . . 
. . @ . . . @ . . . @ . . . . @ . . . . . . . . . @ . . . . . . 
. . . . . . @ . . . . . . . . . @ . . . . . . . . . @ . . @ . . 
. @ . . . . . . . . . @ @ . . . . . . . . . . . @ . . @ @ @ . . 
@ . @ . . . . . . @ @ @ . . @ . . . . . . . . . . . . . @ . . @ 
. @ . . . . . . . . . . . . . . @ @ . . . . . . . . @ . . @ . . 
. . . . . . . . . . . . . . @ . @ @ . @ . . . @ . . . @ . . . . 
. . . . @ . . . . . . . . . . . . . . . . @ . . @ . . . . . . @ 
. . . . . @ . @ . @ . . . . . @ . . . . . . . . . . @ . . . . @ 
. . . . . @ . . . @ @ . . . @ @ . @ . @ . . . . . . . . @ @ . . 
@ @ . . . @ . . . . . @ @ . . . . . . . . @ . . . . @ . . . @ . 
. @ . @ . . . . @ . . . . @ @ @ . . . . . . . . . @ . . . . . @ 
. . . @ . . . . @ . . . @ . @ @ . . @ . @ . . . . . . . . . @ . 
. . . . . . . . . . . . . . @ . @ . . . @ . . . . . . . . . . @ 
. . . @ @ . . . . . . . . . . . . . . . . @ . . . . @ . . . . @ 
. . @ . . . . . . . @ . @ . @ . . . . @ . . . . . . . . . . . @ 
. . . . . . . . @ . . . . . . . @ @ . . . . . @ . . @ . . @ . . 
. . . . . . . . . . . . . . . . . . . . . . . . . @ . . @ . . . 
@ . . . . . . . . . . . . . . @ . . . . . @ . . . . . . . . . . 
. . . . @ @ . . . @ . . . . . @ . @ . @ . . @ @ . . . @ . . . @ 
. . . . . . . . . . @ . . @ . . . . . . . @ . @ . . @ @ . @ @ @ 
. . . . . . @ . . . @ . . . . . . @ . . . @ . . . @ . . . @ @ . 
. @ . . . . . . . @ @ . @ . . . @ . @ . . . . . . . . @ @ . . . 
. . @ . . . . . @ . . . . @ . . . . @ @ @ . . . . . . . . @ . @ 
@ . . . . . @ . @ @ . . . . @ . . @ . . . @ . . . . . @ @ . @ . 
. . . . . . . . . . . . . . . . @ @ . @ @ . . . . . . . . @ . . 
. . . . . . . . . . . . . @ @ . . . . . . . . . @ . . . . . @ @ 
. . @ . . . . . . . . . . @ . @ . . . . @ . . @ @ . . . . . @ . 
. . . . . . . @ . . @ . . . . . . . . . . . . @ @ . . . . . . . 
50
3 25 11 5
7 28 5 17
18 21 12 10
31 13 6 11
10 21 15 13
28 29 24 23
7 29 1 12
27 3 20 24
26 18 11 28
11 5 7 0
30 22 16 4
29 17 2 2
14 21 3 20
29 10 13 9
31 31 19 0
19 10 12 11
0 10 12 24
25 17 29 14
19 11 17 0
2 1 4 15
23 20 5 1
26 25 23 27
12 26 2 29
18 24 20 17
28 21 6 13
9 4 27 3
8 6 0 24
27 18 30 14
19 7 18 28
29 13 27 19
9 2 13 24
16 29 28 18
26 27 16 1
20 25 26 14
17 17 19 30
30 5 1 10
4 18 22 9
25 26 25 16
16 0 28 14
26 0 4 25
14 6 14 19
9 18 27 21
4 5 14 6
10 15 25 12
17 0 4 30
22 4 14 8
26 3 16 22
18 9 8 31
31 8 20 2
3 26 28 0
