32 32
. . . . . . @ . . . . . . . . . . . . . . . . . . @ . @ . . @ @ 
. . @ . . . . . . @ . . @ @ . . @ . . @ . . . . . . . . . . . . 
. . . @ . . . . . . . . . . . . . . . . . . . @ . . . . . . . . 
. . . . . . . . . . . . . @ . . . . @ . . . . . @ . . . . . . . 
. @ . . @ . . . @ @ @ . @ . . . . . . . . . . @ . @ . . . . . . 
. . . . . @ . @ . . . . . . . . . . . @ . . . . @ . . . @ . . . 
. . . . . @ . . . . . . . . . . . . . . . . . . . . @ . @ . . @ 
. . . @ . . . . . . . . . . . . @ . . . . . . . . . . . @ @ . . 
. . . @ . @ . . . . . . . . . . . @ . . . . @ . @ @ . . . . . . 
. . . . . . . . . . . . @ . @ . . @ . . @ @ @ . . . . @ . . . . 
@ . . @ . . @ . . . @ . @ . . . @ @ . . @ . . . . . . . . @ . . 
. . . . . . . @ . . . . @ . @ . . . . @ . @ . . . . . @ . @ . . 
@ . @ . @ . . . . . . . @ . . . . . . . . . . . . @ . . @ . @ @ 
. . @ . . . @ @ . . . . . . . . . . . . . . . . @ . . . @ . . @ 
. . . . . @ . . . . . . . . . . . . . . . @ . . . @ . . . . . . 
. . @ @ . . . @ . . @ . . . . @ . . . . . . @ . . . @ . . . @ . 
. @ . . @ . . . @ . . . . @ . . @ . . @ . @ . . . . . . @ @ . @ 
@ . @ . . . . . . @ . @ . . . @ . @ . . @ . . . . . . . . . @ . 
@ . . @ . @ . . . . @ . . . . . . . . . . . @ . . . . . . . . . 
. . . @ . . . . . . . . . . . . . . . . . . @ . . @ @ . . . . . 
@ . . . @ . @ . @ . . @ @ . . . . . . . @ . . . . . @ . . . @ . 
. . . . . . @ @ . . @ . @ . . @ . . . . . @ . . @ . . . . . @ . 
@ . @ . . . . . . . . . . @ @ . @ . . . . @ . . . @ . . @ . . . 
. . . @ . @ @ . . . . . . . . . . @ @ @ . . @ @ . . @ @ . . @ . 
@ . . . . . . . @ . @ . . . . . . . . . . . . . . . . . . . . . 
. . . @ . . . @ @ . . @ . . . . @ . . . @ . . @ . @ . . . . . . 
@ . . . . . . . . @ . @ @ . @ . . . @ @ . @ . . @ . @ . @ @ . . 
. . @ . . @ . . . . @ . . . . . . @ . . . @ . . . . @ . . @ . . 
. @ . . @ @ . . . @ . . . . . . . @ . . . . . . . @ @ . . . @ . 
. . . . @ . . . . . . . . . . @ @ @ . . . . . . . . . . . . . . 
. @ . . @ . . . . . @ @ . . . . . . . . @ . . . . . . . . . . . 
. . . . . . . . . . @ . . . . . . . . . @ . . . . . @ . . . . . 
10
3 0 13 17
17 12 2 6
29 0 26 12
7 8 19 0
9 0 10 17
1 27 3 31
6 2 23 29
18 20 27 18
15 25 14 28
27 26 11 1
