32 32
@ @ . . @ @ . @ . . . . . . . . . . . @ . @ @ . . . @ . . . . @ 
. . . @ @ . . . . @ @ . . . . @ . . . . . . . . @ . . @ @ . . . 
. @ . @ . . @ @ . . . . @ . . . . @ . . . @ . . . . @ . . . . @ 
. . . . @ . @ . . @ . . @ . . . . . . . . @ . . . . . . . . . @ 
. . . @ . @ . . . . @ . @ . . . . . @ . . . . @ @ . . @ . @ . . 
. . . . . . . . . . @ . . . . . . . @ . . . . . . . . . . . . . 
@ . . @ . . @ . . . . . . . . . . . . . . . . . . . . . . . . . 
. . . . . . . . . @ @ . . . @ . . . . . . . . . . . . . @ . . . 
. . . . . . . @ . . . @ . . . @ . . . . . . . . . . . . . . @ . 
. . . . . . . . @ . @ . . @ . . . . @ . . . . . @ . . @ @ . . @ 
. . . . . @ . . . @ . @ . . . . . . @ . . . . @ . . . . . . . . 
. @ . . . . . . @ . . @ . . . @ @ . @ . . . . . . . . . . . . . 
. . @ @ . . . . . . . . . . . @ . . @ . . @ . @ @ . . . . . . . 
. . . @ @ . . @ . . @ @ . . . . . . . . . . . . . @ . . . . . . 
. @ . . . . . @ . . . . @ @ @ . . . . . . . . . . . . . @ . . . 
@ @ . . . @ . . . . @ . . . . @ . . . . . . @ @ @ @ . . . . @ . 
@ . . . . . @ . @ . . . . . . @ . . . @ . . . . @ . . . . . . @ 
. . . . . . . . . . . . . . . . . . . @ . . . . . @ . . . . @ . 
. . . . . . . . . . @ @ . . . . . . . . . . . . . . . . . . . . 
. . . . @ @ . . @ . @ @ . . . . . . @ . . . . . @ . . . . @ . @ 
. . . @ @ @ . @ . . @ . @ . . . @ . . . . . . @ @ @ . . @ . . . 
. . @ @ @ . . . . . . . . . . . . . . . . . . . @ . . . @ . @ @ 
. . . @ . . . @ @ . . . . . . @ . . . . . @ . . @ . . . . . . @ 
. . . . . . . . . . @ . . . @ . . . . . . . . . . . . . . @ . . 
. . . . . . . . . . . . . @ . . . @ . . . . . . . . @ . . . . . 
. . . . . . . @ . . . . . . . @ . . @ . @ . . @ . . . @ . . . . 
. . . . @ . . . @ @ @ . . . . @ . . . . @ . . . . @ . @ . @ . @ 
. @ . . . . . @ . . . . @ . @ . . . . . . . . @ . @ . @ @ . . . 
. . . @ . . @ . @ . . . . @ . . . @ . . . . @ . . @ . . . . . . 
. . . @ @ . . @ . . . . . @ . . @ . . . . . . . . @ . . . . . . 
. . . . . . . @ . . @ @ . . . @ . . . @ . . . . . . @ . . . . @ 
. . . . . . . . . @ . . @ . @ . @ . . . . . . @ . . . . . . . . 
10
10 24 19 5
29 30 20 1
0 11 17 22
11 26 14 29
29 8 20 13
30 27 5 9
28 22 25 31
16 22 28 15
16 9 17 18
31 10 2 9
