32 32
. . . . . . . . . @ . . . . . . . . . . . . . . . . . @ . . . . 
. . . . . . @ . . . . . . . @ @ . @ . . . . . @ . . . . . . @ @ 
@ . . . . . . . . . . @ . . . . . . . @ @ . @ . . . . . . . . . 
. . . @ . . . . . . . @ @ . . . . . . @ . . . . . @ . . @ . . . 
. . . . @ . . . . @ . . @ @ . @ . . @ @ @ @ . @ . . . . . . . . 
@ . . . . . . . . . . . . . . . . . . @ . @ . . . . @ . . @ @ . 
. . @ . . . @ @ . @ . @ . . . . . . . @ . . . . . . . @ . . . . 
. . . @ . . . @ . @ . . . . . . . @ . . . @ . . . @ . . . . . . 
@ . . . . . . . . @ . . . . . . . . . . . . . . . . . . . . . . 
. . @ . . . . @ . . . . . . . . . @ @ . . @ . @ @ . . . . . @ . 
. @ . @ . . . . . . @ . . . . @ @ . . . . . . . . . @ . @ . . . 
. @ . . . @ . @ . . . @ @ . . @ @ . . . . . . . @ . . . . . @ . 
. . . . . . . . . . . @ @ . . @ . . . . . . @ . @ . . . . . . @ 
. . @ @ @ . @ . @ . . @ . . . . . . . . . . @ . . @ . . . . . . 
. . . . . . . @ . @ . . . @ . @ @ . . @ . . . . . . @ @ . . . . 
. @ . . . @ . . . . . . . @ . . @ . . . . . . @ . . . . . @ @ . 
. @ . . @ . . . @ . . . . . . . . . . . . . . . . . . . @ . . . 
. . . @ . . . . . . . . . . . @ . . . . . . @ . . . . . @ @ . @ 
. . . . . @ @ . . . . @ . @ @ . . @ @ . . @ @ @ . @ . . . @ . . 
. @ . . . . @ . . . . . @ . . . . . . @ . @ . . @ . . . . . . @ 
@ . . @ . . . . . . @ . @ @ . . . . . . . . . @ . . @ . . . @ . 
. . . . . . . . . . . . . . . . . . . . . . . . . . . @ . . . . 
. . . . . . . . . . . . . . . . . . . . @ . . . . . . . . @ @ . 
. . @ . . . . . @ . . . . . . @ . . @ . . . . . . . . . . . . . 
. . . . . @ . . . . . . . . . . . . . . @ . . . . . . @ . . . . 
. . @ . . . . . . . @ . . . . . . . @ . . . @ . . . . @ . . . @ 
. . @ . . @ . . . . . . . . . . @ . . . . . . @ . . . . . @ @ . 
. . . @ . . . . . . . @ . . . @ @ @ . @ . . . @ . . . . . . . . 
@ . @ . . . . . @ . @ . . . @ . . . . . . @ . . . @ . @ . . . . 
. . . @ @ . . . @ . . . @ . @ . @ . . . . . . . . . . . . @ . @ 
. . . . . . . . . @ @ . @ . @ . . . . @ . . @ @ . . . @ @ . . . 
. . . . . @ . . . @ . @ . . . @ . . @ @ . . . @ @ . . . . . . . 
20
27 3 23 23
3 15 9 10
17 24 13 22
9 17 26 7
20 14 20 25
25 19 8 4
4 1 3 25
26 26 21 20
14 15 30 31
28 8 28 23
18 27 8 11
26 7 18 24
1 31 9 11
0 25 4 3
28 4 16 18
23 25 0 23
21 2 17 8
23 8 20 30
1 26 24 27
18 10 3 23
