32 32
. . . . @ . . . . . . . . @ . @ . . @ . . . . . . . . . . . . . 
. . . . . . . . . . . . . . . . @ . @ @ . . . . @ . . . . . @ . 
. . . . . . . @ . . . . @ . . . . . @ . . . @ . . . @ . . . @ @ 
. . @ . . @ . . . . . . @ . @ . . . . . @ . . . . . @ @ . . @ . 
. . . . . . @ . . . . . . . . . . . . @ @ . . . . . . . . @ . . 
@ . . @ . . . . . . . @ @ . . @ @ . . @ . . @ . @ . . . . . @ . 
. @ . . . . . . . @ . . . @ @ . . @ . @ . @ . . . . . . . . . . 
. . . . . . . . . . . . . . . . . @ . . @ . . @ . . @ @ . . . . 
@ @ . . . . . . . . . . @ @ . . . . . . . @ . . . . . . . @ . . 
. . . . . @ @ . . . @ . . . . . . @ . . . . . . . . . . . . . . 
@ @ . . . . . . . . . . . @ . @ . . . @ . @ . . @ . . . . . . . 
. @ . . . . @ . . @ . . . . . . . . . @ . . . . . . . @ . @ . . 
. . . @ . . . . . . . @ . . . . @ . . . . . . . . . . . . . . @ 
. . . . . . . @ @ . . @ . . . . . . . @ . . . . . . @ . @ . . . 
. . . @ . . . @ . @ . . . . @ . . . . . . . . . @ @ . . . @ @ . 
. . . @ @ @ @ @ @ . . . @ @ . . . @ . . . . . . . . . . . . . . 
. . . . . . . @ . . . . . @ . . . . . . @ . . . . . . . . . . . 
. @ . @ . @ . . . . . . . @ . . . . . . @ . . . . . @ . . . @ . 
. . . . . @ . @ . . @ . @ @ . . . . . . @ @ . . . . . . . . . . 
@ . . . . @ . @ @ . . . . . . . @ . . . @ @ . . . . . . . . . . 
. . . . . . . @ @ . . . . . @ . @ . . @ . . . @ @ . @ . . . . . 
. . . @ . . . . . . . . . . . . @ . . . . @ . . @ . . . . . . . 
. @ @ . . . @ . . . . . . . @ . @ @ . . . . . . . . . . . . . . 
. . . . . @ . . @ . . . @ . @ . @ @ . . . . . . . . . . . . . . 
@ . . . . . . . @ @ . . @ . . . . . . . . @ . . . . @ . . . . . 
. . . . . @ . . . . . . . . . . . @ . . . . . . @ . . . . . @ . 
. . . @ @ . . . . . . . @ . . . . . . . . . . . . . . @ . . . . 
@ . . . . . . . . . . . . . . . . @ . . . . . @ . . . . . . . @ 
@ @ . . . @ . @ @ @ @ . . . . . . . . . . . @ @ . . @ @ @ @ . . 
. @ . . . . . . . . . @ . . @ . . . . . @ . . @ . @ @ . . . @ . 
. . . . . . @ . . . @ . . @ . . . . . . . @ . @ . . . . . . . . 
@ @ . @ @ @ @ . . @ . . . . . . . @ . . . @ @ @ . . . . . . @ . 
40
10 27 7 24
25 12 27 29
20 20 7 12
31 13 29 27
18 24 22 3
30 8 7 10
24 11 12 22
5 5 2 28
5 2 21 13
17 13 22 0
10 22 30 30
17 12 23 19
25 2 24 22
15 27 25 16
25 18 6 26
10 15 1 15
10 12 17 8
1 30 26 19
24 26 23 12
2 30 9 21
26 6 16 25
18 17 6 21
13 14 10 25
31 8 1 13
1 18 11 9
1 2 15 18
16 26 7 26
4 23 9 10
10 24 11 1
14 19 7 30
10 19 29 26
2 19 7 27
5 21 5 7
17 4 16 24
1 14 27 9
2 5 2 10
22 9 1 30
23 9 21 11
15 2 29 1
27 18 13 1
