32 32
. . . . . . . . . . . . . . @ . . . . . . @ . . . . . . . . . . 
. . @ . @ . . . @ . . . . . . . . . . . . . . . @ . . @ . . . . 
. . @ . @ . . . . . . . @ . . @ . . . . . @ . . . . @ . . . . @ 
. . . . @ . . . . @ . . @ . . . . @ . . . . . @ . @ . . . . . . 
. . . . . . . @ . . @ . . . . . . @ . . . . . @ . . . . . @ @ . 
. . @ @ @ . . . . . @ @ . . . . . . . . . . . . . . . @ . . . @ 
@ @ . . @ . . . . . @ . . . @ . . . . . @ . @ @ . . . @ @ . . . 
. @ . . @ . . . . . . . . . . @ @ . . . @ . . . . @ . . . @ . . 
. . . . . . . @ . @ . . . @ . . . . . @ @ . . . . . . . @ . @ @ 
. . @ @ . . . . . . . . . . . @ . . . . . . @ . . . . . . . . . 
. . . . . . . . @ . . @ . . . . @ @ . . . . . . . . . . . . . . 
. @ . . . . . @ . . . . . . . . . . . @ . . . @ . . . . . @ . . 
. @ . . . . . . . @ . . . . . . . . . . . . . . @ . . . . @ @ @ 
. . . . . @ . . . . . . . . . . . . . @ . @ . . . . . . . @ . . 
. . . . @ . . @ . . . . . @ . . . . @ . . @ . . . @ . . @ . . . 
. . . . . . @ . . . . . @ . . . . . . @ . @ . @ . . @ . @ . . . 
. @ . . . . @ . . . . @ @ . . . . @ @ . . . . . . . . . . . . . 
. . @ . @ . . . . . . . . @ . . @ @ . @ . . . . . @ . @ . . . @ 
@ . @ . . @ . . . . @ . . . . . . . . @ . . . . . . . @ @ . . . 
. . . @ . . @ . . . @ . . @ . . @ . . @ @ . . . . . . . . @ @ @ 
. . . . . . . . . . . . @ . . . . . . . . @ @ . . . . @ . @ . @ 
@ . . @ . @ @ . . . . . . @ . . . . . @ . @ . . . @ . . . . . . 
. . . . . @ @ . @ . . . . @ . @ . . . . . @ . . . . . . . . . . 
. . . . . . @ . . . @ . . . . . @ . . . . @ @ . @ @ . . @ . . . 
. . . . . . . . . . . . . . . @ . . @ . @ @ . @ . . . @ . . . . 
@ . . . . . @ . . . . . . @ . . . @ . @ . . . . . . . . . @ . . 
. . . . . . . . @ . . @ . . . . . . @ @ . . @ @ @ . . . . . . . 
. . . . @ . . . . @ . . . . . . . . . @ . . . . . @ . @ . . . . 
@ . . @ . . . . . . . . . . . . @ . . . . . @ . . . @ . @ . . . 
. . . @ . . . @ . . . . . @ . @ . . . . . @ . . . @ . . . @ . . 
. . . . . . . . . . . @ . . @ . . . . . . . . . . . . @ @ . . . 
@ @ @ . . @ . @ . . @ . . @ . . . . . . . . . . @ . . . . . . . 
30
28 31 18 9
5 7 31 28
29 9 5 29
14 25 4 8
8 3 18 31
20 21 25 9
18 6 9 15
26 10 7 3
7 25 0 14
14 16 18 11
31 26 22 12
8 29 5 10
18 0 16 24
29 22 28 27
4 29 9 13
22 25 31 6
17 28 11 23
12 1 16 3
24 9 6 2
1 22 17 23
8 19 16 2
3 13 8 5
29 5 27 9
28 22 27 3
8 25 24 21
1 21 14 23
29 27 21 10
22 14 5 4
28 0 4 0
22 8 20 11
