32 32
. . . . @ . . . . @ @ . @ . . . . . . . . . . . @ . . . . @ . @ 
@ . @ . . . . . . . @ . . . . @ . . . . . @ . . @ . @ . . . . @ 
. @ . . . . . @ . . . . . . . . . . @ . @ @ . @ . @ @ . . . . . 
. . @ . . @ . . . . . . . . . @ . . @ . . . . . . . @ . @ . . @ 
. . . . . . . . . . . @ . . . . . @ . . . . @ . . . . . . . . . 
. . . . @ @ . @ . @ . . @ . . @ . . . . . . . . . @ @ . . @ . . 
@ . . . . @ . . @ . . . @ . . . . . @ . . @ . @ @ . @ . . . . . 
. . . . . . . . . . . . . . @ @ . . . . . . . @ . . . . . . . . 
. . . . . @ @ . @ . . . . . @ . . . @ . . . . . . . . . . . . . 
. . . . . @ . . . . @ . @ . @ . . . . . @ . . . . . @ . @ . . . 
@ . . . . . @ . . . . . . @ . @ . @ . . . . . . . . . . . . . . 
@ . . . . @ . . . . . . . @ . @ . . . . . @ @ . . . . . . . . . 
. . @ @ . . . . . . . . . . . . . . . . . . . . . @ . . . @ . @ 
@ . . . . . . . . . . . @ . . . . @ . . . . . . . . . . . . . . 
. . . @ . . . . . . . . . @ . . . . . . . . @ . @ . . . . . . . 
. . . . . . @ . . . . @ . @ . . . . @ . . . . . . . . . . . . . 
. @ . . . . . . . . . . . . . @ . . . . . . . @ . . . @ . . . . 
@ . . . . . @ . . @ @ . @ . . @ . @ . . @ . . . . @ @ . . . . . 
. . . @ . . . . . . @ @ . . . . . . @ . @ . . . @ . @ . . @ . . 
@ . . . . @ . . . . . @ @ . . @ @ . . . @ @ . . . @ . @ @ . @ . 
. . . . . . . . . . @ . . . . . @ . . . . . . . @ . @ . . . . . 
@ . . . . @ . . . . . . . . . @ . @ . . . . @ . @ . @ @ @ . . . 
. . . . . @ @ @ . . . @ . . . . @ . . . . . . . . . . . @ . . . 
. . . @ . . @ @ . . @ . . . . . . . . @ @ . @ . . . . . . . @ @ 
. @ . . . @ . . . . . . . @ . . . . @ . @ . . . . . . . . . . @ 
. @ @ . @ . . . . . . @ . . @ . . . . @ @ . . . . . . . . . @ . 
@ . . . . . . . . . . . . . . . . @ . . . . . . @ . @ . . . . . 
. . . . @ . . . . . @ . . @ . . . . . . . . . . . . @ @ . . . . 
. @ @ . . . . . . . . . . @ . @ . @ . . . . . @ @ . @ . . . . . 
@ . . . . . . . . . . . . @ . . @ . . . . . . . . @ @ . . . . . 
. @ @ . . . . . . . . . @ . . . @ . @ . . @ @ . . . . . . . . . 
. . . @ @ . . . @ . . @ . @ . . . . . . . . . . @ . . . . . . . 
70
25 16 13 25
9 22 14 18
31 28 7 14
28 14 12 4
6 28 7 4
16 8 26 22
9 1 8 17
30 13 4 23
25 21 6 12
6 30 29 25
2 5 28 17
29 11 3 30
20 20 25 16
9 8 24 17
27 17 3 3
16 31 2 6
13 22 23 21
27 14 31 17
17 16 24 3
10 21 18 12
24 8 19 5
1 20 8 29
13 5 15 29
28 17 1 23
10 19 24 24
10 26 0 9
14 2 23 0
29 28 17 29
20 31 21 27
2 18 27 22
17 24 31 6
1 3 15 31
29 25 28 24
13 25 1 26
25 6 25 14
25 27 6 9
19 28 27 24
20 12 10 15
29 1 4 17
26 11 13 26
7 3 4 22
7 14 20 21
17 29 12 1
4 28 13 22
5 29 5 0
4 17 19 9
24 11 2 19
12 15 1 20
28 8 18 10
6 14 28 12
18 25 11 1
18 10 18 13
1 26 19 27
10 22 24 7
12 20 10 29
23 17 7 3
20 4 5 27
1 23 4 10
9 4 27 26
21 27 11 2
25 10 14 26
17 27 13 30
1 21 9 8
1 6 10 30
29 4 19 17
19 16 19 8
1 12 14 16
29 6 8 15
22 6 7 20
0 23 10 16
