32 32
@ @ . . . . . . @ . . . . . . . . @ @ . @ @ . . . . . . . . . . 
. . . . . . . . . . . . . @ . . . @ . . . @ . @ . . @ . . . @ . 
. . @ . . . . . . . . . . . . . . . . . . . . @ . . . . . @ @ . 
. . @ . . . @ . @ . @ @ . . . @ . . . . . . . . . . @ . @ . . . 
. . . . . . @ . @ . . . . . . . . . . . . @ @ . @ . . . . . . . 
. @ . . . . . . . . . . . . @ . . . @ . . . @ . . @ . . . . . . 
. @ . @ . . @ . @ @ . @ . . . . . @ @ . . . . . . . . . @ @ . @ 
. . . . . . . . . . . . . . @ . . . . . @ . . . . . @ @ . . . . 
. . . . . . . . . . . . @ . . . . . . . . . @ @ @ . . . . . . . 
. . @ . . @ . . . . . . . . . @ @ . . . . @ @ . . @ . . . . @ . 
. . . . . . . . . . . . . @ . . . @ . . . . . . . . . . . . . @ 
. . @ . @ . . @ . @ . . . . . @ @ . . . . . . . @ @ . @ . . @ . 
. . @ . . . . . . . . @ . . . . . @ @ . . . @ . . . . . . . . @ 
. @ . . @ @ . @ . @ @ . . . . . . @ . . . @ @ . @ . @ @ . . . @ 
. . . @ . . . . . . . . . @ . . . . . @ @ . . . . @ . . . . @ . 
. @ @ @ . . @ . @ . . . . @ . . . . . @ . . . . . @ @ @ @ . . @ 
. . . . . . . . . . . . . . . . . @ @ . @ . . . . . . . @ . . . 
. . . . . . . @ . . . . . . . . . . . . . . . @ @ . . . . . . @ 
@ . @ . . . @ . . . . . . . . . . . . . . . . @ . @ @ . @ . . . 
. . . . . . . . . . @ @ . . . . . @ . . . . . @ . . @ @ . . . . 
. @ . . . . @ . . . . . . . @ . @ . @ . . . . . @ . . @ . . . . 
. @ . . . . . @ . . . . . . @ . . . . . . @ . . . . . . . . . @ 
@ . @ @ @ . . @ . @ @ . . @ . . . . . @ . @ . . . . . . . . . . 
. . . . . . . . @ . @ . . . . . . . . . @ . . . . . @ . . . @ @ 
@ . . . . . @ @ @ . . @ . . . @ . . @ . . . @ . . . . . . . @ . 
. . . . . . . . . . . . @ . . . . . . @ . . . . . . @ . @ . . @ 
. . . @ @ . . . . . @ . . . . . . . . @ @ . . . . . . . . . . . 
. . . . . . . . . . . . . @ . . . . . . . . . . . . . . @ . . . 
. . . @ @ . . . . @ . @ . . @ . . . . . . . . . @ . @ . . . . . 
. . . . @ @ . . . . @ . . . . @ . . . . . @ . . . . . . . . . . 
. . . . @ . . . . @ . . . . . . . . . @ . . . . @ . @ . @ . . . 
. . . . . . @ . . . . @ . . . . . . @ . . . . . . . . . @ . . . 
50
5 8 1 26
6 1 24 23
17 3 12 17
16 8 30 15
31 28 5 15
27 21 25 7
9 19 5 28
31 4 11 13
14 24 1 11
28 23 1 17
13 21 12 9
20 30 9 14
9 23 2 0
13 26 18 13
3 5 23 20
16 17 17 26
11 25 11 8
8 16 29 22
14 23 18 30
13 30 7 28
10 12 7 12
24 14 29 16
20 2 16 30
3 4 27 5
23 24 2 27
8 19 18 4
10 7 29 15
5 22 13 5
21 16 11 2
14 17 15 16
12 1 3 29
5 11 7 1
7 20 16 14
4 31 14 25
15 5 21 17
14 25 11 23
18 10 1 2
16 30 12 6
5 24 14 9
14 10 4 2
8 21 3 13
10 28 9 9
13 12 3 2
20 15 29 30
26 31 8 5
28 20 30 28
19 8 16 28
22 16 12 26
30 4 0 6
4 10 24 12
