32 32
. . . . . @ @ . . . . . . . . . . . . . @ . . . . . @ . . . . . 
. . . . . . . . @ @ . . @ . . . . . . . . . . . . . . . @ . . . 
. . . . . @ . . . . . . . @ @ . . @ . @ @ . . . . @ . . . . @ . 
. . . . . @ . @ . . . @ @ . . @ . . . . @ @ . @ . . . @ . . . . 
. . @ . . . . @ @ @ . . @ . . . . @ . . . . @ . @ . . @ @ . . . 
@ . . . @ . . . @ . . @ . . . . . @ . . . . . . . . . . . . . . 
. . . . . . . . . @ . . . . . . . . . . . . . @ . . . . . . . . 
. . . @ . . . @ . . . . . @ . . . . . . . . . . . . . . . . . . 
. . . . @ @ . @ . . . . . . . @ . @ . . . . . . . . . @ . . . . 
. . @ . . . . . . . @ @ . . @ . @ . @ . @ . . . . . . . . . . . 
. . . @ @ . . . . @ . . . . @ . @ . . . . . @ . . . . . @ @ @ . 
. . . . . . . . . . @ . . . . . . . . . . . . . @ . . . @ . . . 
. @ @ . . . . . . . . . . . . . . @ . . . @ . @ . . . . . . . . 
. @ . . . . . @ . . @ . . . . . . . . @ @ . . @ . . . . @ @ @ @ 
. . . . . . @ @ . . . . . . . . . @ . . . . . @ @ . . . . . . . 
. . . . . . . . . . . . . @ . . . . @ . . . @ . . . . . . . . . 
. . . . @ @ . . . @ . . . . @ . . . @ . . . @ . . . . . . . . @ 
. @ . . . . @ . . @ . . . . . . . . . . . . . . . . . . . @ @ . 
@ . . . . . . . . . . . @ . . . . . @ @ . . . . . . . . . @ . @ 
@ . @ . @ @ . . . . . . . @ . @ @ . . . . . . . . . . . . . . . 
. . . . . . . @ . @ . . . . @ . @ . . @ . . . . . . @ . @ . . . 
. @ @ . . . . @ @ . . . . @ @ . . . @ . . . . . . . . . @ . . . 
. . . @ . . @ @ . . . @ . . . . @ . @ . . . . @ @ . @ @ @ . . . 
. @ . @ @ . . . . . . . . . . . @ . . . @ . . @ . . . . . . . @ 
. . @ . . @ . . . . . @ . . . . . . . . . . @ . @ . . . . . . . 
. . . . . @ @ . @ @ . . . @ . @ @ . . . . . @ . . . . . . . . @ 
. . . . . @ . . . . . . . @ . . . . . @ . . . @ @ @ @ . @ . @ . 
@ . . @ . @ . @ . . @ @ @ @ . . @ . . . . . @ . . . @ . . . . . 
. . @ . . . . . @ . . . . @ . . @ . . . . . . . . . . . . . . . 
. @ . . . . . . . . . @ . . . . . . . . . . . . . . @ . @ . . @ 
. . . . . @ . . . . @ . . . . . . . . . . . @ . . . . . @ . @ @ 
. . . . @ . . . . . . @ @ . . . . . . . . . . . . . . @ . . . . 
50
2 30 27 20
10 31 19 1
21 23 13 22
19 4 27 1
6 6 19 23
13 13 5 6
29 22 27 16
22 29 20 16
17 23 11 1
22 22 6 31
16 15 25 29
5 31 6 6
4 29 16 0
4 2 28 19
19 10 26 11
14 7 25 14
24 8 30 27
5 1 14 6
23 0 26 5
29 14 28 15
30 27 1 4
25 8 13 16
10 26 6 21
23 20 28 8
9 19 8 19
24 16 13 1
12 17 21 29
18 30 15 30
11 20 13 9
7 29 30 15
3 30 1 0
5 29 29 22
8 2 11 18
10 20 7 9
1 30 8 2
0 3 12 19
17 26 11 4
20 17 17 29
5 21 2 10
3 2 21 7
12 26 23 2
22 8 20 26
1 14 9 9
3 12 30 23
8 24 3 4
25 10 16 31
6 27 0 0
12 13 6 11
25 25 2 31
16 14 14 22
