32 32
. . . . . . . . @ . . . . . . . . . . @ . . . . . . . @ @ . . . 
@ . . . . . @ . . . @ . . @ . . @ @ . . . . @ . @ . . . @ @ . . 
. . . . . . . . . . . . . . @ . @ . . . . . . . . . . @ . . @ . 
. @ @ . @ . . @ . . . . . . . @ . . . . . @ . . . . . . . . @ . 
. . . . . @ . . . . . . . . @ . . . . . @ . . . . . . . . . . . 
. . . . . . . @ . . . . . . . . @ . . @ . . . . . . . . . . . @ 
. . . @ . @ . @ . @ . @ . . . . @ . . . @ . . . . . . . . . . . 
. @ . . @ . . . . . . . . . . . . @ . . . . . . . . @ . . . . . 
. @ . @ . @ . . . . . . . . @ . @ . . . . . . . @ . . . @ . . . 
. . @ . . . . @ . @ . . . . . . . @ . . . @ . . . . @ . . . @ . 
. @ @ . . . . @ . . . . . . . @ . @ . . . . . . . . . . . @ . . 
@ @ . . . . . @ @ . . . . . . . @ . . . . . . . . . . . . . @ . 
. . . @ . . . @ . @ . . . . . . . @ @ . . @ . . . . . . . . . . 
. . . . . @ . . . . . . . . @ . . . @ . . . . . . . @ . @ @ @ @ 
@ . . . . . . . . . . . @ . . . . . . . . . . . . . @ . . . . . 
. . . @ . . . . . . @ @ . @ . . . . . @ . . @ @ . . @ . . @ . . 
. . . @ . . . . . . @ . @ . . @ . . . @ @ . . . @ . . . . @ . . 
. . . . @ . . . . @ . @ . . . . . . @ . . . . . @ . @ @ . @ . . 
. @ @ . . . . . . . . . . @ . . . . . . . . . . . @ . . . . . . 
@ . . . . . . . @ @ . . . @ @ . . . . . . . @ . . . . . @ . . . 
. . @ @ . . . @ . . @ . . . . . . @ . . @ . . . @ . . @ . . . . 
. @ @ . . . . . . . . @ @ . @ . @ . . . . . . @ . . . . . . . . 
. . @ . . @ . . . . . @ @ @ . . . . . . . @ . . @ . @ @ . . . @ 
. @ . . @ . @ . . @ . . @ . @ . . . . @ . . . . . @ @ . @ @ . . 
. . . . . @ . . . @ . . . . @ . . . . . . @ . . . @ . . . . @ . 
. . . . @ . . . . . @ . . . . . . . . . . . . . . @ . . . . . . 
@ . . @ . @ . . . . . . . . . . @ . . . . @ @ . . @ . . . @ @ . 
. . . @ . @ . . . . @ . @ . @ . . . . @ . . . . . . . @ . . @ . 
. . . . . . . . . . . . . . . . . . . . . . . . @ . . . @ . @ . 
. . . . @ . . . . . @ . . . . . @ . . . . . @ . @ . @ . @ @ . @ 
. . . . . . . . . . . . . . . @ . . . @ . @ . @ . . . . . . . . 
. . . . . @ . . @ . . . . . . . . . . . . . @ . . . . . . @ . . 
50
30 20 16 13
14 16 14 18
24 10 7 15
24 13 12 1
24 11 2 15
7 7 0 8
28 14 24 6
30 1 31 9
19 11 0 0
3 28 29 25
0 4 22 21
8 8 15 14
31 17 25 14
3 17 6 13
14 3 25 22
26 4 6 11
26 1 6 2
6 28 15 7
17 25 29 27
23 9 11 8
27 15 25 6
11 12 16 14
3 14 2 31
16 13 25 4
16 14 26 16
20 25 26 12
13 5 4 0
9 21 9 2
6 16 9 0
18 29 21 23
2 23 27 25
8 13 8 18
8 10 20 9
19 22 26 30
21 17 22 14
24 2 13 21
29 12 16 31
10 11 27 13
4 11 23 0
6 8 5 12
28 27 14 16
15 17 0 9
12 10 12 3
21 16 31 15
7 29 31 28
23 6 3 23
19 7 2 24
19 28 24 13
21 7 25 9
17 2 24 4
