32 32
@ . . . . @ @ . . . . . . . . . . @ . . . . . . . . . . @ . @ . 
. . . @ @ . . . . . . . . . . @ . @ @ . @ @ . . . . . . . . . . 
@ . . @ @ . @ @ . . . . . @ . . @ . . @ . @ . . . . . . . . . . 
. . . . . . . . . @ . . . @ . @ . . . . . . . . . . . . @ . . . 
. . @ . . . . @ . . . . . . . . . . . . . . @ . . . . . . . @ . 
. . . . . . . . @ . . . . . . . . . . . @ @ . @ @ . . . . . . . 
. . . . . . . . . . . . . . . . . @ @ . . @ . . @ @ . . . . . . 
. . . . . . . . @ . @ . @ . . . . . @ . . . @ . . . . . . . . . 
@ @ . . . . . @ . . . . . . . @ . @ . . . . . . . @ . . . . . . 
. . . . @ . . . . @ . . . . . @ @ . . . . @ . . . . @ . @ . . . 
. . @ . . . @ . . . @ . . . . . . @ . . . . . . . . . @ @ . . . 
. . . . . . . . @ . . . . . . @ . . . . . @ . . @ . . . . . . . 
. . . . @ @ . . . . . . . . @ . . . . . . . . . . . @ . . . . @ 
. @ . . @ . . . . @ . . . . . . . . . . . . @ . . @ . @ @ . . . 
@ . . . @ @ . . . . @ . . . . . @ . . . . @ . . . . @ . . . . . 
. . . @ . . . . . . . . . . . . . . @ . . . . . @ . . . . . . . 
. . . . . @ . . . . . . . . . . . . @ . . . . . @ . . . . . . . 
. . . . @ . . @ @ . . . . . @ @ . . @ . . @ . . . . . . . . . . 
. @ . . . . . . @ . @ . . . . . @ . . . . @ . @ . . . . . . @ . 
. . . . . . . . . . @ . . . . . @ . . . @ . @ . . @ . . . . @ @ 
@ . . . . . @ @ . . . . . . . @ @ . . . . @ . @ @ . . . . . @ . 
. @ @ . @ . . . . . . . . . @ . . . @ @ . . @ . . @ . @ . . @ @ 
. . . . . . @ @ . . @ . . . @ . . @ . @ @ . @ . . . @ . . . . . 
. . @ . . . . . . . . . . . . @ . . . . . . . @ @ @ . . . . . @ 
. . @ @ . . . . . . . @ . . . . . . . @ . . . . . . @ . . . . . 
. . . @ . . @ . . . . . . . @ . @ . . . . . . . . . . . . . . . 
@ . . . @ @ @ @ . . @ . @ . @ . @ @ . . . . . . . . @ . . . @ . 
. . @ . . . . . . . @ . . . . . . . . . @ @ . . . @ . . . . . . 
. . . @ @ . . @ @ . . . @ . . @ . . . . @ . . . . . . . . . . @ 
. . . @ . @ . . . . @ . . . . . . . . @ @ @ . . . . . . . . . . 
. @ . . @ . . @ . . . . . . @ @ . . @ . . . . . . . . . . . @ . 
. . . @ @ @ . . . @ . . . . . . . . @ . @ . . . . @ @ . . . . . 
10
2 6 16 13
1 27 5 17
15 5 25 4
20 6 14 14
20 7 23 2
10 4 7 18
21 16 14 27
25 28 12 24
22 27 21 28
24 19 7 14
