32 32
. @ . . . . . . . . . . . @ . @ . . . . . . . . . @ . . . . . @ 
. . . . . . . . @ . . . . . . . . . . . . . @ . . @ . . . . . . 
. . @ @ . . . . . . . . . . . . . @ . . . . . . . . . . . . . . 
. . . . . . @ . . . . . @ . . . @ . . @ . . . . . . . . . . . . 
. . . . . . . . @ . . . . . @ . . @ @ @ . @ . . . @ . . . @ @ . 
@ . @ . . . . @ @ @ . . . @ . @ . . . . . . . . . . . . . @ . . 
. . @ . . . . . . . . . . @ . . . . . . . . @ . . . . . @ . . . 
@ @ . @ . @ . . . . @ @ . . . . . @ . . . . . . . @ . . @ . . . 
. . . . . . . @ @ . . . . . @ . . . . . . . . . @ . . . . . @ . 
. . . . @ . @ . . . . . @ . . . . . . . . . . . . @ . . . . . . 
. @ . . . . . . @ @ . . . . . @ . . . @ @ . . . @ . . . . . @ . 
. . . @ . @ . . . . . . . . @ . . . @ . @ @ . . . @ . . . . . . 
@ @ . . . @ . . . . @ . . . @ . . @ . . . . . @ @ @ . @ @ . . . 
. @ . . . @ . . . . @ . . @ . . @ . . . . . . . . . . . . . . @ 
. . . . . . . @ . . . . . . . . . . . @ . . . . . . . @ . . @ @ 
. @ . . . @ . . . . . . . . . . . . . @ . . . . . . @ . . . . . 
. @ . @ . . . . @ @ . . @ . . @ . @ . . . . . . . @ . . . . . . 
. @ . . . . . . . . . . @ . . . . . . . . . @ @ . . . @ . @ . @ 
. @ . . . . . . . . . . @ . @ . . . @ . @ . . . . . . . . @ . . 
. . @ . . @ . . . . . @ . @ . . . . . @ @ . @ @ . @ . @ . @ . . 
. . . @ . @ . . . . . . @ . . @ . . . . . . . . . . . . . . . . 
. . . . . . . . @ . . . . @ . . @ . . . . @ . . . . @ @ . . @ @ 
. . . . . . @ . . . . . . @ @ @ . . @ @ . . . . . . . @ . . . . 
. . . . . . . . . . @ . . @ . . . . . @ @ @ . . . . . . . . . . 
@ . . . . . @ . . @ . . . . . . @ . . . . . . . @ . . . . . @ . 
@ . . . . . @ . . . @ . . . @ @ . . . . . . . @ @ . . . . . . . 
. . . . . @ @ . . . . @ . . . . . . . . . @ . . . . . . @ . @ @ 
@ @ @ . . . . . . . . . . . . @ . @ . . . @ . . . . . . @ @ . @ 
@ . . . . . . . @ . . . . . . . @ . . @ . . . @ @ . . . . @ . . 
. . . . @ . @ @ . . . . . @ . . @ . . . . . . . . . . . @ . . . 
. . . . . . . . @ . @ . . . . . . . @ . . @ @ . . @ . @ . . . . 
. . . . . . . . @ . . . . . . . . @ . . . . . . . . . @ . @ . . 
20
15 29 23 6
21 2 19 25
10 18 0 0
13 4 31 5
2 21 17 6
26 4 13 11
27 23 22 11
12 6 10 5
31 11 22 22
3 19 22 29
24 14 24 19
6 4 5 3
9 11 11 9
28 2 12 11
1 31 9 14
23 29 3 6
16 19 23 24
5 8 21 16
28 5 3 1
26 17 25 24
