32 32
. . . . . . . . . . . . . @ . . . . @ . . . . @ . @ . . . @ @ . 
@ . . @ . . . . @ . . . . . @ . . . . . . . . . @ . . . . . . . 
. . . . . . @ @ . . . . . @ . . . . . . . @ . . . . . . . @ . . 
. . . . . . @ . . @ . . . . . . . . . @ . . . . @ @ . . . . . . 
. @ @ . @ . . . . . . . . . . . . . . . . . . . . @ . . . @ . . 
@ . . . . . . @ . @ @ . . @ . . @ . . . @ @ . . . . . . @ . . . 
. . . . . @ . @ . @ . . . @ @ . . . . . . @ @ . @ . . . . . @ . 
. @ . . @ . @ @ . . . . . . @ @ . @ . . @ . . . @ . @ . . . . . 
. . . . . . @ . . . . . . . . . . . . . . . . . . . . @ . . . . 
. . . . . . . . . . @ . . . . . @ . . . . . . . @ @ . @ . . @ . 
@ . . @ . . . . . @ . @ . . . . . . @ . . . @ . . @ . . . . . . 
. . . . @ @ @ . @ @ . . . . . . @ . . . @ . . . @ . @ . @ . . . 
. @ . . . @ . @ . . . . . @ . . . . @ . . . . . @ . @ . . . @ . 
@ @ . . @ . . . @ . . . . . . . . . . . . @ . . @ . @ @ . . . . 
. . . . . . . . . . . . . @ . . @ . @ . . . . . . . . . . . . . 
@ . . . @ . . . . . . . @ . . . @ . . . @ . . . . . . . . @ . @ 
. . . @ . . . @ . . . . @ . . . @ . . @ @ . . @ @ . . . . . . . 
. . . . . . . . . @ . . . . . . @ . . . . . . . . . @ . . @ . . 
. . . . . . . @ . @ . @ . . @ . . . . . . . . @ . @ @ . . . . . 
. . @ . . . . @ . . . . . @ . . . . . . . . . . @ . . . @ . . @ 
. @ . . . . . . @ . . . . . @ @ . . . . @ . . . . . . . . . . @ 
. @ . . @ . . . . . . . . . . . . @ . . . . @ . . . . . . . . . 
. @ @ . . @ . . . . @ . @ . . . @ . . . . @ . . . @ . . . . . @ 
. @ . . . . @ @ . . . . . . . . . . @ . @ . . . . @ . . @ . . . 
. . . @ . . @ . . . @ @ . . . @ . . . . . . . . . @ @ . . . @ . 
. . . . . . . . . . . . @ . @ @ . . . . . . . @ . . . . . . . . 
. . @ @ . @ . . . . . . . . @ . . . . . . . . . @ . . . . . . . 
. . . . . . . @ . . . . @ . . . . . . . . . @ . . @ . . @ . . . 
@ . . . . . @ . . . @ . . . . . . . . . . . . . . . @ . . . . @ 
. . @ . . . . @ . . . . . . . . @ . @ . . @ . . . . . . . . . . 
@ . . @ . @ . . . . . . . . @ @ . . . @ . @ . . @ @ @ . @ . . . 
. @ . . . . @ . . . . @ . . . . . . . . . . @ . . . @ . . . . . 
10
9 28 11 14
14 3 21 16
17 27 21 20
29 24 12 21
19 31 26 0
30 13 16 3
27 4 15 2
9 30 24 25
24 31 12 19
3 2 22 3
