32 32
. . . . . . . @ . . . @ . . . . . @ . . . . . . @ . . . . . . . 
. @ . . . @ @ . . . . . . @ . . @ @ . . @ . . . @ . @ . . @ . . 
@ . . . . . . @ @ . @ @ . . . @ . . . . . . @ . @ . . . @ . . . 
@ . . . . . . . . . . . . . . . . . . . . . . . . . @ . . . @ . 
. . . . . . . . @ . . . @ @ . . . . . . . . . . . . . . @ @ . . 
. . . . . . . . . . . . . @ . . . @ . . . . . . . . . . . . . @ 
. . @ . @ . . . . . @ . . @ . . @ . . . . . . . . . @ . @ . . . 
. @ @ . . . . . . . . . . . . . . . @ . . @ @ . . . @ . . . @ . 
. . . . . . . . @ . . . @ . . . . . . @ @ . @ . @ . . . . . . . 
. . . . @ . . . . . . @ @ . . . . @ @ . . @ . . . . . . @ . . . 
. . @ . . . . . . . @ . . . . . . . . . @ . . . @ @ . . . . . . 
. . . @ . . . . . . . @ . @ . . . . @ . . . . . . . . . . . . @ 
. . . @ . . @ . . . . . . . . . @ . @ . . . . . . . @ . . . . . 
. @ . . @ . . @ . . . . . . . . @ . . @ . . . . . . @ . . . . . 
. @ . . . . @ . . . . . @ . @ @ . . @ . @ . . . @ . . . . . @ . 
. . . . . . . . . . . @ . @ . . . . @ . . . . @ . . @ @ @ . . . 
. . . . . . . . . @ @ . . . . . @ . . . . @ . @ . . . . . . . . 
. . . . . . . @ . . . . . . . . . . @ @ . . . @ @ @ . . . . . . 
. . . . . . @ . . . . . . . . . . @ . . . . . . . . . . . . . @ 
. . . . . @ . @ @ . . . @ . . . . . . . @ . . . . . . . . . . . 
@ @ . . . . . . . . @ . @ @ @ . . . @ . . . . . . . . . . . . . 
@ . . . . . . . @ @ @ . . . . . @ . . @ . @ . . . . . . . . . @ 
. . . . @ . . @ . . . . . . . . . . @ . . . . . . @ . . . . @ @ 
. @ . . @ . . . @ @ . @ . @ . @ @ . . . . @ . @ . . . @ @ @ @ @ 
@ . @ . . . . . . . . . . . . . . . . . @ . . . . . @ @ . . @ @ 
. . . @ . . . . . . . . @ @ . . @ . . . . . . @ . . . @ . . . . 
@ . . . . . . . . . . . . . . @ . . @ . . . @ . . . @ @ . . . . 
. . . . . . @ . . . . . @ . . . . . . . . . @ @ . . . @ . @ @ . 
. . @ . . . . . . . . . @ . . . . . . . . . @ . . @ @ . . . . @ 
. . . . . . . . . . @ . @ . . . . . @ . . . @ @ @ . . . . . . . 
. . . . . . @ . @ . @ . . . . . @ @ @ . . . . @ . . . @ @ . . . 
. . . . @ . . . . . . . . . . . . . . . . . . . @ @ . . . . . @ 
10
6 5 12 22
1 10 11 6
8 13 3 27
14 2 3 0
6 16 5 7
22 22 14 10
17 21 12 21
14 26 14 24
23 11 15 25
5 3 25 15
