32 32
. . . . . . . . . @ . . . . @ . . . . . @ . . . . . . . . . . . 
. . . . . . . . . . . @ @ . . . . @ . . . . . . @ @ . . . @ . @ 
. . . . . @ @ . . . . . . . . . . . . . @ @ . . . . . . . . . . 
. @ @ . . . . . . . . . @ . . . . . . . . . . . . . . . . . . . 
. . . . . . . . . . . . . @ . . . . . . . @ . . @ . . . . . . . 
@ . . . . @ . . . . . . . . . . . . . . . . . . . . . @ . . . @ 
. . . . . @ . . . . . . . . . . . . . . . . . @ . . . . . @ . . 
. . . @ . . . @ . @ . @ @ . . . @ . . . . . . . @ . . . . @ @ . 
. . . . . . . . . . . . . . @ . @ . . . . @ @ . @ . . . . . . . 
. @ . . . . . . . . . . @ . @ @ @ . . . @ . . @ @ . . @ . . @ . 
. . . . @ @ @ @ . . @ . . . . . . . . . @ . . . . . . @ . . @ @ 
. . . . . . . . . @ . . @ . . . . . . . . . . . . @ @ . . @ . . 
. . . @ . . . @ . . . . . . . @ . . @ . . . . . . . . . @ @ . . 
. . . . . @ . . . @ @ . @ @ . @ . @ . . . . . . . . . . . . . . 
. . . . . . . @ . . . . . . . . . . . . . . @ . . . . . @ . . @ 
. . @ . . @ . . @ . . . . . . @ . . . @ @ . . . . . . @ . . . . 
. . . @ . . . . @ @ . . . . . . . . @ @ . @ . . . . . . @ . . . 
. . . . @ . . . . @ . . . @ . . . @ . . @ . @ . . . . . . . . @ 
@ @ . @ . @ . . @ . . . . . . . . @ . . . @ @ . . . . . . . @ . 
. @ . . . . @ @ . . @ . @ . . . . . . . @ . . . . . . @ . . . . 
. . . . . . . . @ . . @ . @ . . . . . . . . . . . . @ . . . . @ 
@ . @ . @ . . . . @ . @ @ @ . . . . . . @ . . . . @ . . . . @ @ 
. . . . . @ @ . . @ . @ . . @ @ . . . . . . . . . . . . . . . . 
. . @ . @ . @ . . . . . . . @ . . . . . @ . @ . . . @ . @ . . . 
. . . . @ . @ . @ . @ . @ . . . @ @ . . . . @ @ . . . . . . . . 
. . . . . . @ @ . . . . . . . . @ . . @ . @ . . . . . . . . . @ 
. @ @ . . . . @ . @ . . . . . . . . @ . . . . . . . . . @ @ . . 
. . . . @ . . . . . . . . @ . . . . . @ @ @ . @ . @ . . . @ . . 
. . @ . @ . . . . . @ @ . @ . . . @ . . . . . . @ . . @ . . . @ 
@ . @ . . . . @ . . . . . . . . . . @ . . . . . @ @ @ . . @ . . 
. . . . @ . . . . . . @ . . . . . . . . . . @ . @ . . . . . . . 
. . @ . . . . . @ . . @ . @ . . . . . . . . . . . . . . . . . . 
20
14 3 29 31
22 27 21 31
17 29 26 1
27 29 0 10
3 14 3 27
24 31 30 3
26 14 3 25
29 25 16 2
23 30 10 11
23 8 19 14
9 28 11 13
0 26 0 11
16 10 9 31
2 2 29 13
31 23 1 1
20 12 17 29
7 9 3 5
4 4 20 31
18 21 17 19
3 30 6 15
