32 32
@ @ . . . . @ . . . . @ . . . . . . . . . . . . . . @ . . . @ @ 
. . . . @ . . . . @ . . . . . . @ @ . @ @ . . @ . . . . . . @ @ 
. . @ . . . . . . . . . . . . @ . . . @ @ . . . . . . . . . @ . 
. . @ . . . . @ . . . @ . . . . . . @ . . . . . . . . . . . . . 
@ . . . @ . . . @ . @ . . @ . @ . @ . . . . . . . . . . . . . . 
. @ . @ . . @ . . . @ . @ . . . . @ . . . . . . @ . @ . . . . . 
. . . . . . . . . @ . @ . . . . @ . . @ . . . . . . . . . . . @ 
. @ . . . @ . . . @ @ . . . @ @ . . . . . . . . . . . . @ . . @ 
. . @ . . . . . . . . . @ . . . . . . . @ . . . @ @ . . . @ . . 
. . . . . @ . . . . . . . @ . . . . . . @ . . . @ . . @ @ . . @ 
. . . @ . . . . . . . . . . . . @ . . @ . . @ . . . . . . @ . . 
. . . . . . . . . @ . . . . . . . . @ @ . . . . . . . . . . @ . 
@ . . . . @ @ . . . . . @ . @ . @ . . . . . . @ . . . . . @ . . 
. . . . . . @ . . @ . . . @ . . . @ . . . @ . . . . . . . . @ @ 
. . . . @ . . . @ . . . @ . . . @ . . . . . . . . . @ . . @ @ . 
. . . . @ . . @ . @ . . . . . . . @ @ . @ . . . @ . . . . . . . 
. . . . @ . @ . . @ @ . . . . . . . . . . . . . . . . . . . . . 
. . . . . @ @ . . . . . . @ . . . . . . @ . . . . . . . @ . . . 
. . @ @ . . . . . . . . @ . @ . . . . . . . . . @ @ . @ . . @ . 
. . . . @ . . . . . . . . @ . . . . . @ . . @ @ . . . @ . @ . @ 
@ . . . @ . . . . . . . . . @ . . . @ . . . . . . . . . . @ @ . 
. @ @ @ . . . . @ . . . . . @ . . @ @ @ . @ @ . @ . . . . . . @ 
. . @ . . . . . . @ . . . . . . . . @ @ . . . . @ . . . . @ . . 
. . . . . . @ . @ . . . . @ . . . . @ @ . . . . . . . @ . . . . 
@ . . . . . . . @ . @ @ @ . . . . . @ . . . . . . . . . @ . . @ 
. . . . @ . . @ . . @ . . . . . . . . . . . . . . . . @ . . . . 
. . . . . . . . . @ . . . . . . . . . @ . . . . . @ @ . . . @ @ 
. . . . @ . . . . . . . . @ @ @ . . @ . . . . . . @ . . . . . . 
. . . . . . . . @ . . . . . . . @ @ . . @ . . . . . . @ . @ . . 
@ . . . . . . . . . . . @ . . . . . . . . . . . @ . . . @ . . . 
. @ . . . . . . . . . . @ . . . . . @ @ . . @ . . . . . @ . . . 
. . . . @ . . @ . . . . . . . . . . . @ . . . . @ @ . . . . . . 
40
0 23 1 6
8 26 8 2
8 22 8 8
31 16 4 5
5 4 21 30
17 10 21 5
21 28 11 20
16 15 12 27
10 13 19 4
18 16 11 8
5 21 11 27
11 18 11 21
12 16 13 10
5 24 3 19
13 10 31 17
8 13 10 12
2 14 13 12
7 16 14 26
8 12 26 2
3 4 14 3
25 7 18 29
19 20 8 20
21 11 13 2
10 12 19 27
30 27 17 31
1 29 0 3
22 18 20 25
9 3 13 22
13 24 23 22
6 30 17 22
6 21 5 14
17 31 12 23
0 3 3 15
27 13 2 6
21 24 4 12
0 21 2 7
16 30 29 1
5 26 31 28
5 1 13 24
18 5 4 18
