32 32
. . . . . . . . . . . . . @ . . . . . . @ . . . . . . . . @ . . 
. . . @ . . . . @ . . @ @ . @ . . . . @ . @ . @ . . . . . @ . . 
. . . . . . @ . . . @ . . . . . . . . . . @ . . . . . . . . . . 
. @ . @ . . . @ . @ . . . @ . . . . . . . . . @ . . @ . @ . . . 
. . . . @ . . @ . . . @ . . @ . . @ . . . . . @ . . . . . . . . 
. . . . @ . @ . . . . . @ @ @ . . . . . . . @ @ . . . . @ . @ . 
. @ . @ . . . . @ . . . . . @ . @ @ @ . . . . . @ . . @ @ . . . 
. . . . . . @ . . . . . @ . . . @ . @ @ . @ . @ . . @ . . @ . . 
. . . @ . @ . . . . . . . . . . . . . @ . . . . @ @ . . . . . . 
. . . . . . . @ @ . . . . . @ @ . @ . . . . . . . . . . . . . @ 
. @ . . . @ . . . . . . . . . . @ . . . . . . @ . @ . . @ . @ . 
. . . . . . . @ . . . @ @ @ @ . @ . @ . . . . . . @ . . . @ @ . 
@ . . . . . . @ . . . . . . . . . . . @ . . @ @ . . . @ . @ . @ 
. . . . . . @ . . . . . . . @ . . . . . . @ @ @ . . . . . . . @ 
. . . . . @ . @ . . . . . @ @ . . . . . . . . . . . . . @ . . . 
@ @ . . . . . . . . . . . . . . . . . . . . . @ . . . @ . . @ . 
. . . . . . . . . . . . . . . . . . . . . . @ . @ . @ . . @ . . 
. . . @ @ . . @ . . . . . . . @ . . . @ . . . . @ . . @ . . @ @ 
. @ . . . @ . . . . . . . . . . . . . . @ . . . . . . . . . . . 
. . . . . . . . . . . . @ . . . . @ . . . . . . . . . @ . . . . 
@ @ . . . @ @ . . . . . . . . . . . @ . . . . . . @ @ . . . @ @ 
. . . . . @ . . . @ . . . . . . . . @ . . . @ @ . @ . . @ . @ . 
. . . . . . . @ @ . . . . . @ @ . @ @ . . . . . . . . . . . . @ 
@ . . . . . . . . @ . @ . . . . . @ . . . . @ . . @ . . @ . . . 
. . . . . . . . . . . . @ . . . . . . @ @ . . . . . . . @ . . @ 
. . . . . . . . . @ . . @ . . . . @ . @ . . . . . . . . . @ . . 
. . @ . . . . . . . . . . @ . . . . @ . . . . . . . . @ . . . . 
. @ . . . @ . . . . . . . . . @ . @ @ . . . . . . . . . . @ . . 
@ . . @ @ . @ . . . @ . . @ . . @ . . . . . . . . . . . . . . . 
. . . . . . . @ . . . . . . . . @ @ . . . . . . . . . . . . . @ 
@ . @ @ . . . . . . . . @ . . @ . @ . . @ . . . . . . . @ @ @ @ 
. . . @ . . @ . . . . . . . . . . . . . . . . . . . . . @ . . . 
50
25 5 31 6
16 26 24 20
6 23 19 29
23 22 16 9
3 10 12 17
18 23 26 31
2 21 21 0
27 1 26 2
22 15 9 27
5 0 16 4
10 15 1 14
9 15 0 29
7 16 9 26
5 16 2 17
22 0 22 3
16 27 5 24
13 21 8 8
25 16 2 21
9 16 29 24
27 8 27 20
20 21 18 3
15 6 19 0
2 7 25 15
2 23 4 9
18 13 0 21
31 18 10 13
26 0 6 18
28 8 31 5
22 26 8 7
20 29 18 30
4 15 5 2
13 20 14 0
8 18 29 2
21 6 24 15
0 26 26 26
28 20 8 28
27 0 5 25
27 30 30 6
20 28 8 3
0 10 6 1
8 3 28 28
1 24 13 21
27 2 16 22
28 16 30 2
19 20 1 5
8 27 1 13
11 24 13 27
26 14 22 31
25 4 16 27
21 18 12 8
