32 32
@ . . . . @ . @ . . . . . . . . . . . . @ . . . . . . . . . . @ 
. . . @ . . . . . . . @ . @ . . @ . @ . @ @ . . . . @ . . . . @ 
. . . . @ . . . . . @ . . @ . . @ . . . @ . . . . . . . @ . . . 
. . . . . . . . . . . . . @ . . . . . . . . . . . . . . . @ . . 
. . . . . . . . . @ . . @ . . . . . . . . @ @ . . . @ . . . . . 
. . . . . . . . . . . . . . @ . . . . . . . @ @ @ . . . . . . . 
. . . . . . @ . . . @ . . . . . . . . . . . . . . @ . . . . . . 
. . @ @ @ . . . . . . . @ . @ . @ . . . . @ @ . @ . . . . . . @ 
. @ . . . @ . . @ . . . . . @ . . . . @ . . . @ . . @ . . . . @ 
. . . . . . . @ @ . . . @ . . . . . . . @ . . . . . . . . . @ @ 
@ . . . @ @ . . . @ . @ @ . @ . . . . . . . . . . . @ . . . @ @ 
@ . . @ . . @ . . @ . . @ . @ . . . . . . . . @ @ . . . . @ . . 
@ . . . . . . . . . . . @ . . . . . . . @ . . . . . . . . @ . . 
. . @ @ . . . . . @ . . @ . . . . . . . . . . . @ @ . @ . . . . 
. @ . . . . . . . . . . . . . @ . @ . . @ . . . . . . . . . . . 
. . . . @ @ . @ . . . @ . . . . @ . . . . . . @ . . . . . . @ . 
@ . . . . . . . . . @ . . @ . . . . . . @ . . . . @ @ . @ . . . 
@ . . . . . . . . . . @ @ . . . . @ @ . . . @ @ . . @ @ . . @ . 
. . . . @ @ . . . . . @ . . @ @ . @ . . @ @ . @ . . . . . . . @ 
. . . . . . @ . . . . . . . @ . . . . @ . @ . . . . . . . . . @ 
@ . . . . . . @ . . . . . @ . . . . . . . . . . . . . . . . . . 
. . @ . . . . . @ . . . . . . . . @ . . . @ . . . . . . @ . . @ 
. . . . . . . . . . @ . . . @ . . . . . . @ . . . . . . . . . . 
@ . . . . . . . . . . . . . . . . @ . @ . . @ . . . . . . . . . 
@ . . . . . . @ . @ . . . . . @ . @ . . . . . . . . @ . . . . . 
@ @ . . @ . . . . . @ . . . . . . . @ . . . . . . @ . . . . @ . 
. @ . . . . . . . . @ . . . @ . @ @ . . . . . . @ . . . . . . . 
. . @ . @ . @ . . @ . @ . . @ @ . . . . . . . . . . . . . @ . . 
@ @ . @ . @ @ . . . @ . @ . @ . . . . . . . . . . @ . . . . . . 
@ . . . . . . . @ . . . . . . . . @ . . @ . . . . @ . . . . @ . 
. @ . . . . . . . @ . @ @ . . . . . . @ @ . . . @ . @ . @ . . . 
@ . . . . @ @ . @ @ . . . . . . . . . . . . . @ . . . . . . . . 
10
2 22 3 6
6 12 1 23
25 5 19 13
15 23 15 22
19 27 1 6
27 8 29 19
9 22 6 12
13 0 18 14
15 19 19 27
7 11 21 0
