32 32
. . . . . . . . @ @ @ . @ . . . . . . @ . . . . . @ . . . . . . 
. @ @ . . @ . . . . . . @ . . . . . . . . . . @ . . . . . @ @ . 
@ . . @ @ . . . . @ . @ . . @ . . . @ . . @ @ . @ . . . . . @ . 
. . @ . . . . . . @ . @ . . @ @ . @ . . @ . . . @ @ . . . . . . 
. . . . . . @ . . @ . @ . . @ . . . . . . . . . . . . . . @ . . 
. . . . . . . . . . . . @ . . . . . . . . @ . . . . @ . . . . . 
@ . @ . . . . . . . . . . . . . . . . @ . . . . @ @ . . . . @ @ 
. @ @ . . . @ . . . . @ @ . . . . . . . @ . . @ . . . . . . . . 
. @ . . . . . . . . . @ . . . . . . @ . . . . . . . . . . . @ @ 
@ @ . . . . . . @ . . . @ . . . . . . . . . . @ . . . . . . . . 
@ @ . . . . . . . . . . . . . . . . . @ @ . @ . . . . . . . . . 
. . . @ . . . . @ . . @ . . @ . @ . . . . . . . @ . . . . . . @ 
. . . . @ . . @ . . . . @ . . . . . @ . . . @ . . . . . . . @ . 
. @ . . . . . @ . @ . . @ . @ . . . @ @ . . . . . . . . @ . . . 
. . . . . @ @ . @ . . . . @ . . @ . . @ . @ @ . . . . . @ @ . . 
. @ . . . . . . . . . . . . . . @ . . . . . . @ @ . . . . . . . 
. . . . . . . . . . @ . . . @ . @ @ . . . . . . . . . . . . . . 
. @ . . . . . @ . . . . @ . . . . . . . . . @ @ . . . . . . . . 
@ . . . @ @ . . . @ . . . . @ @ . . @ . . . . . . @ . @ . . @ @ 
@ . . . . . . @ . . . . . . . . . @ @ . @ . . . @ . . . . . @ @ 
. . . . . . . . . . . . . . . . . . . . . . . @ . . . . . . . . 
@ @ . . @ . . . @ . @ . . . . @ . @ @ . . . . . . . . . . . @ . 
. . . . . . . . . @ . . . . @ . . . . @ @ . @ . . . . . . . @ . 
. . . . . . . . . @ . . @ . . . . . . . . . . . . . . @ . . . . 
@ . . @ . @ . . . @ . . . . . . . . . @ . . . . . . . . . . . @ 
. . . . . . . . . @ @ . . @ @ . . . . @ . . . . . . . . . . . . 
@ @ . . . . . @ . . . . @ . . . . . . @ . . . @ . . . @ . . . . 
. @ @ . @ . . . . . . . . . . . . . . . . @ . . . . . . . . . . 
. @ @ . . . @ . . . @ . . . . . . . . . . . . . . . . . . @ @ @ 
. . . @ . . . . @ . @ . . . . . @ . . . . @ . @ . @ . @ . . . . 
. . . . @ @ . . . . . . . . . . @ . . . . . . @ @ . . . . . @ . 
@ . . @ . . @ . . . . . . @ . @ . . @ . . . @ . @ . . @ . . . . 
20
26 8 20 14
16 17 17 29
8 27 26 11
25 24 23 6
26 31 18 7
29 15 3 12
12 31 8 13
22 28 4 14
29 21 16 18
28 30 17 30
9 19 20 26
17 25 15 8
27 22 19 5
28 29 26 31
1 25 26 10
2 24 21 25
16 2 30 29
16 0 24 16
31 16 7 24
4 11 7 22
