32 32
. . . . . . . . . . . @ @ @ . . . @ . . . . . . . @ . . . @ @ . 
. . . . . @ . . . . . . . . @ . . . . . . . @ . @ . @ . . . . . 
. . . @ . . . @ . . . . . @ . @ . . . . . @ @ . . . @ . @ . . . 
. . . . . . . . @ . . . @ . . . . . . . @ . @ . . . . . . . @ . 
@ @ . @ @ . @ . . @ @ . . . @ . . . . . @ . . @ . . @ @ . . . . 
@ . . . . @ @ . . . . . @ @ . . . . @ . . . . . . . @ . @ @ . . 
. . @ . . @ . @ . . @ . . . @ . . . @ @ . . . . . . @ . . . . . 
. . . . . @ . . @ . . . . . . . @ @ . . . . . . . . . . @ @ . . 
. . . . @ . . . . . . . . . . . . . . . . . . . @ . . . . . . . 
. . . @ . . . . . . . . . . @ . . . . . . . . @ . @ @ @ . . . . 
. . @ @ . . . . . . . . . . @ . . @ . . . . . . . . . . . @ . . 
. . @ . . . . @ . . . . . . . . @ . . . . . @ @ . @ . . . . . . 
. . . . @ . . @ . . . . . . . . . . . . . . . @ . . . . @ . . . 
@ . . . . . . @ . @ . @ . . . . . @ . . . . . . @ . @ . . . . . 
. . . . . . . @ . . . . @ . . @ @ . @ . . @ . . . @ . . . . . . 
. . . @ . . . . . . @ @ . . . . . . . . . . @ . . . . . . . . . 
@ . . . . @ @ . . . . . . @ . . . . . . @ . @ . . @ . . . . . . 
. . . @ . @ @ . . . . . . @ @ . . . . . . . . . . @ . . @ . . . 
. . . @ @ . . @ . . @ @ . . @ . . . . . @ . . @ . @ . . . @ . @ 
@ . . . @ . @ . @ @ . @ . . . . . . . . . . . . . @ . @ . @ @ . 
. . . . . @ . . . . . . @ . @ . . . . . . . . . . @ . . @ . @ . 
@ . . . . . . @ . @ . @ . . @ . @ . . . . . . . . . . . . . . . 
. @ @ @ . @ . . . . . . . . . . . . . . . . . . . . . @ . . . . 
@ . . . @ . . . . . . . . . . . . @ . . . . . . . . . @ . . . @ 
. . . . @ . . . . . @ . . . @ @ . . . . . . . . . . . . . . . . 
@ . . . . . . @ . . @ . . . . . . . . . . . @ . @ . . . . . @ . 
. . . . . . . . @ @ . . . . @ @ . @ . . . . . . . . . . . . . . 
. . . . . . . . . . @ @ . @ . @ . . . . . . . . @ . . @ . . . . 
. . . . . . . @ . . . . . . . . . @ . . @ . . . . . . . . . . @ 
@ . . . . @ . . . . @ @ . . @ @ . . @ . @ . . . . . . . . . . . 
. @ @ . . . . . . . . . . . . @ . @ . . . @ . . . . @ . . . @ . 
. . . . . . . . . @ @ . . . . . @ . . . . . . . . . . . . @ @ @ 
70
10 22 7 16
15 8 27 3
5 27 3 5
4 16 31 16
26 27 19 1
11 1 11 7
21 22 14 12
6 12 12 30
21 11 16 8
23 24 4 15
10 1 9 11
28 27 10 26
12 4 5 27
22 23 0 7
31 30 24 10
23 25 30 26
8 21 3 29
16 27 19 4
1 11 26 17
10 10 29 20
22 6 11 1
1 5 30 18
6 9 10 5
9 9 4 29
0 27 8 14
29 15 30 27
20 1 20 11
25 10 13 24
15 18 0 27
31 7 9 2
30 23 18 10
2 9 4 17
0 8 7 9
21 1 6 27
17 31 28 23
27 28 6 15
27 15 11 22
15 1 13 28
25 23 30 11
31 5 10 2
6 7 29 21
29 12 25 13
9 27 23 21
14 0 30 1
29 28 16 5
25 6 16 25
23 27 19 9
3 3 29 24
6 8 4 31
8 12 12 19
1 0 30 24
7 23 16 9
27 5 16 2
6 15 3 16
19 3 18 18
4 22 29 11
10 14 5 8
29 24 10 30
28 16 9 17
30 13 22 0
20 27 17 2
0 31 26 0
14 15 1 11
3 1 10 8
2 8 18 27
14 12 21 27
9 12 14 2
21 13 7 30
23 8 27 17
2 21 20 12
