32 32
. . @ . . . . . . . . . . . . . @ . . . . . @ . . . . @ . . . . 
. . . . . . . . . . . @ . . @ . . . . @ . . . . @ . . . . . . @ 
. . @ . . . @ @ . @ . . . . @ . @ . . . . . @ . . . . . . . @ . 
@ . . . . . . . . . . . @ . @ . . . . . . . . . . . . . . . . . 
. . @ . . . . @ . @ . . . . . . @ @ . . @ . . . . @ @ . . . . @ 
@ . @ . . . @ @ . @ . @ . . . . . . @ @ . . . @ . . . . . . . . 
. @ . . . . . @ . . . . . . . @ . . . . . . . . . . . . . @ . @ 
@ @ . . . . . . . . @ . . . . @ . @ . @ . . . . . . . . @ . . . 
. . . . . . @ . @ . @ . . . . . . . . @ . . . . . . . . @ . . . 
. . . . @ @ @ . . . . . . . . @ . . . . @ . . . . . . . . @ . . 
. . @ @ . . . . . . . . . . . . @ . @ . . . . . . @ . . . . . . 
@ @ @ . . . . . . @ . @ . . @ . . . . . @ . . . . @ . . . . @ . 
@ . . . @ @ . . . . . . . @ . . . @ . . . . . @ . . . . . . . . 
. . . . . . . . . . . @ . @ @ . . . . . @ . . . . . . @ . . . . 
@ . . . . . . @ . . @ . . . . . . @ . . . . . . . @ . . @ . . . 
. . @ . @ . . @ . . . . . . . . @ . . . . . @ @ . . . . . . . . 
@ . . . . . . . . . @ . . @ @ . @ . @ @ @ . . . . @ . . @ . @ . 
. . @ @ . . . . . . @ . . @ . @ . . @ . . . @ . . . . . . . . @ 
. . @ . . . . . . @ . @ . . . . . @ . . . @ . @ . . . @ . . . @ 
. . . . . . @ . . . . . . @ . @ . . . @ . . . . . @ @ . . @ . @ 
. . . @ . . . . . @ . . . . . . . @ . . . . @ . . @ @ . . . . . 
@ . . . . . @ . @ . @ . . . . . @ . . @ . . . @ . . . . . @ @ . 
. . . . . . . . . . . . . . . . . @ . . . . @ . . . . . . . . . 
. . . @ . . . . @ . . @ . @ . . @ . . @ . . . . . @ @ . . . . . 
. . . . . . . . . . . . . @ @ . . @ . . @ . . @ . @ . @ @ . . . 
. . . . . . @ . . . . . . @ . . . @ @ . . . . . . @ . . . . . . 
. . . @ . . . . . . . . . . . . . . @ . . @ . . . @ . . . . . . 
. . . . . . . . . . . . . @ . . . . @ . @ . . . . . . . . . . . 
@ . @ . . . . @ @ . . . @ . @ . . . . . . . . @ . . . . . . @ . 
. . @ . . . . . . . @ . . @ . . . . . . . . . . . . . @ . @ . . 
. . . @ . @ . @ . . . . . . . . . . . @ @ . . . @ @ . . . . . . 
. . . . . . . . . . . . . . @ @ @ . . . . @ . . . . . . . @ . @ 
50
22 23 7 7
8 7 29 3
15 8 14 0
16 26 21 20
30 31 12 26
14 17 23 6
24 25 27 21
1 30 9 17
11 4 29 7
18 24 6 24
8 15 30 22
2 26 25 6
7 27 22 13
16 9 21 27
31 7 19 3
6 23 31 14
29 24 23 19
29 26 2 31
23 17 23 29
18 20 22 27
31 21 7 3
17 31 0 15
11 17 20 29
26 17 20 31
14 7 29 17
17 11 21 3
9 19 31 16
6 0 2 6
12 8 1 27
21 9 1 1
15 21 26 1
8 0 11 27
13 7 4 19
4 27 17 1
14 4 14 26
15 13 19 10
11 14 7 25
2 31 7 24
30 8 1 16
29 18 12 27
12 16 7 22
0 22 5 7
24 15 17 5
16 19 30 29
19 25 12 31
19 11 1 2
24 4 0 9
6 22 14 8
30 13 1 21
3 15 23 30
