32 32
. . @ . . . @ . . . . . . . @ . . . . . . . . . . . @ . @ . @ @ 
. . . @ . . . @ . . . . . . . . @ . . . . . . . @ @ . @ . . . @ 
. . . . . . . . . . . . . . . . . . . @ . . . . . . . . @ . . . 
. @ . . . . . @ . . . . . . . . . . . . . . . . . . . . . . . . 
@ . . @ . . . . . . . . . . . . . . @ @ @ . . . . @ . @ . . . . 
. . . . @ . @ . . @ . . @ . @ . . . . . . . . @ . @ . . . @ . . 
@ @ . . @ . . @ . @ . . . . . . @ . . . . . . @ . . . @ . . . . 
. . . . @ . . . @ . . @ . . . . . @ . . . . . . . . . @ . @ @ . 
. . . . . . . . . . . . . . . . . . . . @ . . @ . . @ . . @ . . 
. . . @ @ . . . . . . . . . . . . . . . @ . . . . @ . . . . . . 
@ . . . . . . . . @ . . . . . . . . . @ . . @ . @ . . . . @ . . 
. @ . . . . . . . . . @ @ . . . . . @ @ . @ @ . . . @ . . . @ . 
. . . . . @ . . . . . @ . . . . . . @ @ . @ . . . . . . . . . . 
. . . . . @ @ @ . . . . . . . . @ @ . @ . . . @ . . . . . . @ . 
. . . . @ @ . @ . . @ . . . @ . . . @ @ . . . . @ . . . . . @ . 
. . . . . . . . . . . @ @ . . @ . . @ . @ . . . . . . . . . @ . 
. . . . . . . @ . . @ @ @ . @ . . . . . . @ . . . . . . . . . . 
. . . . @ . @ @ @ . @ . @ . . . @ . . @ @ @ . . . @ @ . . . . . 
@ . . @ . . . . . . . . . . . . . . . . . @ . . . . . . . . . @ 
. . . . . . . @ . . . . . . . @ . @ . @ @ . @ . . @ . . @ @ . . 
. @ @ . @ . . @ . . . . . . . @ . . . . . . . @ @ @ . . . . . . 
. . . . . . . . . @ . . . . . . . . . . . . . . . . . . . . . . 
. @ . . . . . . . . . . . . . . . @ . . . @ . . . . . . . . . @ 
. . . . @ . . . . . . . . . . . @ @ @ . @ . @ . . @ . . @ . . . 
. . . . . . . . . @ . . @ @ . . . . . . . . . . . . . . . . . @ 
. . . . . . . . . . . . @ . . . @ . . . . . . . . . . @ . . . . 
. . . . @ . . . . @ . . @ . @ . . . @ @ . . . . . . @ . . . @ @ 
. . @ . . . . . . . . . . . @ @ . . . . . . . . @ . . . . . . @ 
@ . . @ . . . @ @ @ . . . @ @ . @ . . @ @ . @ @ @ . . . . . . . 
. . . . . . . . . . @ . @ . . . . . . . . . @ . . . . . . . . . 
. @ @ . @ . . @ . . . . . @ . @ . . . @ . . . . . @ @ . . . . . 
. . . . . . . @ . @ . . . @ . @ . @ @ . . . . . . . . . . . . @ 
70
19 25 24 25
2 8 30 21
13 25 0 23
18 28 18 19
16 24 28 14
5 10 11 27
5 29 2 22
1 26 5 24
3 17 6 26
7 2 21 25
25 2 15 16
5 3 15 2
3 0 8 5
6 20 29 1
17 5 0 9
3 2 20 29
10 2 20 7
31 14 1 7
10 4 28 21
4 31 16 8
9 0 30 4
3 24 23 18
20 20 23 0
26 16 20 26
17 16 15 11
16 10 5 17
2 10 16 7
13 15 12 12
3 20 23 3
16 30 25 28
2 19 0 1
31 6 0 31
15 9 3 25
17 18 13 18
7 22 25 18
21 27 2 16
4 11 2 2
23 2 25 22
10 3 16 27
25 0 14 22
8 4 11 3
16 9 28 11
23 27 8 3
6 31 16 20
14 25 13 21
15 3 29 3
26 3 30 24
20 18 3 14
23 4 30 22
14 4 16 24
31 28 11 31
31 25 30 31
17 20 9 3
10 10 17 3
6 16 27 31
20 0 10 2
11 24 5 23
24 21 9 7
20 11 29 17
21 29 16 30
7 0 9 1
29 22 21 9
25 7 2 12
25 25 15 1
6 26 27 30
27 26 12 3
10 12 29 30
15 5 16 15
31 30 23 10
5 19 0 20
