32 32
. @ . . . . @ @ . . @ . . @ . . . @ . . . . . @ . . . . . . . . 
. @ @ . . . . . . . . . . @ @ @ . @ . . . . . @ . @ @ @ . . . . 
. . . . . . . . . . @ . . . . . . . . . . . @ . . . . . . . . @ 
. . . @ . . @ . . . @ . @ . . . . . . . . . . . . . . . @ . . . 
. . . . @ . @ @ . . . @ . . . . . @ . @ @ . . . . . @ . . @ . . 
@ . . . @ . . @ . @ . . @ . . . . . . . . . . . . . . . . . . . 
. . . @ . . . @ . . . . . . @ @ @ @ . . . . . . . . . . . . . . 
. . . . @ . . . . @ . . @ . . . . . . . . . @ . . . . . @ . . . 
. . . . . . . . @ @ . . @ . @ . . . . @ @ @ . . . . . . . . . @ 
@ @ . . @ . . . . @ @ . . . . . . . . @ . . . . . . . . @ . . . 
. . . . . @ . . . . . . . . . . . . . @ . . . @ . . . . @ . @ . 
. . . . @ . . . . . . . @ . . @ @ . . . @ @ . @ . . . . . @ . . 
. . . . . . @ . . @ . . . . . . . . @ . . . . . . . . . . @ . . 
. . . . . . . . . . . . . @ . @ @ . . . . . . . . . @ . . @ . . 
@ @ . . @ . . . . @ . . @ . . . . . . . . . . . . . . . @ . @ . 
. . . . . . @ . . @ @ . . . . @ @ @ . . @ . . @ @ . @ . . . . @ 
. . . @ . @ . . . . . . @ . . . . . . @ @ . . . . . . . . . . . 
. . @ @ . @ . @ . @ . . . @ . @ . . @ . . . . . . . @ . . . . . 
. . . . @ . . . . @ . @ . . . . . . . @ . @ . . . . . . @ . @ . 
. @ . . . . @ . . . . . . . . . . . @ . . . . . . . . @ . @ . . 
. . @ . @ . . . @ . . . @ . @ . @ . . . @ . @ . . . . . . . . . 
. . . . . . . . . . . . . . . . . @ . . . . @ . @ . . . @ . @ . 
. . . . . @ . . . . . . @ . @ @ . . . . @ . . . . @ . . . . @ . 
. @ . . . . . . . . . . . . . . . . . . . . @ . . . @ . . . . . 
@ . . @ @ . . . . . . @ . . . . . . . . @ . . . @ . . . . @ . . 
. . . . @ . . . . @ . . . . @ . . . . . . . . . @ . . . . . . @ 
. . . . . . . . @ . . . . . @ . . . @ . . . . . @ . . . @ @ . . 
@ . . @ . . . @ @ . . @ @ @ . . @ . . . . . . @ . . . . . . @ . 
. . . . . . . . . . . . . . . @ . . . . . . . . . . . . . . . . 
. . . . . . . . . . . @ . @ . . . . . @ . . @ . . . . @ @ . . . 
. . . . . . . . @ . . . . . . . . @ . . @ . . . @ . . @ @ . . . 
. . . @ @ @ @ . . . . . . . @ @ . @ . @ . . . . . . . . . . @ . 
10
16 5 1 4
6 27 5 1
13 2 4 13
0 17 15 14
19 6 29 10
5 21 5 21
2 24 17 14
29 5 9 31
31 13 4 27
0 31 18 15
