32 32
. . . @ @ . . @ . . . . . . . . . . . . . . . . . . . . . . . . 
@ . . . . . . . . . . @ @ . . @ @ . . @ @ . @ . . . . . . . . . 
@ . . . @ . . . @ . . . . . . . . . . . . . . @ @ . . . . . . . 
. @ . @ @ . @ . . . . . . . . @ . . . . . . . . . . . . . . . . 
. . . . @ . . . . . . @ @ . . . . @ . . . . . . . @ . . . @ . . 
@ . . . . . . . . . @ . . @ . . . . . . @ . @ . . . . . . . . . 
@ . @ . @ . . . . @ . . . @ . . . . . . . . . @ . . . . . . . . 
. . @ @ . @ . . . . @ . . . . @ @ . . . . . . . . @ . @ . . . @ 
. . . . . . @ . . . @ . . . . . . . @ . . . @ . . . . @ . . . @ 
. . . . . @ @ . . . . . @ @ . . . . . . . . . . . . . . @ . . . 
. @ . . . @ . . @ . . . @ @ @ . . . . . . . . . . . . . . . . . 
. . . . . . . . . . . @ . . . . @ . @ @ @ . @ . . . . @ . . @ . 
. . @ . . . . . . @ @ . . . . . . . . @ . . . . @ . . . @ . . . 
. . . . . . . . . @ . @ . @ @ . . @ . . . . . . . . . @ . . @ @ 
. . . . . . @ @ . @ . @ . . @ . @ . . @ @ . . . . . . @ . . @ . 
. @ . . . @ @ @ . . . . @ . @ . . . . . . . @ @ . . . @ . . . @ 
. . . @ . . . . . . . . . . @ . . @ . . . . . . . . . . . . . @ 
. @ @ @ . . . @ @ . . . @ . . @ . . . . . . . @ . . . . . . . . 
. . . . . . . . . . . . . . . . . . @ . . @ . . @ . . . . . . . 
. @ . . . . @ @ . . . . . . . . . . . . . . . . . @ . . . @ . . 
. . . . . . . . @ . @ . @ . . . @ . . . . . . . . . . . . . @ . 
. . . . . . . . . @ . . . . . . . . . . @ . . . @ . @ . @ @ . @ 
@ @ @ . . . @ . @ @ . . . . . . . . . . . . . @ . @ @ @ . . @ . 
. . . . . . . . . @ . . . . @ @ . . . @ . . @ @ . . . . . . . . 
. . @ @ . . . @ . @ . . . . . . . . . . . . @ @ . . . @ . . . . 
. @ . @ @ @ . . @ . . . @ . . . . . @ . . . . . @ . . . @ . @ @ 
. . . . . . . . . . . . @ @ @ . . . . . @ . . . . . @ @ . . . . 
. . . . @ . . . . . @ . . . . . . . . . . . @ @ . . @ . @ . . @ 
. . . . . @ . . . . . @ . . . . . . @ @ . . . . @ . . . . . . . 
. @ . . . . . @ . @ . @ . . . . . @ . . . . . . . . . . . . . . 
. . . . . . . . . @ . . . . @ . . . . . . @ . @ . . . . . . . . 
. . . . . . . . @ . . . . . . . . . . @ . @ @ . . . . . . . . . 
30
21 29 11 6
26 28 22 7
30 3 31 11
14 24 9 5
23 26 19 8
14 31 8 1
25 25 14 24
25 16 12 11
0 24 27 10
7 3 20 0
5 17 4 31
17 28 10 30
18 31 0 29
12 12 8 30
27 2 18 12
20 30 18 19
2 31 16 13
22 20 22 17
5 11 14 2
2 2 3 21
11 30 29 0
3 31 9 3
25 23 22 2
9 17 13 8
18 17 28 28
4 9 21 0
5 23 9 1
31 1 5 26
30 5 30 23
20 0 11 10
