32 32
. . @ . @ . @ . . . . . @ . . . . @ @ . @ @ . . . . . . . . . . 
. @ . . @ @ . . . . @ . . . . . . . @ . . @ . . . . . . . @ . . 
. . . @ . . @ . . . . . . . . . . @ @ . @ . . @ . @ . . . . . . 
@ @ . . . . . @ . . @ . @ . . @ . . . . . . . @ . @ . . . . . . 
@ @ . . . . @ . . . . . . @ . @ . . . . @ . . . @ . @ . . . . . 
. @ . . . . . @ . . . . . . . @ . . @ . . . . . . . . . @ . . @ 
. @ . . . . @ . @ . . . @ . . . . . . . . . . . @ . . . . . . @ 
. . . . . . @ . . . . . . . . . . . . @ . @ . @ . @ . . . . . . 
@ . . @ . . . . . . . . . . . . . . . . @ . . . . . . . . . . . 
. . @ . . . . @ . . . . . . . . . . . . . . . . @ . . . . @ . @ 
. . . @ @ . @ . . . . . . . . . . . . . . . . . @ @ . . . . . . 
@ . @ . . . . . . . . @ . . @ @ . . . . . . @ @ . . @ . . . . . 
@ . . . . @ @ . . . @ . . . . @ . . @ . . . . . . . @ . . @ @ . 
. . @ . @ @ . @ . . . . . . . . . . . . . . @ . . . . . @ . . . 
@ . . . @ @ . . . . @ . . @ . . . . . . . . . . . . @ @ @ . . . 
. . . . . . . . @ . . @ . . @ . . . . @ @ . . @ . . . . . . @ @ 
. . . . @ @ @ . @ . . . . . . . . . . . . . . . . @ . . @ . . . 
. @ . . @ . . . . . . . . . . . . . @ @ . . . . . @ . . @ . . @ 
. . . . . . . . . . . . . . . . @ . . . @ . @ . . @ . @ @ @ . . 
. . . @ . . . . . . . . . . . @ . . @ . . . . . . . . . . . @ @ 
. . . @ . . . . . . . . @ @ . . . . . @ . . @ . . . . . . @ . @ 
. . @ @ . . . . . @ . . . . @ . @ . . @ . . . . @ . . . @ . . . 
. . . . @ . . . . . . @ . . . . . . . . . @ . . @ . . . . . . . 
. . . @ @ . . . @ . . . . . @ . @ . . . . . . . . . . @ @ . . . 
. . @ . . @ . . . . . . . . . @ . . . . . . . . . . . . @ @ . . 
. @ . . . @ . . . @ . @ . . . . . . . . @ . . . @ . . . . @ . . 
@ . . @ . . . . . . . . . . . . . . . . . . . . . . . . . @ . . 
. . . @ . @ @ . @ . . . . . . @ . . . . . . . . @ . . . . . . . 
. @ . . . . . @ . @ . . @ @ . . @ . . . . @ . . . . . . @ . . . 
. . @ . . . . . . @ . @ . . . @ @ @ . . . . . . . . . . . . . . 
. . . . . . . . . @ @ . . . . @ @ . @ . . . . . . . . . . . @ . 
. . . . . . @ . . . . . . . . @ . . . . . @ . . . . @ . @ . . . 
10
27 17 30 31
14 22 8 1
12 26 17 20
11 18 23 19
8 11 9 18
24 3 10 6
9 16 1 16
26 28 25 14
22 0 12 16
12 4 21 14
