32 32
. . . . @ . . . . . . . . . . @ . . @ . . @ . . . @ . . @ . @ . 
. . . @ . @ . . . . . . . . . . . @ . . . . . @ @ . . . @ . @ . 
. . . . . . . . @ @ . . . . . . . . . . . . . . . @ . . . @ @ . 
. . . . . . . . @ . @ . . . . . . . . . . . @ . . . . . . @ @ @ 
. . . . . . . . . . . @ . . . @ . . . . @ . . . . @ . @ . . . . 
@ . . @ @ . . @ . . . . . @ . . . . @ . @ . . . . @ . @ . . @ @ 
. . . . . . . . @ @ . @ . . @ . . . @ . . . . . . . . . . . . . 
@ . . . . . . . . . . . . . @ . . . @ . . @ . . . . . . @ . . @ 
. @ @ . @ . @ . . . . . @ . . . . . . . . . @ @ . . . . . . . @ 
. . . @ . . . @ @ . . . . . . . . . @ . . @ . . . . . @ . . @ . 
. . . . @ . . . @ . @ . . @ . . . . . . . . . @ @ . . . . . . . 
. . @ . @ . . . . . . . @ . . . . . . . . . . . . . . . @ . . . 
@ . . . @ . . . . . @ . . @ . . . . . . . . . . . @ @ . . @ . . 
. . @ @ . . @ . . . . . . . . @ . . @ . . . @ . @ . . . . . @ . 
. . . @ . . . @ @ . . . @ . . . @ . . . . . . . . . . . . . . . 
@ . . . . @ @ . . . . . . . @ . . . . . @ . @ . . . . . @ . . . 
. @ . . . . . . . . . @ . . . . . . . . . . . . . @ . . . @ . . 
. . . @ . . . . . . . . @ . . . . @ . . . . . . . . . . . . . . 
. @ . . . . @ . . . . @ . . . . . . @ . . . . . . . . @ . @ @ . 
@ . . . . . . @ . . . @ . . . . . . . . . . @ . . . . . @ . . @ 
@ @ @ . . . . @ . . @ . . @ . . . . @ . @ . . . @ . . . . . . . 
. @ . . @ . . @ . . . . . . . . . @ @ @ . . . @ . . . @ @ . @ . 
. . . . . . . . . . @ . . . @ . . @ . . @ . . . . . . . . . . . 
@ . . . . . . @ @ . . . @ . . @ @ . @ . . @ @ . . . @ . . . . . 
@ . . . . . . . . . . . @ . . @ . . @ . @ @ . . . . @ . . . @ . 
. @ . . . . . . . . . . . . . . . . . . . . . . . @ . . . . . . 
. . @ . . @ . . . . . . . . . . . . . . . . . @ . . @ @ . . . . 
@ @ @ . . . . . @ . . . . . . . . . . . @ . @ @ . . . . . . . . 
. . @ . . . . @ . . @ . . . . . . . @ . . @ . . . . . . . . . @ 
@ . . @ @ . . . . . @ . . . @ @ . . . . . . . . . . . . . . . . 
. . . . . . . . @ . . . @ . . @ . . . . . @ . . . . . . . . . @ 
. . @ . . . @ . . @ . . . @ @ . . . . . @ @ . . . . @ . . . . . 
70
0 2 8 26
24 2 13 9
8 7 3 0
25 17 7 6
26 10 22 16
15 19 28 6
19 25 30 28
11 12 25 23
4 17 18 11
3 23 19 17
11 7 12 5
0 16 3 8
1 10 15 20
7 17 4 13
7 13 28 22
28 2 27 16
14 5 22 9
18 25 15 7
18 10 8 28
24 22 26 3
21 26 13 2
11 8 17 30
10 2 29 5
30 11 0 11
3 31 17 12
16 21 8 20
24 30 29 20
17 12 31 15
8 5 19 2
27 3 0 10
16 27 12 10
31 26 25 28
21 25 23 20
13 15 3 26
11 28 0 0
21 29 2 1
19 19 13 26
27 6 12 20
17 16 12 18
22 6 15 5
1 12 5 17
13 0 22 26
21 5 19 23
11 26 14 26
12 22 5 18
19 18 20 3
16 29 15 18
28 25 25 3
31 9 20 13
5 3 15 21
25 6 12 26
12 13 29 10
18 29 26 18
18 2 13 7
17 19 14 19
22 17 22 14
13 27 18 2
25 10 13 22
9 19 22 28
31 31 16 21
23 20 15 6
9 13 15 25
13 25 13 15
5 23 20 11
27 25 23 18
11 25 28 28
5 12 16 26
2 18 23 11
11 1 27 2
23 7 15 31
