32 32
. . . . . . . . . . @ . . . . . . . . @ . . . . . . . . . . . @ 
. . @ . . . . . . . . @ . . . . . . . . . . @ . @ . . . . . @ . 
. . . . . . @ @ @ . . @ . . . . . @ @ @ @ . . . . @ . @ . . . . 
@ . . . . . @ . . . . . . . @ . @ . . . . . . . . . . . . . . @ 
. @ . . . . . . @ . . . . . . . @ . . . @ . @ . . . . @ . . . . 
. . . . . . @ . . . . . . . . @ . . @ @ . . . . . @ . @ @ @ @ @ 
. . . . . . . . . . . . . . . . . . . . . . . . . @ . . . . @ . 
@ . @ @ . . . . . . . . . . . . . . . . @ . . @ . . @ . . . . @ 
. . @ . . @ @ . @ . . . . . . @ @ @ . . . . . . . @ . @ . . . . 
. . . . . . . . . . . @ @ @ . . . . . @ . @ . . @ @ . . . . . . 
. . @ . . . . . . @ . . @ . . . . . . . . @ @ @ . @ . . . . . . 
. . . . . @ @ @ . . . . . @ . . . @ @ . . . . . . . . . . . @ . 
@ . @ . . . @ . . @ @ . . @ . @ . . . . . . . . . . . . . . @ . 
. . . . . . @ @ . . @ . @ @ . . . . . . . . @ @ . . @ . . . . . 
. @ @ . . @ @ . . . . @ . . @ @ . @ . . . . . . . @ @ . . @ . . 
. . . . . . . . . @ . . . . . . . . @ . . . @ . @ . . . . . . . 
. @ . . . . . @ . . . . . @ @ . . . @ . . . @ . . @ . . . . . . 
. . . @ . . . . @ @ @ . . . . @ . . . . . . @ . . . . . . . . . 
. . . @ . . . . . . . @ @ . . . . . . . . . @ . . . . . . . . . 
. . @ . . . . . . @ . . . . . . . . . . . . . @ . . . . . . @ @ 
. . . . . . . . . . . @ @ . . . . . @ . . @ . . . @ @ . . . . . 
. . . . @ . . @ . . . . . . @ . . @ . . . . . . . . . . . @ . @ 
. . . . . . . @ . @ . . @ . @ . . . . @ . . @ @ . . . . . @ @ @ 
@ . . . . @ @ . . @ . . . . . . . @ @ @ . . . . . . . . . . @ @ 
. @ . @ . . . . . @ . . . . . @ @ @ . @ . @ . . . . . . . . @ . 
. . . . . . . . . @ . @ @ @ . @ . . . . . . . . . @ . . . . . . 
. . . . . . . . . @ . . . . . @ . . . @ @ . . . . . . . . . . @ 
. @ . @ . . . . . . . . . . . . . @ . . . . . . . @ . . . . . . 
. . . . . . . . @ . . @ . . . . . . @ . . . . . @ . @ . . . . . 
. . . . . @ . . . @ . . @ . . . . . . . . . @ . . . . . . . . . 
. @ . . . . . . @ . . . . . . . . . . . . . . . . . . . . . . @ 
. @ . . . . . . . . . . . . . . . . @ @ . . @ . . . . . . @ . @ 
30
0 0 4 18
5 31 23 29
1 25 24 18
16 5 26 22
1 18 21 29
13 10 17 7
22 21 17 25
5 28 11 21
25 17 23 21
30 10 0 25
15 7 14 1
20 8 1 17
13 15 24 27
14 11 5 1
4 0 16 12
21 28 7 14
9 3 10 22
7 20 0 31
31 20 20 12
9 8 24 30
12 15 14 27
8 29 29 6
8 31 27 23
18 4 29 18
30 2 21 2
28 22 24 7
15 19 8 1
8 24 21 31
20 0 26 12
18 29 25 13
