32 32
. . . . . @ . . . . . . @ . @ . . . . . . @ . . . . @ . . . . . 
. @ . . . . . . . . . @ . @ @ . . @ @ @ . . . . . @ . . @ . . . 
@ . . . . . . . . . . . . . . . . . . . . @ . @ . . . @ @ . . @ 
. . . @ . . . . . . . . . . . @ . @ @ . . . . @ . @ . . . . . @ 
. . . . . . . . @ @ . @ . @ . . . @ . . . @ . . . . . . . . . . 
. . @ @ . . . . . . @ . . . @ . . . . . . . . . @ @ . . @ . @ . 
. @ . . @ . . . . . . . @ . . . . @ @ . . @ . @ @ @ . . @ . . . 
. . . @ . . . . . . . . . . @ . @ . . . . . @ . . . . . . . . @ 
. . . . . . @ @ . . . @ . @ . . . . @ . . . @ . . @ . @ . . @ . 
@ . . . . . . @ . . @ . . . @ . . . . . . . . . . @ . . . . . . 
. . @ . . . . . . . . . . . . . . . . . . . . @ . . . . . @ . . 
. . . . @ @ . . . @ . . . . . @ . . . . . . . . . . . . . . . . 
. . . @ . . . . @ @ . . . @ @ . . @ . . . . . . . . @ . . . . . 
. . . . . . . . . . . @ . @ @ . @ . . . . . @ . . . . . . . . @ 
. . . @ . . . . . . . . . @ . @ . . @ . . @ . . @ @ . . . . . . 
@ . . @ . @ @ . . . . . . . . . . @ @ . @ . . . . @ . @ . . . . 
. @ . . . . . . . @ . . . . . . . . . . . . . . . @ . . . @ . . 
. . @ . . . . . . @ . @ . . . . . @ . . . . @ . . @ . . @ . . @ 
. . @ @ . . @ . . . @ . . . . . . . . . . . . . . . @ @ . @ . . 
. @ . . . . . . . @ . @ . . . . . @ . . . . . . @ . @ . . . . . 
. @ . . @ @ . . . . . . . @ @ . . . @ . . . @ . . . @ . . . @ . 
. . . . . . . . . . . . . . . . . . . . . . . @ . @ . . . . . . 
. . . @ . . . . . . @ . @ . . . @ . @ @ . . . @ . . @ @ . . @ @ 
@ . . . @ . . @ . @ @ . . . . . . . . . . . . @ . @ . . . . . @ 
. @ . . . . . . . @ . . . @ @ . . . . . . . . . . . . . . . . . 
. . . @ . . . . . . . . . . . . @ @ . . . @ . . @ . . @ . . . . 
. . . . . . . . . . . . . . . @ . . . @ . . . . @ . . . @ @ . . 
@ . . . . . . @ . . . . . . . @ @ . . . . @ . . . . . . . . . . 
. . . . . . . @ . . . . . . @ . . @ . @ . . . . . . . @ . . . . 
. . @ . . . . . . . @ . . . @ . . . . . @ . . . . . . . @ . . @ 
. . . . @ . @ . . . . . . . . . @ . . . . . @ . . . . . . . . @ 
. . @ . . . . . @ . . . . @ . . . @ . . . . . @ . @ . . . . . @ 
30
8 30 4 18
20 30 29 4
13 11 5 4
27 20 19 6
24 23 14 21
3 0 9 14
2 19 15 25
23 8 13 9
10 11 29 11
19 14 8 23
22 26 20 23
28 13 20 17
0 13 19 29
17 9 12 27
24 30 6 29
27 9 12 30
6 24 8 0
4 18 7 16
11 16 7 3
21 12 17 5
6 5 9 0
12 5 8 30
19 6 26 17
22 12 6 22
7 2 15 19
2 4 1 4
26 17 5 14
14 11 31 5
17 0 22 18
19 23 26 21
