32 32
@ . . . . . . . . . . . . . . . @ . . @ . . . @ . . . @ . . @ . 
. . . @ @ . @ . @ . . . . . @ . . @ . @ . . @ . . . . . @ . . . 
. . . . @ . @ . . . . . . . . . @ @ . . @ . . . . . . . . . . @ 
. . @ . @ @ . . @ . . . @ . . @ @ . . @ . . . @ . . . . @ . . . 
. . . . @ @ . . . . . . @ . . . @ . . . . . . @ . . . . . @ . . 
. @ @ . . . . . @ @ . . . . . @ . . @ @ . . . . . . . @ . . . . 
. . . . . @ . . . @ . . . . . . . . @ . . . . . . . . . @ . . @ 
. . . @ . . . . . @ @ . . . . . . @ @ . @ . . . . . @ . . . @ . 
. . . . . . . @ . . . . . @ . . . . . . . . . . . . . @ . . . . 
@ . . @ . . . . . @ . . @ @ . @ . . . . . . . . . . @ . @ . . . 
. @ . @ . . @ . . . . . . . . . . @ . . . . . . @ . . . . . . . 
. . . . . . . @ . . . . @ . . @ . @ . @ . . . @ . @ @ . . . . . 
. . . . . . . . . . . @ . . . . . . . . . . . . @ . . @ . . . @ 
. . . @ . . . . @ @ . . . @ @ . . @ @ . . @ @ . . . . . . . . . 
. . . . @ @ . . @ . . . . . . . . . . . . . . @ . . . . . . @ . 
@ . @ . . . @ @ . . . . . . @ . . . . . . . @ . @ . @ @ . . . @ 
. @ . . . @ . . . . . . . . @ . . . . . . . . @ . @ . . . . . . 
. . . . . . @ . . . . . . . . . . @ . @ . . . . . . . @ . . . . 
. . . . . . . . . . . . . . . . . . . . . . . . . . @ . . . . @ 
. . . . @ . @ . @ . . . . @ . . . . @ . . . . . . @ . . . . . . 
. . . . @ . . . . . . . . @ . . . . . . . @ @ @ @ . . @ @ . . @ 
@ . . . . . . . . . . . . . . . . . . . . . @ . @ @ . . . . . . 
@ . . . . . . . . @ @ @ @ . @ . @ @ . . . . . . @ . . . . . . . 
. . . . . . @ . @ . . . @ . . @ . . . . . . @ . . . . @ . . . @ 
. . . @ . . . . . . . . . . @ . . @ . . . @ . . . . @ . . . @ . 
. . . @ . @ . . . . . . . @ @ @ . . . . . . . . . @ . . . . . . 
. . . . @ . . @ . . . . @ . . . . . . @ @ . . @ . . . . . . . . 
. . . @ . . . @ . . . . @ . . . . @ . . . . @ . . . @ . @ . . . 
. . . . @ . @ . . . . @ . . . . . . . . . . . @ . @ . . @ . . . 
. . @ . . . @ . . . . . @ . @ . . . . . . @ . . . . . . . . . . 
@ @ . . . . . . . . @ . @ . . . . . @ . . @ . . . @ . . . . @ . 
. . . . . . . . . . . . . . . . @ . . . @ @ . . . . @ . . . . . 
50
0 31 31 22
29 25 11 7
26 6 9 11
15 27 28 12
12 15 24 26
17 9 6 14
28 8 1 19
9 23 4 23
13 21 12 13
27 4 17 31
24 23 19 31
16 29 3 22
5 1 16 19
10 13 1 22
3 28 3 20
15 0 27 28
10 29 30 22
17 19 16 6
8 18 7 4
7 25 13 17
17 31 20 8
22 10 5 8
28 25 18 17
15 18 21 22
21 14 23 31
17 30 18 22
6 4 29 9
25 7 29 27
24 5 24 24
2 12 31 8
21 8 21 12
2 16 8 29
9 20 13 30
27 3 11 4
6 30 11 11
29 5 2 2
18 21 18 26
9 1 18 4
19 14 13 22
11 29 30 1
27 30 31 9
31 25 17 20
26 19 22 6
3 14 0 24
26 10 1 29
9 4 0 25
30 20 15 2
1 21 4 16
16 13 21 17
2 20 9 27
