32 32
. . @ . . . . . . . . . . . . . @ . @ . . . . . . . . . @ @ . . 
. . . . @ . . @ . @ @ . . . . . . . @ . . @ @ . . . @ @ . . . . 
. @ . . @ . . . @ . @ @ @ . . . @ . @ . . @ . . . . @ . . . . . 
. . . @ @ . . @ . @ . . . @ . . @ . . . . . @ @ . . . @ . @ @ . 
@ . . @ . @ @ . . . . . . . @ @ . . . . . . . . . . @ . . . . . 
. . . . . . . . . . . . . . . . . @ . . . . . . @ . . . . . @ . 
. . . . @ . . . . . . . . @ @ @ . . . . . @ @ @ . . . . . . . . 
@ . . . . . . . . . @ @ . . . . @ . . . . . . . . . . . . . @ . 
. . @ . . . @ . @ . . . @ @ . . . . . . . . @ . . . @ . @ . . . 
. . @ @ @ @ . . . . . . . . @ @ . . . . @ . @ . . . . @ . . . @ 
. . . . . . . . . . . . @ . . @ . . . . . . . . . . . . . . . @ 
. . . . . . . . . . . @ @ . @ . . . . . . . @ . . . . . . . . . 
. . . . . . . . . . @ . . . @ . @ . . . . . @ . @ . @ . . . @ . 
. . . . . . . @ . . . . . . . . @ . . . . . . . . @ . . . @ . @ 
. . . . . . . . . . . . . . @ @ . . . . . . . . . . . . @ . . . 
. . @ . . . . @ . . . . @ @ @ @ . . . . . . @ . . . . . . @ . . 
@ . . . . . . . . . . . . . . @ . . @ . . . . . . . . @ . . . . 
@ . . . . . . . . . @ @ . @ . . . . @ @ . . . . . . . . @ . . . 
. . . @ @ @ . . . . . . . @ . . @ @ . . . @ . . . . . . . . . . 
. . . . . . . @ . . @ . . . @ . @ . . . . @ . . . . . . @ . . . 
@ . . . @ . @ @ . . . . . . . @ . . . . . . . . . . . . . . . . 
. . . . . . . @ . . . @ . @ . . @ . . . @ . . @ . . . . . . . . 
. . . . . . . . . @ . @ . . . @ . . . . . . . . . . . . . @ . . 
@ . . . . @ . @ @ . . . . . @ . . . . . . . . . . @ . . . @ @ . 
@ . . . . . @ . @ . . . . @ . . . . . @ . . . . . . . @ . . . . 
. @ . . . @ . @ . . . @ . @ . . . . . . . . . . . . . . . . . @ 
. @ @ . . . . . @ . . . . @ @ . . @ . . . . . . @ . @ @ . . . . 
. . . . . . . . @ @ . . . . . @ . @ . . . . . @ . . @ . @ . . . 
. . @ . . . . . . . . . . . @ . . . @ . . @ . . . . . . @ @ @ . 
. . . . . . . . . . . . . @ . . . @ . . . . . . . . . . . . . . 
. . . . . . . . @ . @ . . . @ . . . @ . . . . . @ . . @ . . . . 
@ . . @ @ @ . . . . @ . . @ @ . @ . . . . . . . @ . . . . . . . 
70
18 25 30 25
28 6 8 0
25 2 12 6
2 22 18 12
14 20 0 26
29 5 4 26
20 19 14 2
10 9 26 29
16 25 16 16
0 18 9 31
0 13 4 12
23 13 16 5
29 21 28 13
4 14 17 2
13 22 12 17
27 0 25 15
8 6 14 10
31 1 7 14
3 16 13 27
20 24 26 13
6 5 28 24
18 3 25 18
27 7 6 18
16 4 31 30
14 17 22 4
3 28 15 17
0 8 17 16
6 15 22 5
17 6 26 20
15 3 9 16
27 25 28 22
2 20 4 24
3 5 25 14
15 30 26 24
23 23 7 28
5 20 20 19
11 19 30 20
18 31 11 30
26 21 13 16
2 6 23 12
22 5 4 29
1 21 24 13
6 18 12 1
20 7 22 28
31 5 2 2
23 10 27 19
13 7 15 24
14 22 3 6
0 21 1 1
20 0 10 9
14 0 8 15
3 6 5 27
11 28 20 11
7 18 23 30
10 10 10 26
8 21 14 7
12 28 24 9
31 3 0 13
11 30 22 13
1 7 17 12
3 23 23 17
10 14 0 12
26 7 18 29
14 21 7 2
20 17 21 0
2 23 1 8
27 2 2 4
15 24 12 31
30 21 17 31
20 13 1 6
