32 32
. . . . . . . . . @ . @ . . . . . . . . . @ . . . . @ @ . . @ . 
. @ . . . . . . . . . @ . . . . . . . . . . @ . @ . . . . . . . 
. . . @ . . . . . . . . @ . . @ . @ . . . . . . . . . . @ . . . 
. . @ . . @ @ @ @ . @ . . . . @ @ . . . . . . . @ . . . @ . . @ 
. . @ . @ . @ . @ . @ . . . . @ . . . . . . . . . . . @ . . @ . 
. . @ @ . . @ . @ . . @ . . . . . . . . . . . @ . . . @ @ . . . 
. @ @ @ . . . . . . @ . . . . @ . @ . . . . . . . . . . . . . . 
. . . . @ . . . @ . . . . . . . @ . @ . . @ . . . . . . . . . . 
@ @ . . . . . @ . . . . @ . . . . . . . . . . . . . . . . . . . 
. . . . . . . . . . . . . . . . . . . . . . . . . . . . . . . . 
. . . @ . @ @ . . . . . . @ . @ . . . . . . @ @ . . . . . @ @ . 
. . . . . . . . @ . . @ @ . . . . . . . @ @ @ @ . . . . . . . . 
. . . @ @ . . . . . . . . . . . . @ . . . . . . . @ @ @ . . @ . 
. . . . . . . . . . . . @ . . @ . . . . . . . @ . . . . . @ @ . 
. . . . . . . . @ @ . @ . . . . . . . . . @ . @ . . . . . . . . 
. . . . . . @ . @ @ . . . @ @ . @ . . . . . . . @ . @ . . . . . 
. @ . @ . . . . . @ . . . . . . . @ @ . . . @ . . @ @ . @ . @ . 
. . @ . . . . . . . . . . . . . . @ . @ . . . . @ . @ . . . . . 
. . . @ . @ . @ @ . . . . . @ . . . . @ @ . . . . . . . . . . . 
. @ . . . . . @ . @ . @ @ @ . . . . . . . . . . . . . . . @ . . 
@ @ . . . . @ @ . . @ . . . . @ . . . @ @ . . . . . @ . @ . . . 
. @ . . @ . @ . . . . . . . . . . . . . @ . . . . @ . @ . . . . 
. @ . @ . . . . . . . . . . . . . . . . . . . . . @ @ . . . . . 
. . @ . . @ . . . @ . @ . . . . . . . . . . . . . . . . . . . . 
. @ . @ . @ . @ . . @ . . @ . . . . . @ @ @ . . . . @ . @ . . . 
. . . @ . . . . . @ @ @ . . . @ . . . @ . . @ @ . . . . . . . . 
. . . . @ . . . . . . . . . . . . . . . . . @ . . . . . . . . . 
. . @ . @ . @ . . @ . @ . @ . . . . . . . . @ . . . . . . . . . 
. . . . . . . . @ . . @ @ . . . . . . . . . @ . . . . . . . . . 
. . . . @ . . . . . . @ . . . . . . . . @ . . . . @ . . . . . . 
@ . @ . . . . @ . . . @ . . . . . . . . . . @ . . . . . . . . . 
. . @ . @ @ . . . @ @ . . . . @ . @ . @ @ @ @ . . . . . @ . . . 
40
9 26 3 23
9 3 10 28
16 10 17 28
26 29 1 14
9 7 14 6
10 30 12 21
7 0 31 27
12 21 15 18
22 8 24 4
22 6 4 25
29 30 13 31
28 11 20 19
4 11 8 16
12 5 29 21
23 17 17 25
0 26 21 21
5 9 12 15
27 22 24 18
22 23 12 1
12 20 26 23
8 8 31 1
19 11 22 7
4 25 23 31
29 6 5 29
5 30 24 28
4 16 28 14
19 19 27 19
14 7 27 29
5 25 21 2
21 8 24 7
20 22 4 8
4 5 0 27
31 17 16 29
18 8 19 15
2 8 9 28
0 4 19 6
5 20 30 21
20 14 2 2
15 26 7 22
27 25 6 2
