32 32
. . @ . @ . @ @ . . . . . @ . @ @ . . . . . . @ . . . @ @ @ . . 
. . . . . . . . . @ @ . @ . . . . . . . @ . . . . . . . . . @ . 
. . . . . . . @ . . @ . . . @ @ . . . . . . @ @ . . @ . . . . . 
@ . . . . @ @ . . . . . . @ . . . @ . . . . . . . . @ @ . . . . 
. . . . . . . . . . . . @ . @ . . . @ . . . . @ . . . @ . . . . 
. . . @ . . @ . . . . . . @ . . . . . . . . . . . . . @ . . @ . 
. . . . . @ . . @ . . . @ . . . . . . . . . . . @ . . . . . @ . 
. . . . . . . . . . @ . @ . @ @ . @ @ . . . . . @ . . . . . . . 
. . . @ . . . . . . @ @ . . . . . . . . . . . . . @ . . . . @ . 
. . . . . . . . @ . . . . . . . . . . . . . . @ . @ @ . . . . @ 
. . . @ . . . . . . . . @ . . @ . . . . . . @ . . . . . . @ . . 
. . @ . . . . . . . . @ @ . . . @ . . . . . . @ . . . . . . . . 
@ @ . . . . . . . . . . . . . @ . @ . . @ . . . @ . . . @ . . @ 
. . . . . . . @ . . . @ . . . . . @ . . @ . . . @ . . . . @ . . 
@ . @ . . @ . . . . . . . . . . . . @ . @ . . . @ . @ . @ . @ . 
@ . . . @ . . . . . . . . @ @ . @ @ . @ . . . . . . . . . . . . 
. . . . . . . . @ . . . . . . . . . @ . . . @ . @ . . . . . . . 
. . . . . . . . . . . . @ @ . . @ @ . . . . @ . @ . . . . . . . 
. . . . . . . . . . . . . @ . . . . @ . . . . . @ @ . . . . @ . 
. . . @ @ . @ @ . @ . . @ @ @ . @ . @ . @ . . . . . @ . . . . . 
. . . . . . . . . . @ . . . . . . @ . . . . . . . . . . . . . . 
. . . . . . @ @ @ . . . @ . @ . @ . @ . . . . @ . @ . @ @ . . . 
. . . @ @ . . . . . . @ . . . @ @ . . . . . . . . . . . @ . . . 
. . . . . . . . . . . @ @ . . . @ . . . . . . . . . . . . . . . 
. . . . . . . . . @ . . . . @ . @ . . . @ . . . @ . @ @ . . . . 
. . . . . . . . . . . . . . @ @ @ . @ . @ . @ . . . . @ . . . . 
. . @ . . . . . . @ . . . . . @ . . . . . . @ . @ . . . . . . . 
. . . . . . . . . . . . . . . . . . . . @ @ . . . . @ . . @ . . 
. @ . . . . . @ @ . . . . . . . . . @ . . . . . . . . . @ . . @ 
. . . @ . . . . . . . @ @ . . . . @ . . @ . . @ @ . . . . . . . 
. @ @ @ . . . . . . . . . @ . @ . . . @ . . . @ . . . . . . . . 
. . @ . @ . @ @ . @ . . . @ . . . @ @ . . . . . . @ . . . @ . . 
30
5 22 11 6
2 9 25 10
31 25 27 13
18 5 20 9
6 25 10 15
17 22 9 17
6 6 1 16
22 5 19 27
27 2 8 19
0 18 4 13
24 15 16 4
15 11 18 8
25 14 26 16
11 0 25 30
2 24 12 15
30 31 20 30
26 18 24 1
16 18 31 27
30 0 14 20
12 16 27 12
24 1 9 4
13 16 13 29
27 22 2 12
3 26 25 14
8 27 20 22
25 27 18 23
1 25 27 26
27 9 26 5
28 5 10 18
9 5 29 21
