32 32
. . @ . . . . . @ . . . . . . . . . . . . @ . . . . . @ . . . . 
. @ . . . @ . . . @ . @ @ . . . . . @ . . . . @ @ @ . . . . . @ 
. @ @ . @ . . . . . . . . . . . . . @ . . . . @ @ . . . @ . . . 
. @ @ . . . @ . @ . . . . . . . @ . @ . . . . . . @ . . . . . . 
. . @ . . . . . . . . . . . @ @ . . . . . . @ . . . . . . @ . . 
. . . . . . . . . . . @ . . . @ . . @ . . @ @ . . . . . . . . . 
. . @ . . @ @ @ @ . . @ . . . @ . . . . . . . . . . . @ . . . . 
@ . . . . @ . . . . . . @ @ . @ . . . . . . . . @ @ . @ . . . . 
. @ . . @ . . . . . . . . . . . @ . . . . . @ @ . @ . . . . . . 
. @ . @ . @ . . @ . @ . . . @ . . . . . . . . . . . . . . @ . . 
@ . . @ . . . @ @ . @ . @ . . . . . @ . . . . . . . . . . . . . 
. . @ . . . . . . . . @ . . @ . . . . . . . . @ . . . @ . . . . 
. . . . . . . @ . . @ . . . @ @ . . . @ . . . . . . . . . . . . 
. . . . . . . @ . . . . . . . . @ . @ . @ @ . . . . . . @ . . . 
@ . . . . . . @ @ . . @ @ . . . @ @ . @ . . . @ . . . . . . . . 
. . . . . @ . . . . . @ . . . . . . . @ . . . . . @ . . . @ . . 
. . @ @ @ . . @ . . @ . . . @ @ . . . . . . . . . . @ . . @ . . 
@ @ . . . @ @ . . . @ . . @ . @ . . . . . . . @ @ . . . . @ . . 
. @ . . . . @ . . . . @ . . . @ . . . . . @ . . . . . . . . @ @ 
. . . . . . . . . . @ . . . . . . . . . . . . @ . . . . . . . @ 
. . . . . . @ @ . @ . . . . @ . . @ . . . . . . . . @ . . . . . 
. . . . . @ . . . . . . . . . . . . . . . . . . . . . @ . . . . 
. . . . . . @ . . . @ . . @ @ . @ . . . . @ . . . . . . @ . . @ 
. . . . . . . . . @ . . . . @ . . . . . . . . . . . . @ @ . . . 
. . . @ . . @ . . @ @ @ . . . @ . . . . . . . . @ . . @ . @ . . 
@ . . . . . . . . . . . @ . . . . . . . . . . @ . @ . . . . . . 
. . . . . . . . . @ . . . . . . . . . . . . . . . . . . . . . . 
@ . . . @ . @ @ . . . . . . @ . @ . . . @ . . @ . . . . @ @ . . 
@ @ . . . . . . . @ . @ . . . . . . . . . @ @ . . . . . . . @ . 
. . . . . . . @ . @ @ . . @ . @ . . . @ . @ . @ . . . . @ . . . 
@ . . . . @ . . . . . . . @ . . . @ @ @ . . . . @ . . . . . . . 
. . @ . . . . . . . . . . . . . . . . . . . . . . . @ . . @ . @ 
70
4 4 22 2
5 5 28 9
8 15 17 4
1 26 12 26
28 6 1 19
11 23 25 26
18 22 26 12
19 26 1 24
6 10 12 17
0 29 10 3
22 23 31 30
18 27 11 8
21 3 23 30
17 2 12 30
6 9 14 25
10 0 5 11
31 25 8 26
27 17 16 17
31 15 7 26
22 22 19 17
1 24 19 7
29 8 6 4
21 14 5 19
19 1 31 0
26 19 8 12
20 12 16 31
17 5 21 4
4 3 13 16
12 4 8 2
5 23 23 7
3 15 5 24
3 23 25 6
3 6 12 23
0 12 26 14
5 19 30 23
0 31 8 27
12 29 12 5
13 18 7 19
16 25 15 3
22 11 19 5
4 7 31 6
8 7 17 16
27 13 19 1
27 10 17 18
24 27 25 19
31 29 21 27
16 12 22 15
25 0 3 25
1 25 5 3
15 31 9 14
24 11 21 23
31 7 18 28
9 6 22 0
23 9 31 7
17 26 7 11
16 9 24 22
29 18 21 6
15 0 11 20
15 19 11 30
6 30 31 28
0 1 29 10
8 31 2 14
23 23 3 3
18 7 8 19
3 26 15 14
4 0 16 1
7 9 3 4
16 16 12 0
30 21 9 4
29 19 20 2
