32 32
@ @ . @ . . . . . . . . . . . . . @ . . . . . . @ . . . @ . . . 
. . . @ . . @ @ . . @ . . @ . . . @ . . . @ . . . @ . . . . . @ 
. . . . . . . @ . . @ . . . . . . . . . . @ @ @ . . @ . . . . @ 
. . . . . . . @ @ . . . . . . . . @ . . @ @ . . . . . . @ @ @ . 
. . . @ @ @ . . . . . . @ . . . . . . . . . . . . @ . @ . . . . 
. . . . . . . . . . . . @ . . . . @ @ . . @ . . . . . . . . @ . 
. @ . @ @ . . . . @ . @ . . . @ . . . @ . . . . @ . . . . . . . 
. @ . . . . . . @ . . . @ . . . . . . . . . . . @ . . . . . . . 
. . . . . . . . . . . . . . @ . @ . . . . . . . . @ @ . . . @ . 
. . . . @ . @ . . . . . . @ . . . @ @ . . . . . . . . @ . @ @ . 
. . . . @ . . . @ . . . @ . @ . . . . . . @ . . . . . @ . . . . 
. . @ @ . . @ @ . . . . . . . @ . . . . @ . . @ . . @ . . . . . 
. @ . @ . . . . @ @ . @ . . . . . . . . . . . @ . . . . . . . . 
. @ . @ . . . . @ . . . . . . . . . . @ . . @ . @ . . . . . . . 
. . . @ . . . . @ . . . . . . . . . @ . . @ . @ . . . . . . . @ 
. . . @ . . @ . . . @ @ . . . . @ . . . @ @ . . . . . . . . . . 
. . @ . @ . . . . . @ . . . @ . @ . . . . . . . . . . . . . . . 
. . @ . . @ . . . @ . . . @ . @ . . . . . @ @ . . . . . . @ @ . 
. @ . . . . @ . . @ . . . . . . @ . @ . . . . . @ . . . . . . . 
. @ . . . . . . . . . . . . @ . @ . . . . @ @ . . . @ . . @ @ . 
. . @ . . . . . . . . . . . . . . . . . . . . . @ . @ . . @ . . 
@ . . . . . . . . . . . . . . . . @ @ . . . . . . . @ . . . . . 
. . @ @ @ @ . . . . . . . @ . @ . . . . . @ . . . . . . @ . . . 
@ . @ . . . . . . @ . . . . @ . . . . . . . @ . . . . . @ . @ . 
@ @ . . . . . . . . . . . @ . . . . @ . . . . . . . . . @ . @ . 
. . . . . . . . . @ . . . @ . . . @ . . . . . . . . . . . . . @ 
. . . . . . . . . @ . . . . @ . . . . . . @ . . @ . . @ . . . . 
. . . . . @ . . . @ . . . . . . . . @ @ @ @ . . . . . . . @ @ . 
. @ . . . @ @ . . @ . @ . . . . . . . . @ . @ . . . @ . . . . @ 
. . @ . . . . . . . . . . . . . @ @ . . . . . . . . . . . . @ . 
. . . . . . . . . . . . @ . @ . . . . . . . @ . @ . @ . . . . . 
@ . . . . . . . . . . . . . . @ . . . . @ @ . . . @ @ . . . @ . 
20
20 21 26 17
10 30 10 28
7 26 15 16
15 16 1 11
24 31 16 13
7 14 0 17
3 7 23 28
20 1 25 2
14 31 6 25
18 2 9 4
18 1 8 19
21 20 15 4
17 19 16 31
28 6 25 6
7 8 0 20
28 31 18 17
12 31 26 22
9 15 5 1
14 15 11 1
0 29 13 0
