32 32
. . . @ @ @ . . . . . . @ . . . . . @ . . . . . . . . @ . . . . 
@ . . . @ . @ . . . . . @ . . . . . . . . . . . . . . @ . . . . 
. . @ . . . . . . . . . . @ @ @ . . . . . . . @ . . @ . @ . @ . 
. . . . . @ . . . . . . . @ @ . . @ . . @ . . @ . . . @ . . . . 
. . . . . . . . . @ . . . @ . . . @ . @ . . . . . . . . @ @ . @ 
. . . . . . . . . . . . . . @ . . . . . @ @ . . . . @ . . @ . . 
. . @ . . @ . . . . . @ . . . . . . . @ @ @ . . @ . . . . . . . 
. . @ . . @ . @ . . @ @ . @ . . @ . . . @ . . . . . @ . . @ . . 
. @ @ . @ . . . @ @ . . . . . . . . . . . @ . . . . . . . . . @ 
. . . . @ @ @ . . @ . . . @ . . . . @ . . . @ @ . . . . . . . . 
@ @ @ @ @ . . . . . . . . @ @ . . . . @ . . . . @ @ . . @ . . . 
. . . . . . . . . . . . . @ . . . . . . . . . . . . . . . @ . . 
@ . @ . . . . . . . . @ . . . . . . . @ @ . . . . . . . . . @ . 
. . @ . . . . . . . . . @ . . @ . . . @ . @ @ . . . . . . @ . . 
. @ @ . . . @ @ . . @ @ @ . . @ . @ . . . . . . . . . . . . . . 
. @ . . . . @ . . @ . . @ . @ . . . . . @ . . . . . . . @ . . . 
@ . . . . . . . . . . . @ . . @ @ . . . . @ @ . . . . . @ . . . 
@ . . . @ . . . . . @ . . @ . . . . . . . @ . . . . . . . @ . . 
@ . @ . . @ . @ . . . . @ . . . . . . @ . . . @ . . . . . . . . 
. . . . . @ . . @ @ . . . . . @ . @ . . . . . . . @ . . . . . @ 
. . . . . . . . . . . . . . . . . . . . . . . @ . . . . . . . @ 
. . . . . . @ . . . . . . . . . . . . . . . @ @ . . . . . . . @ 
. @ . . . . . . . . @ . @ . . . . @ @ . . @ @ . . . . @ . . . . 
@ . . . @ . . . . . @ . . . @ . . . . . . . . . . @ . . @ . . @ 
. . @ . . . . . . . . . . . . . . . . . . . @ . @ . . . . . . . 
@ . . . . . . @ . . . . . . . @ . @ . @ . . . . . . . . . @ @ . 
@ . . . . . . @ . . . . . . . . . . . . @ . . . . . . . . . @ . 
. . . @ . . . . . . . @ . . . @ . . . . . . . . . . . . . @ . @ 
. @ @ . . . . . . . . . . @ . . . . . @ @ @ . . . . . . . . . . 
@ @ . . . @ . . . . . @ . @ . . @ . . . . . . . . . . . . . . . 
. . @ . . @ @ . . . . . . . . . . . . @ . . . . @ . . . . . . . 
@ . . . . . . . @ . . @ . . . @ . . @ . . . . . @ . @ . . @ . . 
40
31 11 11 11
4 21 7 10
1 13 8 15
11 17 21 23
27 13 20 8
21 9 21 7
26 11 9 10
17 30 27 25
8 6 25 31
20 10 27 31
25 5 20 23
22 19 14 4
22 20 8 30
28 19 12 20
14 14 10 21
0 19 29 0
26 13 21 21
7 23 8 7
3 4 27 26
10 2 11 13
9 27 30 20
24 7 16 19
18 30 7 9
17 8 15 29
1 25 7 21
9 17 0 21
29 8 16 26
0 14 16 30
14 4 5 26
27 26 24 2
29 3 21 31
17 2 20 27
28 6 5 21
21 24 10 8
18 28 2 20
12 10 23 0
23 17 25 1
19 0 23 16
20 30 18 23
3 21 12 11
