32 32
. @ @ . @ . . @ . @ @ . @ . . . . . . . . . . . . @ @ . . . . . 
@ . . . @ @ @ . . @ . . . . . . @ @ . @ . . . . . . . . . . . . 
. . @ . . . @ . . . . @ . . . . . . . . . @ . . . . . . . . . . 
. . . . . @ . . . . . @ . . . . . . . . . . . @ . @ . . . . @ @ 
. . . . . . . . . @ @ . . . . . . @ . . . . @ . @ . . . . . . . 
. . . . . . . . . . . @ . . . . . @ @ @ . @ . . @ @ . . @ @ @ . 
. . . @ . . @ . @ @ @ @ . @ @ . . . . . . . @ @ . . . . . @ . . 
. . . . . . . . . @ . . . . . . . @ . . . . . . . . . . . . . @ 
@ @ . . @ . . . . . . . . @ . . . . . . . . . . . . @ . . @ . . 
@ . . . . . . @ . . . . . @ . . . . . . . . . . @ @ . . . @ . . 
@ . . . @ . . . . . . . . . . . . . . @ . . . . . . @ . @ . . . 
. . . @ . @ @ @ . . @ . . . @ . . . . . @ @ . . . . . . @ . . . 
. @ . . . @ . . . . . @ . . . . . . @ . . . @ . . . . . . @ . @ 
. . . . . @ . . . . . . . @ . . . . . @ . . . . . . . . @ @ . . 
. . . . . . . @ @ . @ . @ . . . . . . . . @ . . . . @ . . . . @ 
. . @ . @ . . . . . @ . @ . . @ . @ . @ @ . . @ . @ . . @ . . . 
. . . @ . . . . . . @ . . . . . . . . . @ . . . @ . @ . . . @ . 
@ @ . . . . . . . . . . . . . . . . @ @ . . . . @ . . @ . . @ . 
@ . . @ . . . . . . . . . @ . . . @ . @ . . @ . @ . . . . @ . . 
. . . . . . . . . . @ . @ @ . . . . . . . . @ . . . . . . . . . 
@ . . . . . @ . . @ . . . . . . . . @ . . . . . . . . . . . . . 
. . . . . . . . . . . . . . . . . . @ @ . . . . . @ . @ @ . . . 
. . . . . @ @ . . . . . . . . . . . . . . @ . . @ . . . . @ . . 
. @ . . . . . . . . . . . . . . . . . . @ @ . . . . . . . @ . . 
. . @ . . . . . @ @ . . @ . . @ . . @ . . . @ . . . . @ @ @ . . 
. . . . . @ . . @ . . @ . @ @ . . . @ . . @ . . . . . @ . @ @ . 
. . . . . . . . @ . . . . . . . @ . . @ . . . . @ . . . . . . . 
. @ @ . . . . . . . . . . @ . . . @ . . . . . . . . . . . . . . 
. . . @ . . . . . . . . . @ . . . @ . . . . . @ . . @ . . @ . . 
. . . . . . . . . . . . . @ . . @ . @ . . . . . . . @ . . @ . @ 
. . . . . . . . . . . . @ . . . . . . . @ . . . . . . @ . . . . 
. @ . . . . . . . . . . . . @ . . . @ . . . . . . @ . . @ . . @ 
70
13 0 28 6
13 24 31 10
28 19 23 31
13 21 6 3
15 21 4 14
11 27 7 4
14 28 19 9
24 13 8 12
7 12 21 20
13 20 17 21
20 31 17 9
18 16 9 13
13 4 4 13
3 0 5 4
24 29 14 14
31 4 6 31
13 12 14 17
22 0 7 28
14 0 8 16
29 31 25 23
9 5 14 28
21 9 12 28
1 24 17 20
9 17 25 29
29 11 27 3
10 25 3 22
18 22 29 27
1 21 14 4
24 21 9 26
18 30 22 17
26 5 17 17
17 22 8 13
25 26 27 29
12 25 2 6
19 7 21 17
1 7 17 29
15 16 22 21
28 2 11 27
19 19 20 19
29 4 13 24
12 31 1 5
28 3 27 5
9 25 0 29
9 11 27 18
21 13 16 19
21 19 1 11
13 16 3 14
6 26 11 11
2 17 26 2
8 4 8 27
24 12 15 2
7 5 1 18
15 26 30 1
7 3 3 27
21 10 21 10
30 22 23 25
15 19 28 14
12 7 9 17
10 7 1 26
9 27 19 3
8 19 10 26
24 15 1 7
1 29 0 27
20 18 19 25
2 10 27 0
2 6 24 21
30 23 20 28
17 29 21 27
14 2 7 15
16 5 0 30
