32 32
. @ . . . @ @ . @ . . . . @ @ @ . . @ @ . . . . @ @ @ . . . . . 
. . . . . . . . @ @ . . . @ . . . @ . . @ @ . . . . . . . . . . 
. . . . . . . . @ @ . . . . @ . . @ . . . . @ @ @ . . . @ . @ . 
. . . . @ . . . @ . . . . @ . . . . . . @ . . . . . . . . . @ . 
@ . . . . . . . . . @ . . . . . . @ . . . @ . . . @ . @ . . . @ 
. . . . . . @ . @ . . @ . . . . . @ . . . @ @ . @ . . . @ . . . 
. . . . . . . . . . . . . . . . @ . @ @ . @ . . @ . . . @ @ . . 
. . . . @ . @ . . . @ @ . . @ . . . . @ . . . . @ . @ . . @ . @ 
. @ . . . . . . . . . . @ . @ . . . . . . . @ @ . . . . @ @ . @ 
@ . . . . @ @ . . . @ . . . . . . . . @ . . . . . . . . . . . . 
. . . . @ @ . @ . . . . . @ . . . . @ @ . . @ . . . . . . . . . 
. . . @ . . . . @ . . @ . . . . . @ . . . . . @ @ . @ . . @ @ . 
. . . @ . . . . . . . . . @ . . . . . . . . @ . . . @ @ . . . . 
@ . . . . . . . . . . . . . . . . . . . . . . . . . . . . . . . 
@ . . . . . . . . . . @ . . . . . . . . . . . . . . . . . . . . 
. . . . . . . @ . . . @ @ . . . . . . . . . . . . . @ @ . . . @ 
. . . . . . . @ . @ . . @ . . . . . . . @ . . . . @ . . . . . . 
. @ . . @ . . . . @ @ @ @ . . . . . . . @ @ . @ . . . . . . . . 
. . . . @ . . . . . . . . . @ . . @ @ . . . . . . . . . . . . . 
@ . @ . . . . @ . @ . . . . @ . . . @ . . . . . . . . . . . . @ 
. . . . . . @ @ @ . . . @ @ . . . . . . . @ . . . . . . . . . . 
@ . . . . . @ . . @ . . . @ . . . . . . . . . . . . @ . . . . . 
. . . . . @ . . @ . . . . @ . . . . . @ . @ . @ . . . @ @ . . . 
@ . @ @ . . @ . . . . . @ . @ . @ . @ . . . . . . . . . . . . . 
. . . . @ . . @ . . . . . @ . . . . . . . . . @ . . . . . . . . 
. . . . . . @ . . @ . . . . . . . . . . . . . @ @ . @ . . . . . 
. . . . . . . . . . . . . . . @ @ . @ . . . . . . @ @ . . . . . 
. @ . . . . . . @ . . @ . . . . . . . . . . . . . . . @ . @ @ @ 
. . . . . . . @ @ . . @ . @ . . @ . . @ . . . . . @ . . @ . . @ 
. . @ . . . . . . . . . . . . . @ . . . . . . . . . @ . . . . . 
. . . . . . @ . . . . . . @ . . @ . . . . @ . . . . . . . . @ . 
@ @ . . @ @ . . . . . . . @ . @ . . . . . . . . @ . . . . . . . 
40
0 22 18 8
24 1 14 28
23 20 30 29
10 20 3 0
4 21 20 19
17 26 9 28
28 29 7 21
26 6 0 18
14 25 29 17
28 7 22 31
9 29 27 0
1 14 8 9
9 3 10 5
23 23 12 6
29 16 5 13
24 14 8 29
13 15 13 13
9 26 16 8
0 26 16 21
7 3 24 24
28 3 11 13
0 2 17 31
25 9 5 29
1 29 19 18
16 8 2 13
17 21 3 20
1 30 7 1
11 6 9 31
5 14 9 20
3 21 10 20
0 17 8 12
25 17 4 6
22 17 1 2
7 5 15 11
16 4 7 7
24 18 14 9
4 13 23 1
25 6 19 25
18 16 6 22
12 9 0 24
