32 32
. . . . . . . . @ . . @ . . @ . . . . . . . @ @ . . . . @ . @ . 
. . . @ @ . . . . . . . . . . . . . . . . . @ . . . . . @ . . @ 
. . . . . . @ . . . @ . . . . . . @ @ . . @ . . @ . . . @ . . . 
. . @ . @ . . . . . . . . . . . . . . . . . . . . . . . . . . . 
. @ . @ . . @ . . . @ . . . . @ @ . @ @ . . . . @ . @ . . . @ . 
. @ @ . . . . @ . @ . . . . . . . . @ @ . . . . . . . . . . . . 
. @ . . . . . . . @ . . . @ . . . @ . . @ . . @ . @ . @ . . @ . 
. . . . . @ @ . . . @ . . . . . @ . . . @ . . . . . @ @ . @ . . 
. . . . . . . @ . . . . . . . . . @ . @ . . . @ . . . . . . @ . 
. @ . @ @ @ . @ . . . @ . . . . @ . . . @ . . . . . @ . @ . . . 
@ . @ . . . . . . . @ . . . . . . . . . . . @ @ . . . . . . . @ 
. . . . . @ . @ @ . . . . . @ . . . @ @ . @ . @ . . @ . . . . @ 
. . . . . . . @ @ . . . . . @ @ . . @ . . . . . @ @ . . . @ . . 
. . . . . . . . . . . @ . . . . . @ . @ . @ . . . . . . . . . @ 
. . . . . . . @ . . . . . . @ @ . @ . . . @ @ @ . . . . . . . . 
. . . . . . . @ @ @ @ . . . @ . . . . . . . . . . @ . @ . . . . 
. . . . @ . @ . . . . . . . @ . . . . . @ . . . . . . . . . . . 
. . . . . . . . . . . @ . . . . . . . . . . . . . @ @ @ @ . . . 
. @ . . . . . @ . @ @ . . . . . . . . . . . . . . . @ . @ @ @ . 
. @ . @ @ . . . @ . . . . @ . @ . . . . . . . . . . . . . . . . 
. . . @ . . . . . . . . . . @ . @ . . . . . . . . . @ . . . . @ 
. . @ . . . . . . . . . @ . . . @ . . . . . . @ . @ . @ . . @ . 
. . . . . . . @ . . @ . . . . . . @ . @ . . @ . @ . . . . . . . 
. . . . . . . . . . . . . . . . . . . . . . . . . . . . . . . . 
@ . . . . . . . . @ . @ . @ . . . . . . . . . . . . @ . @ . . . 
. @ . . . . @ . . . . @ . . . . . . . . . . @ . . @ . @ @ . . . 
. . . @ . . @ . @ . . . . . @ . @ . . . @ @ . @ @ . . . . @ @ @ 
. . . . . . . . . . . @ . . . . . @ . @ . @ . . . . . . . . . . 
. . . @ . @ . . . . . . . . @ . . . @ . . . . . . . . . . . . . 
. . @ . . . . . . . . @ . . . . . . @ . . @ . . . . . . @ . . . 
@ . . . . . . . . . @ @ . . @ @ . . @ . . . . . . . @ . . . . . 
. . . . . @ . . . . . . . . . . . . @ . . @ @ . . . . . . @ . . 
20
4 18 3 22
11 3 5 1
6 24 24 13
17 12 15 13
3 18 11 19
21 5 4 11
10 24 4 5
17 20 0 14
23 7 20 24
17 25 6 29
6 9 19 10
12 8 15 15
20 25 21 15
23 4 13 2
0 23 14 17
11 16 27 18
22 11 1 24
16 29 23 20
11 31 11 21
7 29 16 23
