32 32
@ . @ @ . . . . . . . . @ . . . . . . . . . . . @ @ . . . . @ @ 
. . @ . . . . @ . . . . . . . @ @ . . . . . . . . . @ @ . . . @ 
. . . . @ . . . @ . . . . . . . . . @ . . . . @ @ . . . . . . . 
. . . @ . @ . . @ . . . @ . . . . . . @ . @ . . . . . . . . . . 
@ . @ . . . . . . @ . . . @ @ @ . . . . . . . . . . . @ . . . @ 
. . . . @ @ . . . . . . . . . . . . . . . . . . . . . . . @ . . 
. . . . . . . @ . @ . . . @ @ . . . . . @ . . . . . @ . @ @ @ . 
. . @ . . . . . . . . . . . . . @ . . . . . . . . . . . . . . . 
. . . . . . @ @ . . . . . . @ . . . @ @ . @ . . @ . . . . . . . 
. . . . . . . . . . . . . . . @ . . . . . . . . . @ . . . @ . . 
. . . . . @ . . . . . . @ . @ . . . @ . . @ . @ . . . . . . @ . 
. . @ . . . @ . . . @ . . . @ . . . . . . . . . . . . . . . . . 
. . @ . . . . . . . . . . . @ . . . @ . . . @ @ @ . . . . @ . . 
. @ . . . @ . . . . . @ . @ . @ . @ @ . . . @ . @ . . . . . . . 
. . . . . . . @ . . . . . . @ @ . . . . . . . . . . @ . . . . . 
. . . . . @ . . . . . . . . . . . @ . . . . . @ . @ . . . . . . 
. . @ . . . . @ @ . . @ . @ . . @ @ . . . . . . . . . . @ @ . . 
@ . . . . . . @ . @ . @ . . . . @ . . . . . . . . . . . @ @ @ . 
. @ . . . @ . . . @ . . . . @ . . @ . . . . . @ @ . . . . . @ . 
@ . . . . @ . @ . . . . . @ . @ . @ @ @ . . . . . @ @ @ . . . @ 
. . @ . . . . . . . . . . . . . . @ . . . . . . . . . @ . @ . @ 
@ @ @ @ . @ @ . @ @ @ @ . . . . . . @ . . . . . @ . . . . . @ . 
. . . . . . @ . . @ @ . @ . . . . . . . . . @ @ . . . . . . @ . 
. . . @ . @ . . . . . . . @ . . . . . @ . . . . . . . . . . . . 
. @ . . . . @ . . . @ @ . . @ . . . . . . . . @ . . . . . . @ . 
. . @ . . @ . . . . . . @ . . . . . . . . . . . . . . . @ . . @ 
. . . . . . . . @ @ . . . . . . . . . . . . . . . . . @ . @ @ . 
. . . . @ . . . . . . . @ @ . . . @ . . . . . . . . . . . . . . 
. . @ . . . . . . . . . . . . . . . . @ . . . . . . . . . @ . @ 
. . . . . . . . . . . @ @ . . . . . . @ . . . . @ . . . . . . . 
@ @ . . @ @ @ . . . . . . @ @ . . . . . . . . . . . . . . . . . 
@ . . @ @ . . @ @ . . . . . . . . @ . @ . . @ . . . . @ . . . . 
30
3 29 28 30
28 18 21 7
16 9 0 2
28 5 28 27
30 31 18 29
2 10 15 26
15 22 14 23
12 19 18 6
12 18 14 28
0 9 30 8
25 10 7 10
28 22 30 28
12 28 11 10
26 30 0 5
29 23 4 24
8 5 8 5
22 5 13 3
11 20 22 17
16 11 8 1
31 5 26 16
30 11 29 4
28 10 8 9
24 25 6 13
0 29 16 10
12 6 26 2
8 9 19 26
29 19 16 12
0 13 8 25
19 27 11 18
25 12 23 23
