32 32
. . . . @ @ @ . . . . . . . @ @ . . . . @ @ . . . . . . . . . . 
. . . . . . @ . . . . . . . . . . @ . @ @ . . . . . @ . . . . @ 
@ @ . . . . . . . . . . . . . . . @ @ . . @ . . @ . . . . . @ . 
. . . . @ . . . @ . . . . . . @ . . . . @ . @ . @ . . . . @ @ . 
. . @ . . . @ @ . @ . . . @ . . . . . @ . . . . . . . . . . @ . 
. . . . . . @ @ . @ . @ . @ . . . @ . @ . . @ . . . . @ . . . . 
. @ . . . . . . @ . . @ . . @ . @ . . . . . . . @ @ . . . . @ . 
@ . . @ @ . . . . . . @ . @ . . . . . . . . . . @ . . . . @ . . 
. . . . . @ @ . . . @ . . . . . . . . . @ . . . . @ . . . . . @ 
. . . @ . . . @ @ . . . . @ @ . . . . . . . @ . . . . @ . . . . 
@ . . @ . . @ @ . @ @ @ @ @ . . . . @ . . . . . . @ . . . . . @ 
. . @ . . . . @ . @ . . @ . . . . . . @ . . . . . . . . . . . @ 
. . @ . . . @ . . . . . . . @ . . @ @ . . . . . . . . . . . . @ 
. . . . . . . . . . . . . . . . . . . . . . . . . . . . . @ @ . 
. . . . . . @ . . . . @ . @ . . . . . . . . . . . . . . . . . . 
. . . . . . . . . . . . @ . . . . . . @ . . . . @ . . . . . . . 
. . . . . . @ . @ . @ . . . . . @ . @ . . @ . . . . . . @ . . . 
. . . @ . @ . . @ . @ . . . . . @ . . . . . . . . @ . @ . . . @ 
. . . @ . . . . . . . . @ . @ . . . . . . . . . . @ . . . . . . 
. . . . . . . . . . . @ . . . . @ . . . . . . . . @ . . . . . . 
. . . . . @ . . @ . . . . . . . . . . . . @ . . . . . . . @ . . 
. . @ . . . . . . @ . . . . . @ . . @ . . @ . . . @ . . . @ @ @ 
@ . . . . . . @ . . . . . . . . @ . . . . . . . . @ . . . . . . 
. @ . . . . @ . . . @ @ . . . . . . . . . . . . . . . . . . . @ 
. . . . . . . . . @ . . . . . . . @ . @ . . . @ . . . . . . . . 
@ . . . @ @ . . . . . . . . . @ . @ . . . @ . . . @ . . @ @ . @ 
. . . . . . . @ . . @ . @ . . . . . @ . . . . . . . . . . . . . 
. . . @ . . . . . . . . @ . . . . . @ . . . . . . . @ . . @ @ @ 
. . . . . . . . @ . . . . . @ . . . . . . . . . . . . @ . . . . 
@ @ . . @ . . . . @ @ . . . . . . @ . . @ . . . . @ . . @ . . @ 
. . . . . . . . . @ @ . @ . . @ . @ . . . . @ . @ . @ @ . . . . 
. . @ . . . @ . . . @ @ . @ @ . . . . . @ . @ . . . . . @ . . . 
70
30 11 9 19
20 19 31 7
25 3 2 9
16 14 24 12
22 24 8 31
24 31 5 18
26 2 31 18
13 26 7 28
24 28 10 18
28 18 15 17
4 1 8 15
7 1 9 1
19 8 17 23
23 16 29 15
11 16 25 0
28 14 15 9
1 17 1 31
18 0 24 25
3 24 7 17
8 8 23 11
16 12 17 17
4 12 17 3
5 16 7 19
28 2 9 25
12 24 27 18
7 0 2 20
17 19 5 28
19 26 26 17
28 27 6 22
4 6 29 1
14 3 6 30
28 7 5 26
5 28 23 2
9 28 18 0
21 12 27 26
4 20 18 5
19 2 23 3
16 9 6 15
18 11 28 12
1 3 18 22
25 13 16 26
2 27 26 19
2 9 0 1
13 11 27 3
22 22 22 24
22 11 3 30
27 24 31 26
0 21 10 7
17 4 21 18
28 10 26 31
24 27 13 29
31 19 10 14
13 6 30 28
11 25 21 9
10 13 4 1
15 18 5 30
23 6 8 1
6 25 8 23
2 17 9 7
25 31 21 10
4 16 14 4
7 8 23 14
15 28 26 15
17 16 12 16
2 10 11 2
21 18 12 0
8 29 3 11
0 11 14 30
11 22 10 19
0 16 12 22
