32 32
. . . @ @ . . . . @ . . @ . . @ . . . @ . . . . . . . . . . . . 
. . @ @ . . . . @ . . . . . . . . . . . . . . . . @ @ @ . @ . . 
@ @ . . . . . . . . . @ . . . . . . . . . . . . . . . @ @ . . . 
. . . . . . . . @ . @ @ . @ . . . . . @ @ . @ . . . . . . . . . 
. @ . . . . . . . . . @ . . . . @ . . . . @ . . . . . @ . . @ . 
. . . . @ @ . . . . . @ . . @ . . . . . . @ . . @ @ . . . . . . 
. @ . . . . @ @ . @ @ . @ . . . . . . . . @ . @ . . . . @ . . . 
. . . . . @ . . . . @ . . . . @ . . . . . @ . . @ . . @ . . . . 
. . . . . . . . @ @ . . . . . . . @ . . . . . @ . . @ . . . . . 
@ . @ . . . . . @ . . . @ @ . . . . . @ . @ @ . @ . . @ . . . . 
. . . . . . . . . . . . . . . . . @ @ . . @ @ . @ . . @ . . @ . 
. . . . @ . . . . . . @ . @ . . . @ . . . @ . . . . . . . @ @ . 
. . . . . @ . . . . . . . @ . @ . @ . . @ . . . @ . @ . . . . . 
. . @ . . . @ . @ . @ . . . @ @ . . . . . . . . . @ . . . . @ . 
. . . . . . . . @ . @ . . . @ . @ . @ . . . . . . . . . . . . . 
. @ . . . . . . . . . . . @ . . . . . . . @ . . @ . . . . . . . 
@ . . . . @ . . . . @ . . . . @ @ @ . @ . . . . . @ . . . @ . . 
. . . . . . . . . . . . . . . . . . . . . . . . . . . @ . . . . 
@ @ . @ @ . . . . @ . . . . . @ . . . . . @ . . . . . . . . . . 
. . . @ . . @ . . . . . . . . @ . . . . . . @ . @ . @ . . @ @ . 
. . . . . . . @ . . . . . @ . . . @ @ @ . . . . . @ . . . . . . 
. . . . . . . . @ . @ . . @ . . . @ @ . . . . . . . . . . . . @ 
. . @ . . @ . . @ . . . . . . . . . . . . . . . . . . . . . @ . 
@ . @ . . . . . . . . . . . . . . . . @ @ . . . . . @ . . . . . 
. @ @ . @ . . . . . . @ . . . . @ . . . . . . . . . @ . . . . . 
. . . . . @ @ . . @ @ @ . . . . . . @ . . . . . . . . @ . @ . . 
. . . . . . @ . . . . . . . . . @ . . . . . . . . . . @ . @ . . 
. . . . . . . . . . . @ . . . . . . . . . . . . @ @ @ @ . . @ @ 
. @ @ . . . @ @ @ . . . . . . . @ . . @ @ . . . . @ . . . @ . . 
. @ . @ . . . . @ . . @ . . . @ . . . . . . @ . . @ . . . . . . 
. . @ @ . @ . . @ . . . . . . . . . . . . . . . . . @ . . @ . . 
. . . . . . @ . . @ @ @ . . . . . . . . . . . . . . . . . . . . 
30
9 21 11 6
12 3 8 6
2 14 28 9
29 22 15 2
9 28 3 26
21 26 6 24
17 7 14 7
4 20 0 10
18 11 15 1
29 4 0 13
16 31 30 20
28 16 18 29
17 0 26 11
3 6 4 15
4 3 8 23
2 11 19 14
12 21 14 26
11 17 22 4
25 11 2 14
29 29 14 18
14 23 30 3
5 1 12 25
11 28 31 26
4 6 21 31
13 23 18 16
20 20 26 2
8 5 8 20
22 8 22 20
23 24 4 3
27 3 10 19
