32 32
. . . . @ . . . @ . . . . @ . . @ . . . . @ . @ @ . @ . . . . . 
. . . . . . . . . . @ . . . @ . @ . . . . . . . . @ . . . . . . 
@ @ . . @ . . @ . . @ . . . . . . . . . . . . . . . . . . . . . 
. . . . . . . . . @ . . . . @ . @ . . @ @ . . . @ @ @ . @ . . . 
. . . . . . . . . . @ . . @ . . @ @ @ . @ . . . . @ . . @ @ . . 
. . . . . . . . @ . . @ . . . . . . . . . . @ . . . . . . . . . 
. @ . . . @ . @ . . . . . . . . . . . . . . . . . @ . . . . . . 
. . . . . @ . . . . . . . . . . . . . @ . . . . . @ . . @ @ . @ 
. . . @ . . . . . . . . . . . . @ . . @ . . . . . @ . . . . . . 
. @ . @ . @ . . @ . . @ @ . . . @ . . . @ . . @ . . @ . . . @ . 
. @ @ . @ . . . . . . . . . . . @ . . . . @ . . . . . . . . @ @ 
@ . @ @ . . . . . . . . . . . . . . . . . . . . . . @ @ . . @ . 
. . . . . . . . . . @ . . . @ @ . @ . . . . . @ . . . . . @ @ . 
@ . @ . . . . . . . . . . @ . . @ . . . . @ . . . . . . . . @ . 
@ . @ @ @ . . @ @ . @ . @ @ . @ . . . . . . . . . . . . . @ . . 
. @ . . . . . @ . . @ . . . . . . @ @ @ @ . . . @ . . . @ . . . 
. . . . . @ . . @ . . . @ . . . . . . . @ @ . . @ . . . @ @ . @ 
. . . . . . @ . . . . . . . . . . . . . . . . . . . . . . . . . 
. . . . . . . . . . . . . . . @ @ . . . @ . . . @ . . . @ @ . . 
. . . . . . . . @ @ . . @ . . . @ . . . . . . . . . @ . . . . . 
. . . @ . @ . . . . . @ . . . . . . . . . . . . . . . @ . . . @ 
. . . . . . @ . . . . . . @ . . . . . . . . . . . @ @ . . . . . 
. . . @ . . . . . @ . . . . @ . . . @ . . . . . . @ . . . . . . 
. . . @ . @ . . . . @ . . . @ . . . @ . . . . @ . . . . . . . . 
. . . . @ . . . . . . . . . . . . @ . . . . . . @ . . . . . . @ 
@ @ @ . . . . . . @ . . . . @ . . . . @ @ . @ . . . . . . . @ . 
. . . . . . @ . . . . . . . . . . . . . . . @ . . . @ . @ . . @ 
. . . @ . . . . . . . . . . . . @ . . . . @ . @ @ . . . . . . @ 
. . . . . . . . . . . @ @ . . . . @ . . . @ . . @ . . . . . . @ 
. @ . . @ . . . . @ . . @ . . . . @ @ . @ . @ . . . . . @ . @ . 
. . . . . . . . . @ . . @ . . . @ . . . . @ . . . @ . . @ @ @ . 
@ . . @ . . . . @ . . . @ . . . . @ . @ . . . . . . . . . . . . 
10
8 30 9 24
17 18 23 15
16 14 31 1
25 19 11 11
28 2 31 21
1 26 1 3
31 1 15 6
18 19 10 7
17 21 12 25
23 5 5 13
