32 32
. . . @ . . @ @ . . @ . . @ . . . . @ @ . . @ @ . @ . . . @ . . 
. . @ . . . @ . . . . . . @ @ . @ @ @ . . . . . . . . . . . . . 
. . . . . . @ . . . @ @ . . @ . . . @ @ @ . @ . . . . . . . . @ 
. . . . . . . . . @ . . . . . @ . . . . . @ . . @ . @ . . . . . 
. . . . . . . . . . . . . . . . . . . . @ . . . @ . . . . . . . 
. . @ . . . @ @ . @ . @ . . @ . @ . . . . . . . @ . . . @ . . . 
. . . @ . . . . . . . . . . . . . . . . . @ . @ @ . . . . . @ . 
. @ @ . . . . . . . . . . . . . . . . . . . . @ . . . @ . @ @ . 
. . . . . . . . . . . . . . . . . . . . . . . . . . . . . . . . 
. @ . @ . . . . . @ . . @ . . . . . . . . . . . . . . . . . . . 
. @ . . . . . . . . . . . . @ . @ . @ . . . . . . . . . . . . @ 
. . . . . . @ . @ . . . . . . @ . . . . . . . . . . . @ . . . . 
. . . . @ . . . . . . . . . . @ . . . . . @ . . . . . . . . . . 
. @ . . . . . . @ . . @ . . . . . @ @ . @ . @ . . . . @ . . . . 
. . . . . . . @ @ . . . . . @ . . . . . . . . . . . . . . . . . 
@ . @ . . . . . . . . . . . . @ . . . . . . . . . . . . . . . @ 
@ . . . . @ . @ . . . . . . . . @ . . . . @ . . . . @ . . . . @ 
. . . . . . . . . . . . . . . . . . . . . . . . @ . . . @ . . . 
. . @ . . @ @ . . . @ . @ . @ . . . . @ @ . . . @ @ @ @ . . @ @ 
@ @ . . . @ . . . @ . . . @ . . . . . . @ . . . . @ @ @ @ . . . 
. . . @ . @ . . @ . . . @ . . . . . . @ . @ . . . . . @ . @ @ . 
. @ . . @ . . . . . . . @ . . . . . . . . . . @ . . . . . . . . 
@ @ . . . . @ . . . . . . . . @ . . . . . . @ . . . . . . . . @ 
@ . . . @ . . @ @ . . . . . . . . . . @ . @ @ . . . @ . . . @ . 
. . . . . . @ . . . . @ @ . . . . . @ . . . . @ . . @ . . . @ . 
. . . . . . . . . . @ . . @ . . . . . . . . . . . @ . . . @ @ . 
. . . . . @ . . . . . . . . . . . . . . . . . . . @ @ . . . . @ 
. @ . . @ . . . . . . . @ @ . @ . . . . . . . @ . . . . . . . . 
. @ . . . . . @ . @ @ . . . . . . . . @ . . . @ @ . @ @ . . @ . 
. @ . . . . . @ . . . . @ . . . . @ . . . @ . . . . . . . @ . . 
. . @ @ . @ @ . . @ . . @ . . @ . . @ . . . . . . . @ . @ @ . . 
. . @ . . . . . . @ . . . . @ . . . . . . @ . @ @ . . . @ @ . @ 
30
5 5 16 6
29 26 19 4
27 2 22 12
31 3 17 5
3 3 11 16
6 16 16 22
2 29 26 13
30 5 17 27
9 2 23 26
4 8 26 7
13 16 10 20
26 17 0 29
2 24 28 25
5 7 5 10
6 28 16 19
28 18 25 27
10 4 26 4
3 18 20 21
10 24 14 27
19 19 18 16
17 22 27 15
10 9 7 2
1 15 18 3
8 28 2 6
26 8 22 3
29 27 3 7
13 14 29 17
7 26 20 31
8 12 12 19
5 10 12 26
