32 32
. . . . @ . @ @ . . . . @ . . . . . . . . . . . . . @ @ . @ . . 
@ . @ . . @ . . . . @ @ @ . . . . . . . @ . . @ @ . . . . @ @ . 
. . @ . . . . . . . . . . . . . . . . . . . . @ . . . . . . . . 
. . . @ . . . . @ . @ . . . @ . . . . . . . . @ @ . . . . . . . 
@ @ . . . . @ . @ . . . . . . @ . . . @ . . . . @ . @ . @ . @ . 
@ . . @ . . @ . . @ . @ . . @ . . @ . . . @ . . . . . . . . . . 
. . . . . . . @ . @ . . . @ @ . @ . @ . . @ @ . . @ . . . . . . 
. . . . @ . . . . . . . . @ . . . . . . . @ . . . . @ . . . @ . 
. . . . . . . @ . @ @ . . . . @ @ @ . @ . . . . . . @ . . . . @ 
. . . @ . . . . . @ . . . @ . . . . @ . . . . . . . . . . . . @ 
. . . . . . . . . . . . . . . . . @ @ . . . . . . @ . . . . @ . 
. @ @ @ . @ . . . . . . . . . . @ . @ . . . . @ . . . . . . . . 
. @ @ @ . . . @ @ . . . . @ . . . . . . . . . @ @ . . . . . . . 
. . . . . . . . . . @ . . . @ @ . @ . . . . . . @ @ . . @ . . @ 
@ . . @ . . . . . . . . . . . . . . . . . . @ @ . . . . . . @ . 
. . . . . @ @ . . . . . . . . @ . . . . . . . . . . . . @ . . . 
. . . . . . @ . . . . . @ @ . . @ . @ . . . @ . @ . . . . . . . 
. . @ . . @ . . . . . . @ . . . . . . . . . @ . @ @ . @ . . . . 
. @ . . . . . . . @ . . . . @ . . @ . . . . . . . . . . . . . . 
@ . . . . @ @ . . . . . . . . . @ . . . . @ . @ . . . . @ . . . 
@ . . . . @ . . . . . . . . . @ @ . . @ @ . . . @ . . . . @ @ . 
. . . . . . @ @ . . . . . . . . . . . . . . . . . . . @ . . . @ 
. . . . . . . . . . . . @ @ @ . . . . . . . . . . . . . @ . . . 
. . . . . . . . @ @ . . @ . . @ @ @ @ . . . . @ . . . @ . @ . . 
. . . . . . . . . . . @ . . @ @ . @ . . . . . . . . @ @ . . @ . 
@ . . . . . . . @ . . . . . @ . . . @ . @ . . . . . . . . . @ . 
. . . . . . . . . . . . . . . . . . @ . . . . . @ . @ @ . @ . @ 
. . . @ . . @ . . . @ @ . . . . . . . . . . . . . . @ . . . . @ 
. @ . @ . . . @ . . . . . . . @ . . . . . @ . . . . . . . . . @ 
@ . . . . . . . . @ . . . . . @ . . . . . . . . . . . . . . @ . 
. . . . . . . . . . . @ @ . . . . @ . . . . . . . . @ @ . . . . 
. . . . . . . . @ @ . . @ . . @ . . . . . . . . . . . . . . . . 
90
22 22 23 16
5 26 15 19
22 7 4 28
8 6 31 1
30 19 19 24
18 30 16 24
30 28 2 13
24 11 31 25
30 18 17 16
0 2 26 31
19 10 0 30
3 8 31 6
17 9 24 29
11 21 22 10
23 31 23 30
0 21 4 27
21 14 15 14
25 19 4 31
31 4 22 26
23 26 9 16
16 31 31 19
18 21 27 22
7 19 9 0
7 18 8 9
12 6 5 13
1 23 15 11
0 8 8 28
27 19 16 4
20 21 29 29
25 24 26 10
19 13 19 6
22 12 8 16
15 6 24 7
28 1 21 2
31 12 19 22
18 29 26 21
5 18 28 6
11 16 12 6
2 14 29 8
8 26 30 17
11 22 6 28
10 25 22 29
16 29 4 10
21 13 11 25
27 31 9 7
21 29 25 1
0 15 21 10
18 0 7 15
25 2 3 17
4 8 23 4
31 1 14 11
15 3 19 7
24 22 16 28
17 4 3 30
31 6 0 2
13 10 14 7
15 27 19 25
28 14 28 5
21 22 30 27
2 4 29 19
6 10 20 3
10 21 23 7
3 20 21 14
0 22 2 9
31 0 13 8
20 14 4 9
25 28 29 30
18 5 19 30
30 0 16 3
16 7 19 16
30 12 5 12
19 24 1 0
20 5 3 2
8 29 28 8
2 19 5 6
29 9 4 12
7 26 15 25
2 20 10 6
12 20 18 21
9 0 1 10
13 0 13 4
11 15 30 30
13 8 28 28
13 28 9 14
0 0 18 8
20 6 5 27
12 4 28 9
22 15 20 29
1 29 20 11
11 6 19 3
