32 32
. . . @ . . . . @ . @ . . . . . . . . . . . . . @ . @ . @ . . . 
. . . . @ . . . . . . . @ . . . . . . . . @ . . . . . . . @ @ . 
. @ . . . . . . . . . @ @ . . . . . . . . . @ @ . . @ @ @ @ . . 
. . . @ . . @ . . . . . . . . @ . . . @ . . . . @ . . . . . . . 
. . . . . . @ . . . @ . . . @ @ . . . . . . . . . . . . @ . . @ 
. @ . . . . . . . . . . . . . . @ . . . @ . . @ . . . . . . @ . 
. @ @ . . @ @ . @ @ @ . . . . . . . . @ @ @ . . . @ . . . . . . 
@ @ . . @ . @ . . @ . . @ . . . . . . . . @ . . @ @ . @ @ . . . 
. @ . @ . . . @ . @ . . . . . . . . . . @ . @ . . . @ . . . . . 
. @ . . . . . . . . @ @ . @ . . @ . . . . . . . @ . @ @ . . . . 
. . @ . . @ . . @ @ @ . . . . . . @ . . . . . . . . . . . . . . 
@ . . . @ @ @ . @ . . . . . . . . . @ . . . . @ . . . . @ . @ . 
. . . . @ . . . . . . . . . . . . . . @ . . . . . . . @ @ . . . 
. . . . . @ . @ . @ @ . . . . . . . . . . @ . . @ . . . . . . . 
. . . . . . . . @ . . . @ . @ . . . . @ . . @ . . . . . . . . . 
. . @ . . . @ . . . @ . . @ . . @ . . . . . . . @ . . . @ @ @ . 
. . @ . . @ . . . . . . . . . . . . . @ . . . . . @ . . @ . . . 
. . . . . . . . @ . @ . . . . @ . . . @ . . . @ . . @ . . . . . 
@ . . . . . . . . @ . . . . . @ @ . . . . @ . . . @ . . . . @ . 
. . . @ . . @ @ @ . . . . . . . . . . . . . . . . . @ . . . . @ 
@ . @ . . @ . . . . . . . . @ . @ . . . . @ @ @ . . . . . . @ . 
@ . . . . @ . @ . @ . . . . . . . . . . . . @ . . . . . . . . . 
. @ . . . . . . . . @ . . . . . . . . @ . . . . . @ . . . . . . 
. . . . @ . @ . @ . . @ . . . . @ @ . . . . . . . . . . @ . . . 
@ . . . . . . . . . . @ @ . . . . @ . . . . . @ . . . . . . @ . 
. . @ . @ @ . . . . @ . . . . . . . . @ . . . . . @ . . . . . . 
@ . . . . . . @ . . @ . . . . @ . . . @ . . . . . . @ @ . . @ . 
. . . @ . . . . . @ . . . . . . . . @ . . @ . . . . . . . @ @ . 
@ . . . . . . . . . . . . . . . @ . . . @ . . . . . . . . @ . . 
. . . . @ . . . . @ . . . . . @ . . . . . @ . . . . . @ . . @ . 
. . . . . . . . . . @ . @ . . . . . . . . . . . . . . . . . @ . 
. . . . . . . . . . @ . . @ . . @ . . . . . . . @ . . . . . . . 
70
5 4 22 13
3 28 12 27
6 10 18 29
11 20 18 8
11 7 6 0
16 4 5 19
9 0 14 27
14 9 18 14
6 21 28 24
7 15 12 3
16 29 0 0
9 24 17 26
2 22 13 16
11 11 3 11
21 8 16 0
13 5 9 30
21 3 2 23
4 21 15 16
16 10 12 22
24 21 28 26
21 28 6 24
4 0 9 12
23 25 30 12
24 10 21 31
8 2 17 1
26 3 23 18
20 18 1 18
8 8 7 5
4 6 9 20
12 9 17 5
18 8 26 10
25 8 26 21
4 28 21 21
27 0 22 10
17 31 21 10
28 6 28 17
20 26 28 10
11 21 3 31
27 8 0 29
6 25 17 19
25 19 6 5
20 10 23 13
24 8 31 17
18 13 16 4
18 10 2 11
5 26 19 20
28 30 7 24
9 15 13 7
8 22 3 23
17 17 24 23
10 20 29 10
2 4 6 20
14 24 3 15
25 12 25 1
6 5 17 21
23 7 25 2
14 21 8 7
4 10 22 6
6 27 7 23
7 4 14 10
6 8 20 4
14 3 21 11
9 12 8 16
28 31 6 10
1 26 6 22
11 25 8 25
20 19 27 30
2 31 21 3
23 30 4 8
18 2 3 4
