32 32
@ . . . . . . . . . . . . . . . . . . . . . . . . @ . . . @ . @ 
. . . @ . . . . . . . . . . . . . @ . . @ . . . @ . . . . . @ . 
@ . . @ . @ @ @ . . . . . . . . . @ . @ . . . . . . @ . . @ @ @ 
. . . . . . . . . . . . . . . . . . . . . . . . @ . . . . @ @ . 
. . . . . . . @ . . . . . @ @ . . . . . . . . . . @ . @ . . . . 
. . @ . . . @ . . . @ . . . . . . . . @ . . @ . . . @ . . . . . 
. @ . . . . . . . . . . . . @ . . . @ . . . @ . . . . . . @ . . 
. . . . @ @ @ . . @ . . . @ @ . @ . . . @ . @ . . . . @ . @ . . 
. . . . . . . . . . @ . . . . . . . . . @ @ . . . . . . @ . @ . 
@ @ . . . . @ . . . . @ . . . . . . . . . . @ . . . @ . . . . . 
@ . . . . . @ . . . . . . . @ . @ . . @ . . . . @ . . @ . . @ . 
@ . . . . . . @ @ . @ . . . . . . . . . . . . . . @ . . . . . . 
. . . @ @ . . . @ @ . . . @ . . . . . . @ . . . . . @ . @ @ @ . 
. @ . . @ @ . . . . . . @ @ @ @ . . @ . @ . . . . . @ . @ . . . 
. . . . . . . . @ . . . . . . . @ . . . . @ @ . . . . . @ . . @ 
. . . . . . @ @ . . . . . . . @ . . . . . . . . . . . @ . @ . . 
. @ @ . . @ . . . . . . @ . . . . . @ @ . . . . . . @ . . . . @ 
. @ . . . . . @ . . . . @ . . . . . . . . . . . . . . . . . . . 
. . @ . . . . . . . . . . . . . . . . . . . . . . . . . @ . . . 
. . @ . . . . . @ @ . . @ @ . . @ . . . @ . . . @ . . . . . . . 
@ . . . . . @ . . . . @ . @ . . @ . . . @ . . @ @ . . . . . . . 
. @ . . . . . . . @ . . . @ . . . . . . @ . . . . . . . . . . . 
@ @ @ . . . . . . . . . . . . . . @ @ . . . . . . . . . . . . . 
. @ . @ @ . . . . . . . . . . . . . . . . @ . . . @ . . @ . @ . 
. . @ . . . . @ . . . . . @ . . . @ . . . . . . . . @ . . . . . 
@ . . . . . @ . . . . . . . @ . . . . . @ . . . . . . . . . . @ 
. . . @ . . . . . . . . . . . . . . . . . @ . . . . @ . . . . . 
@ . . . . @ @ . @ . . @ . . . @ . . . . . @ . . . @ . . . . . . 
. . . @ @ . . . . @ . . . . @ @ @ . . . @ . . . . . @ @ @ . . . 
. . . . @ . @ . . . . . @ . @ @ . @ . @ @ . . . @ . . . . . . . 
. . . . . . . @ @ @ . . @ . . . . . . . . @ . . @ . . . . . . . 
@ . . . @ . . . . . . . @ . @ . . @ . . . . . @ . . . . . . @ . 
20
6 6 16 26
27 21 8 5
29 20 28 1
18 19 21 28
21 2 31 20
3 10 24 6
1 0 20 14
28 22 7 8
23 11 6 28
26 0 2 14
6 28 27 22
25 26 2 31
21 31 20 18
12 22 25 3
19 8 26 15
5 22 15 26
13 31 27 25
23 19 30 22
8 3 19 12
3 9 20 16
