32 32
. . @ . . . . @ . . @ @ . . . . . . . . . . . . @ @ . . . @ . @ 
. . . . . . . @ . . @ . . . . @ @ . . @ @ . . . . . . . . . . . 
. . . @ . . @ @ @ . . . . @ . @ . @ . . . . . . . . . . . . . . 
. @ @ . . . . . . . @ . @ . . . . . . @ . . . . . . . . . . . . 
. . . . . @ . . . @ . . . . . . . . . . . . . . @ . @ . . @ . . 
. . . @ . @ @ . . . . . . @ . . . @ @ @ @ @ . . . . . . . . . . 
. . . . . . . . @ @ . . . . . . . . . . . . @ . . . . . . @ . . 
. . . . . . @ . . . . . . . . . @ . . . . @ . . . . . . . . . . 
. . . . . @ . . . . . . @ . . . . @ . @ . . . . . @ . @ . . . . 
. @ @ . @ . . . @ . . . . @ @ . @ . @ @ @ . . . . @ . @ . . . @ 
. . . . . @ @ . . . . . . . . . . . @ . @ . . . . . . . . . . . 
. . . @ . . . . . . . . @ . . . . @ . @ . . @ . . . @ . . . . . 
. . . @ . . . . . . . . . @ . . . . . . . @ . . . . @ . @ . @ . 
. . . . . . . . . . . . . @ . . . . . @ . . . . . @ . @ . . . . 
. . . . . @ . . . . @ . . . . . . . . @ . . . @ . . @ . . . . . 
@ @ . . . . . . . . . . . @ @ . . . . . . . . . . @ . . . . . @ 
. @ . . . . @ @ @ . . . . . @ . . . . . . . . . . . . . . . . . 
. . @ . . . . . @ . . . . . @ . . . . . . . . . . . . . . @ . . 
. . . . . . @ . @ . . . . . . . @ . @ @ @ . . . . . . . . . @ . 
. . . @ . . @ . . . @ . . . . . @ . @ . . . . . . . . . . @ . @ 
. @ . . . @ . . . . @ . @ @ . . . @ . . . . . . . . . . . . . . 
. . . . @ . . @ . . . . . . . . @ . . . . @ @ @ . . . . . . @ . 
@ . . . @ . . @ . . . . . . . . . . . @ @ . . . . . . . . . @ @ 
. . @ . . @ . . . @ . . . . . . . . @ . @ . . @ @ . . . . . . . 
. . . . . . @ . . . . . . . . @ . . @ . . . . . . . . . @ . . . 
. . @ . . . . @ @ . @ . . . . . . . @ . . . @ @ . . . @ . . @ @ 
. . . . . . . . . @ @ . . . @ @ @ . . . . . . . . . @ @ . . @ @ 
. . . . . . . . . . . @ . . . . @ . . . . . . . @ . . . . . @ . 
. . @ . . . . . @ . . . . . . . . @ @ . @ . . . . . . . . . . . 
@ . . . . . . @ . . . . . . @ . . @ . @ . @ @ . . . . . @ . . . 
. . . @ . . . . @ . . . . . . . . @ @ @ . @ @ @ . . . . . . . . 
. . . . . . . @ . . . . @ . . @ . . @ . . . . @ @ . @ . @ . . @ 
60
3 1 20 11
6 30 3 16
14 21 28 4
1 7 21 2
14 23 15 5
18 16 12 0
5 3 8 29
28 7 26 30
28 8 1 21
31 7 27 31
25 10 30 5
25 5 27 29
11 14 2 22
26 5 26 16
4 6 25 14
27 24 24 10
5 1 19 21
8 13 17 26
20 26 26 8
21 0 4 13
4 1 24 15
15 7 25 16
4 17 1 2
5 30 7 3
21 8 24 26
0 6 17 25
14 12 6 26
23 24 9 13
8 23 0 8
9 7 1 29
22 8 25 12
14 4 0 7
4 13 21 13
11 29 19 2
10 30 0 27
4 18 27 11
21 18 22 5
21 24 30 3
10 15 3 10
4 19 31 7
6 13 31 16
22 9 17 14
12 23 0 18
1 25 18 13
15 17 27 19
7 28 4 19
28 17 5 1
24 8 8 10
14 19 16 23
18 21 12 18
13 1 12 30
2 30 5 19
10 4 8 27
5 0 4 18
18 26 30 10
27 0 31 4
29 31 23 26
2 12 7 20
18 17 25 29
11 28 8 5
