32 32
. . @ . @ . @ . . . . . . . . . . . . . . @ . . . . . . . @ . . 
. . . . @ . . @ @ . . . @ @ @ . . . @ . @ . . . @ @ . . . @ . . 
. . . . . . . . . @ . @ . . @ . . . @ . @ . . @ . @ . . . . . @ 
. . @ @ . . . . @ @ . . . @ . . . . . . . . . . . . . @ @ . . . 
. . . . . @ @ @ . . . . . . . . @ @ . . . . . . . . . . . . @ . 
. . . @ . . . . . . . . . . . . . . @ . . . . @ . . . . . . . . 
@ @ . . @ . . . . . . . . . . @ @ @ . . . . . . . . . . @ . @ . 
. . . . . . . . . . . @ . . @ . . . . . . . @ . . . @ . . . . . 
. @ @ . @ . . . . . @ . . . . . . . . . . . @ . . . @ @ . . @ . 
. . . . . . . . . . . . . . . . @ . . . . . . . . . . . . @ . . 
. . . . . . . . . . . . @ . . . . . @ . . @ . . . . . . . . . . 
@ . . @ @ . . . @ . . . @ . . . @ . . . . . @ . . . @ @ . . . . 
. @ . . @ @ . @ @ . . . . . . . . @ . . @ . . . . @ . @ . . . . 
. . . . . . . @ . . . . . @ . . . @ . . . . @ . . @ . . @ @ . . 
@ . . . @ . . . . . . . . . @ . . . . . . . . . . . . @ . . . . 
. . . @ . . . . . @ . @ . . . . . . @ @ . . . @ @ . . @ @ . . . 
. . @ . . . . @ . . . @ @ . @ . . . . @ . . @ . @ . . . . . . . 
@ . . @ . @ . . @ . @ . . . . . . @ . . . . . . . . . @ . @ . @ 
. . @ . . . . . . . . . . @ . @ . @ . @ . . . . . . . @ . . . . 
. . . . . @ . . @ . . @ . . . . . . . . . @ @ . . . . . . @ . . 
. . . . . . . . @ @ @ @ . . . @ . . . . . . @ @ . . . . @ . @ . 
. . . . . . . . . . @ . . . . . . . . @ . . . . . . . . . . . . 
. @ . . @ . @ @ @ . . . . . . . . . @ . . . . @ . . . . . . . . 
. . . . . @ . @ . @ . . . . . . @ . . @ . . . . . . . . . . . . 
@ . @ . . . @ @ . . . . . . . @ . . . . @ . . . . . . . . . . . 
. . @ . @ . . . . . . . @ . . . . @ . . . . . @ . . . . . . . . 
. @ . . . . @ @ . . . . . . . . . . @ . . @ . . . . . . . . . . 
@ . . . . . . . @ . . . . @ . . . . . . . . . @ . . @ . . . . . 
. . . . . @ . . . . @ . . . @ . . @ @ . @ . . . . . . @ . . . . 
. @ . . . . . . . . . @ . . . @ . @ @ . . . . . @ . @ . . @ . . 
. . . @ . . . . . . . . . . . . @ . @ . . . . . . . . . . . . @ 
. @ @ . . . . @ . . . . . . . . @ @ @ . . @ . . . @ . . . @ . . 
70
6 12 11 28
28 25 30 18
31 16 5 22
8 14 2 7
17 9 19 22
18 20 2 27
6 20 19 8
19 3 13 6
30 30 3 22
21 29 9 8
18 19 11 26
28 5 14 21
14 19 26 15
11 22 6 7
9 30 17 2
25 7 2 10
19 30 20 17
28 26 29 16
8 7 26 13
11 12 23 14
15 22 28 18
20 22 24 8
14 11 7 3
4 3 9 21
11 26 28 22
17 7 1 4
30 23 13 4
8 28 0 13
13 12 21 15
5 15 4 3
21 13 6 18
16 3 21 13
27 4 6 25
31 24 25 26
19 7 13 29
10 30 22 25
28 9 0 29
20 27 20 8
21 22 9 9
27 25 12 13
27 26 15 14
21 17 28 21
24 23 4 16
4 10 11 8
25 14 25 28
2 20 10 14
10 29 6 14
4 26 1 13
23 0 2 20
8 8 27 1
19 31 0 8
4 15 2 13
16 27 17 22
26 15 24 22
1 9 23 18
29 18 28 23
29 20 20 11
10 4 30 19
15 17 0 25
22 31 12 22
16 28 17 19
25 15 3 29
27 0 13 21
7 10 10 9
26 14 31 12
21 3 1 25
6 25 30 26
23 18 16 19
20 18 14 20
13 8 1 20
