32 32
@ @ . . . . . . . . . . . . . @ . . . . . @ . . . . . . . . . . 
. . @ . . . . . . . . . . . @ . . . . @ @ . . @ . . @ @ . . . . 
. . . @ @ . . . . . . . @ @ . . . @ . . @ . . . @ . @ . @ . . . 
. . @ . . . . . . . . . @ . @ . . . . . @ . . @ . . . . . . . . 
@ @ . . @ . . . . . . . . . . . . . . . . . . . @ @ . . @ @ . . 
. . . @ . . . . . . . . . . . @ . . . . . . . @ . @ . . . . . @ 
. . @ . @ . @ @ @ . . @ . @ @ . . . . @ . . . . . . . . . . @ . 
@ . @ . . . @ @ . . . . . . . . . . . @ . . . @ . . . @ . . @ . 
. . . . . @ . @ . . . . @ . . @ . . . . . @ @ @ . . . . . . . . 
. . @ . . . . . . . @ @ . . @ . @ . . @ . . . . . . @ . . . . . 
. . . . . . @ . . . . . . . @ . @ @ @ . . . . . . @ . @ @ . @ . 
. . . @ . . . @ . . . . . . . . @ . . . . @ . @ . @ . . . . . . 
. . . . . . @ . . @ . @ . . . . . . . . . . @ . . . . . @ . . . 
. @ . . . . @ . . . . @ . . . . . . . . @ . . . . . @ . @ . . . 
. . @ . . . . . . . . . . . . . . . . . . . . . . . @ . . @ . . 
. . . @ . . . . . @ . . . . . . . . @ @ @ . . @ . . . . . . . . 
. @ @ @ . . @ . . . . . . @ . . @ . . @ . . . @ . . . . . . @ . 
. . . @ . @ @ . . . . . . . . . . . . . @ @ @ . . . . . . . @ . 
. . . . . . . . . . . . . . . . . @ . . . . . . . . . . . . @ . 
. . . . @ . . . . . . @ @ . @ . . . . @ . . @ . . . . . . . @ . 
. @ @ @ @ . . . . . @ . . . . . . . . . . . . . . . . . . @ . . 
@ . @ . . . . @ . . . . . . . @ . @ . . . . . . . . . . . @ . . 
. . . @ @ . @ . . . . . . . . . . @ . . . . @ . @ . . . . @ . . 
. @ . . . . . . . @ . . . . @ @ . . . . . . . . . . . @ . . . . 
. . . @ . @ @ . @ . . . . . @ . . . . @ . @ . @ @ . . @ @ . . . 
. . . . . . . . . . @ . . @ . . . . . . . . . . . . . @ . . . . 
. . . @ . @ . . @ . . . . . . . . . . @ . . . . . . . . . . . . 
. . @ . . . @ . . @ . . . . . . . @ . . . . . . @ @ . @ . . . @ 
@ @ @ . . . . . . . . . . . @ . . . . . . . . . @ . @ . . . . . 
. . . @ . @ @ . . . . . . . . . . . . . @ . . . . . . . . . . . 
. @ . @ @ . @ . @ . . . . @ . . . . . . @ . . . . . . @ . . . . 
@ . . . . @ . . @ . . @ . @ . . @ . . . . . @ . . . . . . . . . 
20
27 6 9 20
30 23 0 5
19 21 10 4
17 1 17 8
20 9 20 12
25 1 17 24
29 16 9 28
2 4 23 20
14 16 5 25
17 28 0 13
25 14 10 11
22 6 25 17
14 4 11 27
17 9 16 3
10 24 29 9
6 11 13 17
5 7 29 15
15 19 0 24
23 20 4 9
17 17 29 19
