32 32
. @ . . . @ . . . . . . . . . . @ . . . . . . . . . @ . @ . . . 
. . . @ . . @ . . . . . . . . . . . . @ . . . . . . . @ . . @ . 
. . @ . . . @ . . . . . @ . . . @ . . @ . . . . @ . . . . . . . 
. . . . . . @ @ . @ . . @ . . . . . . . . @ . @ . . . . . . . . 
. @ . . . . . . . . . @ . . . . . . . . @ @ . . . . . . . . . @ 
. @ . . @ . @ . @ . . . . . @ . . . . . . @ . . @ . @ . . . . . 
. . . . . . . @ . . @ . . . . . @ . . . . . . . . . . . . . . . 
. @ . . . . @ . . . . . @ . . . @ . . . . . . . . . . @ @ . . @ 
. . @ . . . . . . . . . @ @ . . . . . @ @ . . . . . . . . . . . 
@ . . . . . . . . @ . . . . . . . . . . . . . . . . . . @ . . . 
@ . . @ . . . . @ . . . . . . @ . @ . . . . @ . . . . . . @ . . 
. @ . . . . . . . . . . . . . . . @ . . . . . . . . @ @ . . @ . 
. . . . . . . . @ . . . . . . . . @ . @ . . . . . @ . . . . . . 
. @ . . . . . . @ . . . . . . . . . . . . . . . . @ . . . . @ @ 
. . @ . . . . . . . . . . . . . . . . . . . . @ . . . @ . . @ . 
. @ . . . . @ . . . @ @ . . . . . . . . . . . @ . @ . @ . @ . @ 
. . . @ . . @ . @ . . . . . . . . @ . @ . . . @ . @ @ . . @ . . 
. @ . . . . @ . . . @ . . . . . . . . . . . @ . . . . @ . . . . 
. . . @ . @ . . . . @ . @ . . . . @ @ @ @ @ . . . . @ . @ @ . . 
. . . . @ @ . . . . . @ @ . . . @ . . . . . @ . . . @ . . . . . 
@ . . . @ . . @ . . . . . @ . . . @ . . @ . . . . @ . . . . . . 
. . . @ . . . . . @ . . @ . . . @ . . . . . @ . . . . @ . . . @ 
. . @ . @ . . . . @ . . . . @ @ . . . . @ @ @ . . . . . . . . . 
. . @ @ @ @ . . @ . . @ @ . . . . . @ . @ . . @ . . . . . . . . 
. . . . . . . . . . . . . @ . . . . . . . . @ . @ . @ @ . @ . . 
. . . . . . @ . @ . @ . . . . . . . . . @ . @ . . . @ . . . @ . 
. . . . . . . . @ . . . @ . @ . . . . . . @ @ . . . @ . . @ @ . 
. . . . . . . @ . . . . . @ . . @ . . . @ . . . . @ @ . @ @ . . 
. . . . . . . @ @ . . . . . @ @ @ . . . . @ . . . . . @ . . . . 
@ . . . . . . . . . . . . . . . @ . @ . . @ @ @ . . @ . . . . . 
. . . . . @ . . . . . . . . . . . . . . . @ . @ . . . . . . . . 
. . . . . . . . @ @ . . . @ . . . . . @ . . . . . @ . . . . @ . 
70
25 23 22 16
8 6 10 10
30 10 28 26
14 6 4 27
17 17 27 6
29 23 22 7
31 24 23 10
19 19 1 29
14 17 0 7
16 11 24 16
16 4 7 1
13 12 17 8
19 29 26 17
8 19 31 12
0 8 18 22
1 8 12 14
4 10 24 9
14 19 19 6
17 26 7 9
30 12 10 13
13 16 1 9
29 17 25 18
23 11 6 10
29 28 0 2
19 23 20 21
27 27 17 17
19 28 30 18
2 18 15 1
27 30 3 6
12 29 9 1
8 3 2 13
2 30 10 5
22 0 19 22
12 12 25 0
29 19 29 5
12 5 12 1
23 22 8 29
9 2 24 0
6 13 22 12
14 16 25 11
22 13 24 20
31 18 16 14
31 25 3 20
13 3 28 22
17 7 31 5
7 18 6 11
7 0 31 28
14 13 20 7
26 30 3 24
31 0 17 24
20 2 14 29
11 27 30 30
16 20 18 10
14 20 19 5
12 25 15 20
0 14 15 7
10 21 30 17
5 9 30 24
0 12 6 6
0 28 31 20
13 5 26 30
17 13 8 18
23 20 17 29
11 20 31 22
23 25 31 27
7 13 11 17
28 2 25 6
15 29 18 19
16 9 21 25
5 16 2 3
