32 32
. . . @ . . . @ . @ . . . . . . . . . . . . . . . @ . . . . @ . 
@ . . . . @ . . . @ . . . @ @ . . . . . . . @ . . . . . . . . . 
. @ . . . @ . . . @ @ . @ . @ . . . . . . . . . . . . . . @ @ . 
. . . . . . . . . . . . . . . . @ . . . . . . @ . . . . @ . . . 
. . . . . . . . . . . . . . @ . @ . @ . . @ . . . . . . . . . . 
@ . . @ @ . @ . . @ . . . . . . . . . . @ . @ . . . @ . @ . . . 
. . . . . . . . . @ . . @ . . . . @ @ @ . . . . . . . . . @ . . 
. . . @ . @ . . . . . . . . . . . . @ . . . . . . . . @ . @ @ . 
@ . . @ . . @ . . . . . . . . . . . @ . . . . @ . . . . . . . . 
. . . . . . . . . . . @ . . . @ . . . . @ @ . . . . @ . . . . . 
. . @ . @ . . . . . @ . @ . . @ . . . @ @ . @ . . . . . @ @ . . 
. . @ . . . . . . . . . . . . . . . . . . . . . . . . . . . . . 
. . . . . . . . . . @ . . @ . . @ . . . . . . . . @ . . . . . . 
. . . @ @ . @ @ . . . . . . . . @ @ . . . . . @ @ . . . . . . . 
. . . . . . @ . . . . . . . . . . . . . . . @ @ . @ @ @ . @ . . 
@ . . . . . . . . . . @ . . . @ . . @ . . . . . . . . . @ . . . 
. . . . . . . . . . . . . . . . . . @ . . @ @ . . . . . . . . . 
. @ . @ . . . @ . @ @ . . . @ . . @ @ . @ @ . . . . . . . . . . 
@ @ @ . . . . . . . . . @ . . . . . . . @ . . @ . . . . . . . . 
. @ . . . . @ @ . . . . . . . . . . . . . . . @ . . . . . . . . 
. . . @ . . @ . . . . @ . @ . . @ . . . @ . . @ . . . . . . . . 
. . @ . . . . . . . . @ . @ . @ . @ @ . . . @ . @ @ . . @ . . . 
@ . . . . @ . . @ . . . . . . @ . . @ @ . . . @ . . . . . . @ . 
. . @ . . . . . @ . . . . . . . . . . . . . . . @ . . . . . . . 
. . @ . . . . . . . @ . . @ . . . . @ . . . . @ . . . . . . . . 
. . . . . . . . @ . . . . . . . . . . . . @ . . . @ . . . @ . . 
@ . . @ @ . . @ . . . . . . . . @ @ . @ . @ . . . @ @ . . . . . 
@ @ . . . . . @ . . . . @ . . @ . . . . . @ . . . @ . . . @ . . 
. . . @ . . . @ . . . @ . . . . @ . . . @ . . . @ @ . . @ . . . 
@ . . . @ . @ . . @ . . @ . . . . . . . . . . @ . @ . . . @ . . 
. @ . . . @ @ . @ @ . @ . . @ . . @ . . @ . . . @ . . @ @ . . . 
. . . . . @ . . . @ . . @ . . . . . . . @ @ . . . . . . . @ . . 
40
30 21 16 31
18 28 8 16
19 16 28 29
0 10 20 14
13 5 1 6
20 25 15 24
28 23 7 21
23 11 28 1
12 22 6 18
11 4 30 17
29 23 6 15
26 12 5 4
26 11 27 2
17 9 17 7
14 10 5 23
14 14 20 1
28 31 18 3
24 22 13 13
11 0 8 11
19 20 1 21
11 29 1 20
30 11 5 11
23 10 6 26
2 7 22 19
5 0 12 21
19 25 28 0
16 7 6 10
14 7 9 8
31 28 31 19
14 28 12 5
26 30 26 31
31 19 22 30
3 27 6 3
17 1 0 28
6 31 7 7
13 2 0 30
7 14 31 20
1 14 17 29
13 26 21 15
23 6 9 12
