32 32
. . @ . . . . @ @ @ . . . . @ @ . . . @ . . . . . @ . . @ . . . 
@ . . . @ . . @ . . . . . @ . @ @ . . . . . @ . . . @ . @ . . . 
. . . . . @ . . . @ @ . . . . . . . . . . . . . . . . . . . . @ 
. . @ . @ . . . . . . @ . . . @ . . @ . . @ @ @ . . @ . . . . . 
. . . @ . @ . @ . . . . . @ . . . . @ @ . . . . . . . . @ . . . 
. @ @ . . . @ . . . . @ . . . . . . . . @ . . . @ . . . . . . . 
. . @ @ . . . . . . . . . @ . . . . @ . . @ . @ . . . @ @ @ . . 
@ . @ @ . . . . @ . . . . . . @ . @ . . @ @ . . . . . . . . . @ 
@ @ @ . . . . . . . . @ . . . . . . . @ . . . . . . . . . . . . 
. . . . . . . . . . . . @ . . . . . . . . . . . @ . . . . @ . . 
. @ . . . . . . . . @ . . . . @ . . . @ @ . . @ . . . . . . @ @ 
. . @ . @ @ . @ . . @ . . . @ . @ . . . . . . @ . . @ . . . . . 
. @ . @ . . . . . . . . . @ . . . . . . . . . . . . . . @ . . . 
. @ . . @ . . . @ . @ . . . . . . . . @ . @ . . . . . . . . @ . 
. . . . . . . . . . . . @ @ . . . . . . @ . . @ . . @ . @ . . . 
. . . . . . . . . . . @ . . @ . . . . . . . . . . . @ @ @ @ . . 
. @ . @ . . . . . . . . @ . . . . . . . . @ . . . . . @ . . . @ 
@ . . . . @ @ @ . @ . . . @ . . . . . @ . . . . . . . . . @ . . 
. . . . @ . @ . . . . . . @ . . . @ . @ @ . . . . . @ . . . . @ 
. @ . . . . . . . . . . . . @ @ . . @ . . . . @ @ . . . @ . . . 
. @ . . . . . . . . @ . . . . . . . . . . . @ . . . . . . . . @ 
. . @ . . . . . . . . . . . @ . . . . . . . . . . . @ . . . . . 
. . . . . . . . . . . @ . . . . . @ . . . . . . . . @ . . . @ . 
. @ @ . . @ . . . @ @ . @ . . . . . . . . . @ . @ . @ . . . @ @ 
. . . . . . . . @ @ . . . @ . . . . . . . . . . . . . . . . @ . 
. . . . @ . . . . . . @ . . @ . @ . @ . . @ . . . . @ . . . . @ 
. . . . . . . . . . . @ . . . . . . . . . @ . . . . . . . . . . 
. . . . . . . . @ . @ . . . . . . . @ . . @ . . . . . . . . @ . 
. . . . . . . . @ . . @ . @ . . . . . . . @ @ . . . . . . @ . . 
. . . . . . . . . . . . . . . @ . . @ . . . @ . . . . . . . . . 
@ . @ . . . . . . . . . . . . . @ . . . @ . @ @ . . @ @ . . . @ 
. . . @ . . . . . . . . . . . . @ . . . . @ . @ . @ . . @ . . . 
20
20 21 28 20
4 14 3 29
11 6 18 26
14 4 8 9
17 15 4 9
18 22 24 16
23 17 24 29
26 7 26 27
1 17 6 21
9 13 8 16
6 14 12 18
7 16 15 23
14 7 6 30
19 9 16 0
2 31 10 22
28 18 23 22
2 9 17 25
0 29 5 9
29 30 11 31
20 9 3 19
