32 32
. . . . . . . . . . . . @ . . . . @ @ . . . . . . . . . . . . . 
. @ . . @ . . . . @ . @ @ @ @ . . . . . @ . . . . @ @ @ . . . . 
@ . . . . . . @ . . @ @ . @ . . @ . @ @ . . . . . @ @ . @ . . @ 
. . . @ . . @ . . . . . . . . . . . . . @ . . . . . . . . @ . . 
. . . . . . . . . . . . . . . @ @ . . . @ @ . . @ @ . . . . . . 
. . @ . . @ . . @ @ @ . . . . . . @ . . . . . @ . . . . @ . . . 
. @ . @ @ . . . . . @ . . . . . @ . . @ . @ . . @ . . . . . . @ 
. . . . . . . . . . @ . @ . . . @ . . . . @ . . . . . @ . . . @ 
. . . . . . . @ . . . . . . . . . . . . . . . . . @ . . @ . . . 
@ . . . . @ @ @ . . @ @ . @ . . . . . . @ . . . @ . . . . . . . 
. @ . . . . . . . . . . . . . . . . . . . . . . . . . . . . @ @ 
. . . . @ . . . . . @ . . @ . . . . @ . . . . . . . . . . @ @ . 
. . . . @ . @ . . . . . . @ . . . . . . . . . . . . . @ . @ . . 
. @ @ . . @ . . @ . . . . . . . . @ . . @ . . . . . . . . . . . 
. . . . . . . . @ . . @ . . . . @ . . . . . @ . . . @ . . . @ @ 
. . . . . . . . . . . . . . . . . @ . @ @ . . . . . . . . . . . 
. @ . . . . . . . . . . @ . . . . . . . . @ . . . . . . . . . @ 
. . . . @ @ @ . @ . . . . . . . . . . . @ @ . . . @ . . @ . . @ 
. @ . . . @ . . . @ . @ . . @ @ @ . @ . . . . . @ . . . . @ . . 
. . . . . . . . @ . . . @ . . . . @ . . @ @ . @ . . . @ . . . . 
@ . . . . . . . . . . . . . . . . @ @ . . . . . @ @ . . . . . . 
. . @ . . . . . . . . @ . . . . @ @ . . . . . . . @ . . . @ . . 
. . . . . . . . . . @ @ @ . @ . @ . @ . . . . @ @ . . . . . . . 
@ . . @ . . . . @ @ . . . . . . . . . @ . . @ @ @ . . . . . . . 
@ . . @ . . . . . @ . @ . . . . . . . . . . . . . . . . . . . . 
@ . . @ . @ @ . . . @ @ . . . . . @ . . . . . . . . . . . . . . 
. . . . . . . . . . . . @ . . . . @ . @ . . . . . . . . @ . . . 
. . . . . . @ . . . @ . . . . . . . . . @ @ @ . . . . . . . . @ 
. . . . . @ . . . @ . . . . . . . . . @ . . @ . @ . . @ @ . . . 
. @ . . . . . . . . @ . . @ . @ . @ . . . . . @ @ . . . . . . . 
. . . @ . . @ . . . . @ . . . @ . @ . . . . . . . . . . @ . . . 
. @ . . . . . . . . . . . . @ @ . . . . @ . . . . . . . . . @ . 
20
18 8 18 17
8 31 3 26
3 17 16 28
15 6 13 15
3 15 15 20
22 11 5 21
27 14 7 16
30 9 26 29
25 3 2 23
0 31 10 4
9 0 3 12
19 7 31 1
9 7 13 22
13 28 26 20
10 10 0 8
13 27 3 7
27 5 4 9
20 8 8 29
25 22 3 17
26 31 24 31
