32 32
. . . . . . . . @ . . @ . @ . . . . . . @ . . . . @ . . @ . . @ 
. . @ . . . . . . @ . . @ . . . @ . . . @ . . . . . . . . . . . 
. . @ @ . . . . @ . . . @ . . . . @ . . @ . . . . . . . . . . . 
@ . . . . . . . . . . . . . . . . . . . . . @ . . . . . @ @ . . 
@ . @ . . . . . @ . . @ . . . . . . . . . . . . . @ . @ . . . . 
@ . . . . . . . . . @ . . . . . . . . . . . . . @ . . . . . . . 
. . . . . . . . . . . . . . . . . . . . . . @ . . . . . . . . . 
. . . . . . . . @ @ @ . . . . . @ . . . . @ . . . . . . . @ . . 
. @ . . . @ . . . @ . @ . . . . . . . . . . . . . . . . . . . @ 
. @ . @ . . . . . . . . . . . @ . @ . @ . @ . . . . . . . . . . 
. @ . . . @ @ . . . @ . . . . . . . . . @ . . . . . . . @ . . . 
. . . @ . . @ . . @ . . . . . . . . . . . . @ @ . . . . @ . . . 
@ . @ . . . . . . . @ . @ . . @ . . . @ . @ . . @ . . . . . . . 
@ . @ . @ . . . @ @ . . . . @ . . . @ . @ . . . @ . . . . . . . 
. . . @ . @ @ . . @ . . . . . . . . . . . . @ . . . . . . @ . . 
. . . @ @ @ . . . . . . . @ @ @ . . . . . . . . . . . @ . . . . 
. @ @ . . @ . . . . . . . . . . . . . . . @ . . . . . . . . . . 
@ . . . . @ @ @ . . @ . . . @ @ @ . @ . @ . @ . . . @ . . . . . 
@ . . . . . . . . . . @ . @ . . @ . . . . @ . . @ @ . @ . . . . 
@ . . . . . . @ @ . . . @ . . . . . . . . . @ . . . @ . @ . . @ 
@ . . . . . . . . . @ . . . . @ . . . . . . . @ . . . . . . . @ 
. . . . @ @ . . @ . @ . . . . . . . . . . . . . @ @ . . . . @ . 
. . . . . . . @ @ @ . . . . @ . . . @ . . . . . . . . . @ . . . 
. @ . . . . . . @ . @ . . . . . . . . . . @ . . . . @ @ . . @ . 
@ @ . @ @ . . . . . . . @ . . . @ . @ @ @ . . . . . @ . . . . @ 
. . . . . . . . . . . . . . . . . . . . @ . . @ . . . . . . @ @ 
@ . @ . . . . . . . . @ . . . . @ . . . . @ @ . . @ . . . . @ . 
. . . . . . . . . . . @ . . @ . . . . . . . . . . . @ . . . . . 
@ @ . . . . . . . @ . . @ . . . . @ . . . . . . . . . . . . . . 
. . . . . . . . @ . @ . @ . . @ . . . . . @ . @ . @ . . . . . @ 
@ @ . . . . @ . @ . . . . . . . @ . . . . . . . . . . . @ @ @ . 
. . . @ @ @ @ . . . . . @ . @ . . . @ @ . . . . . . @ . . . . . 
30
28 23 1 26
26 4 3 4
5 22 17 25
0 1 6 9
1 4 18 9
14 9 17 19
14 14 14 29
16 20 19 26
20 31 13 7
15 30 16 20
22 21 9 26
14 5 29 12
8 10 6 7
23 8 10 0
23 7 31 23
8 5 2 31
13 28 18 10
7 13 11 12
4 27 13 1
21 30 28 29
22 10 28 20
12 10 31 12
22 15 17 11
16 19 4 8
31 16 4 12
24 0 13 5
29 10 19 23
17 8 31 16
21 6 14 28
19 28 27 9
