32 32
. . . . . . . @ . @ . @ @ . . . @ . . . @ . @ . . . @ . . . . . 
. . . @ @ . . . . . . . . . @ . . . . . . . . . . @ . . . . . . 
. . . . . . . @ . . . . . . . . . . . . . . . . . . @ . . . . . 
. . . . . @ . . . @ . . . . . . . . . . . @ . . . . . @ . . . . 
. . . . . . . . . . @ . . . . . . . @ . . @ . @ @ . . . . . @ . 
. . . . . . . . . . . @ . . . . @ . . . @ . . . . @ @ . . @ . . 
. . . . . . . . . @ . . . . . @ . . . . . @ @ . . . . . . . . @ 
@ . . . . . . . . . . @ @ . . . @ . . . @ . . . . . . . . . . . 
. @ @ @ . . . . . . . . . . . @ . . . . . . . @ . . . . @ @ @ @ 
. . . . @ . @ . . . . . . . . . . . . . . @ . . . . . . @ . . . 
. . . . @ . . . . . . . . . . . @ . . . . . @ . . . . @ . . @ . 
. . . . @ . . . @ . . @ . . . . . @ . @ @ . . @ . . . @ . . . . 
. . @ . @ @ . . @ . @ @ . . . . @ . . . . @ . . . . @ . . . . . 
. . @ @ . . . . . . @ . @ . @ @ . . . . . . . . . . . . . . . . 
. . . . . . . . . . . . . . . @ . . . . . . @ @ . @ . . . . . . 
@ . . . . . @ @ @ @ . . . . . . . @ @ . . . . . . . . . @ . . . 
@ @ . . . . . . . . @ . @ @ . . . . . . @ @ . . . . . . . . @ . 
. . . . @ . . . . @ . . . . . . . @ . . . . . . . . . . . @ . @ 
@ . @ . . . . . . @ . . . . . @ @ . . @ @ @ @ . @ @ . . . . . . 
. @ @ @ . . . . @ . . . . . . . . @ . . . . . . . . . . . . . @ 
. . . . . . . . . . @ . @ . . . . . . @ @ . . . . . . . @ . @ . 
. . . . . . . @ . . @ . . . . . . @ . . . . @ . @ . . @ @ . . . 
. . @ . . . . . @ . . . . . . @ . . . . . . . . @ . . . . . . . 
. . . . @ . . . . . . @ @ . . @ . . . . @ . . . . . . . . . @ . 
@ . . . . . . . . . @ . @ . . @ . . . . . @ . . . @ . @ . . . . 
. . @ @ @ @ @ . . @ @ @ . @ . . . . . . . . @ . . . . . . . . . 
. . . . . . . @ . @ . . . . . @ . @ @ @ . @ . . . . @ @ . . . . 
@ @ . . . . . . . . . @ . @ . . . @ . . . . . . . . . . . . . . 
. . . . . . @ . . . . . . . @ . @ . . . . . @ . . . . . . . @ . 
. @ . . . . . . . . . . @ . . . . . . . @ . . @ . @ . . . . @ @ 
. . . . . . @ . . . . . . . . . . @ @ . . . . @ @ . . . @ . . . 
@ . . @ . @ @ . . . . . @ . . . . . . @ @ . . . . . @ . . @ . . 
10
17 6 4 31
2 4 18 11
6 4 31 10
6 29 29 21
31 26 11 10
24 12 18 17
23 25 31 2
4 3 9 8
11 8 31 11
29 7 4 22
