32 32
. . @ @ . @ @ . . @ . . . . . . . . . @ . . @ . . . . . . @ . . 
@ . . . . @ . . . @ . @ . . . @ . . . . @ . . . @ . . . . . . . 
@ . . . . . . . . @ . . . . . . . @ . . . . . . . . . . @ . . . 
. . . . . @ . . . @ . @ . @ . . . @ . . . . . . . . . . . . . @ 
. . . @ . . . @ @ . . @ . . . . . @ @ . . . @ . . . @ @ . . . . 
. . @ @ . . . @ . @ . . . . . . . . @ . @ @ . . . . . . . . . . 
. @ . . . . @ . . . . . . . . . . . . @ . . @ . @ @ . . . . . . 
. . . . . . . @ @ . . . . . . . . @ . . . @ . . @ . . . . . . . 
@ @ . . @ . . . . . . . . . . . . . . . . . . . . . . . @ . . . 
. @ @ . . @ . . . . . . . @ . . . . . . . . . . . . @ . . . . . 
. @ . . . . . . . @ . . . . @ . . . . @ . . . . . . . @ . @ @ . 
. @ . . . . . . . . . . @ @ . . . . . . . . . . . . . . . . . . 
. . @ . . . @ . . . . . . . . . . . . @ @ @ . . . . . . . . . . 
. . . . @ . . . . . . . @ . . . @ . . @ . . . . . . @ @ @ . . @ 
@ . . . @ @ . . @ . . . . . @ . . . . @ . @ . . . . . . . . . . 
. . . . . . @ @ . . . . . . . . . . . . . . @ . @ . . . . @ . . 
. @ . . . . @ . . . . . @ . . . . . @ . . . . . . . @ . . . . @ 
. @ . . . @ @ @ . @ . . @ . . . . . @ . @ . . . . . . @ . . @ . 
. @ . . . @ . . @ . . . . . . @ . . . @ . . . . @ . . . . . . @ 
. . . . @ . @ . . . @ . . @ . . . @ @ @ . . @ . . @ @ . . . . @ 
. @ . . . . @ . @ @ . . . @ . @ . . . . . . . . @ . . . . . . . 
. . . . . . . . . @ . @ . @ . . @ . . . . . @ . . . @ . @ . . . 
. . . . . . . . . . . . @ . . . . @ . . . @ . . . . @ . @ . @ . 
. . . . @ @ @ . . . . . . . . @ @ . . . . . . . . . . . @ . . . 
. . @ . . . . . @ . @ . . . . . . @ . . @ @ . . . . . . . . @ . 
. . @ . @ . . . @ . . . . . . . . . . . @ . . . . . . @ . @ . . 
. . . . . . . . . @ . . . @ . @ . @ @ . . . . . . . . . . . . . 
@ . . . . . . . . @ . . . . . . . . . . . . . . . . . . . . . @ 
. . . . . @ @ . @ . @ @ . . . . . . . @ @ @ @ . @ . . @ . . . . 
@ . . . . . . . . . . @ . . @ . . . . . . . . . . . . . . . . . 
. . @ . . . @ @ . . . . . . . . @ . @ . @ @ . . @ . . . . @ . . 
. . . . . @ . . . @ @ . . . . . . . . . . . . . . @ . . . . . . 
70
4 0 17 10
11 7 7 21
17 23 3 19
15 5 7 24
24 13 6 3
15 8 24 5
17 29 24 31
31 2 3 7
20 13 14 0
21 9 9 18
22 23 5 2
7 14 30 14
29 13 18 6
13 0 23 27
7 23 15 12
11 22 19 9
13 12 15 10
6 29 22 3
14 26 30 27
10 20 13 12
11 30 23 17
0 26 4 21
1 0 16 4
16 18 4 18
1 13 28 18
0 23 8 10
25 8 1 14
20 16 17 13
1 19 2 31
2 4 8 12
7 18 31 12
14 13 18 21
28 31 22 27
15 15 6 1
0 22 25 16
8 12 0 10
29 21 3 12
25 7 6 2
3 20 12 12
30 27 3 8
10 8 23 19
17 30 27 8
18 8 25 5
10 13 14 26
15 30 17 9
4 1 10 22
14 25 15 16
6 21 24 0
29 4 25 21
8 30 25 3
18 13 24 24
17 17 12 29
24 5 6 8
10 10 9 11
25 26 17 15
19 30 16 8
3 31 19 17
30 6 28 27
23 6 10 2
7 20 30 5
27 8 18 15
20 18 16 1
4 18 0 21
17 27 23 12
11 26 0 6
24 26 5 5
16 14 19 4
9 7 31 10
18 22 6 5
24 0 20 18
