32 32
. . @ @ . . . . . @ . . . . . . . . . . . . . @ . @ . @ @ . . . 
. . . . . . . . @ . . . . . . . . . @ . @ . @ . . . @ . . . @ . 
. . . . @ @ . . @ @ @ . . @ @ . . . @ . . . . . . . . . . . . . 
. . . . . . @ . . . . . . . @ . . @ . . . . . . . . . . . . . . 
@ . @ . . . . @ . . . . . . @ . . . . . . . . . . . . . @ . . . 
. . . . . @ @ . @ . . . . . @ @ . . . . . . . . . . @ . . @ . @ 
. . @ . . . . @ . . @ . . . . . . . . . . . . . . . . . . . @ . 
. . @ . @ . . @ . . . . @ . . . . @ . . . . . . . @ @ . . . . . 
@ @ . . @ . . . . . . . . . @ @ . @ . . . . . . @ . . . . . . @ 
. . . . . @ . . . . . . . . . @ . . . . . . . @ . . . @ @ @ . . 
. . @ . @ . . . . . @ . . @ @ . . . . @ . . . . . . . . @ @ @ . 
. . @ . . . . . . . . . . . @ . . @ @ . . . . @ . . . . . @ . . 
@ . @ . . @ . . . . . @ . @ . . . . @ @ . @ . . . . . . . @ . . 
. . . . . @ . . . . . . . . . . . . . . . . . . @ . . . . @ . @ 
. . . . . . . . . @ . . . . . . . . . . . @ . . . . . . . . @ . 
. @ . . @ . . @ . . . . . . . @ . . @ . . . . . . . @ . @ @ . @ 
. . @ . . . . . . . . . . . . . @ @ . @ . . . . . . . . . . @ @ 
. @ . . . . . . . . . . . @ @ . @ . . . @ . . . . . . @ . . . . 
. @ . @ . . . . . . @ . . . . @ . . . . . @ . . . . . . @ @ . . 
@ @ . @ . . . . . . . . @ . . @ @ @ @ . . . . . . . . . . . . . 
. . . . . . . . @ . . . . . @ . . @ @ . . . @ . @ . . . . @ @ . 
. . . @ @ . . . . . @ @ . . . . . . @ . @ . . . @ . . @ . . @ @ 
. . . @ . . . . . @ . . . . . @ @ . @ . . . @ . . @ . @ . . . . 
@ . . . . @ . . . . . . . . . @ . . . . . . @ @ @ . . . . . @ . 
. . . . . . . . . . . . @ . . . . . @ . . @ . . . . . @ . . . . 
. . . . @ . . . . . . @ . . @ . . . . . . . @ . . . . . . . @ . 
. . . @ @ . . . . . . . @ @ . . . . . . . . @ @ . . . . . . . . 
. . . . . . . . . . @ . . . . . . . . . @ . . @ . . . . . . @ . 
. @ . . . . . . . @ . @ . . . . . . . @ . . . . . . . @ . @ @ . 
. . . . . . . . . . . . . . . @ . . @ . . . . @ . . . @ . . @ . 
. . . . @ . . . . @ @ . . . . . . . @ . . . . . . . . . . . . . 
@ . . . . . . . @ @ . . @ . . . . . @ . . . . . . . . . @ . . @ 
60
18 17 14 21
20 3 15 6
2 31 7 28
25 13 12 21
14 1 1 24
14 6 19 30
8 9 11 18
1 21 31 23
13 1 9 10
14 31 26 29
21 26 18 6
13 3 3 4
3 25 29 26
6 9 31 12
4 27 27 7
28 2 6 17
10 4 8 0
19 17 17 28
5 10 14 18
31 9 18 23
10 22 17 5
13 30 21 25
29 19 4 29
21 19 22 15
18 0 0 9
8 13 24 22
10 1 25 10
5 17 28 25
28 28 0 0
13 9 26 16
8 22 12 5
16 30 12 17
20 12 3 23
13 22 11 30
3 2 8 27
0 25 13 5
22 31 1 4
22 24 31 18
24 10 11 19
0 20 23 17
19 6 2 8
5 6 9 20
10 7 14 19
20 5 23 12
5 3 15 10
19 5 11 13
5 25 23 22
7 23 25 25
14 30 13 7
16 1 10 23
23 6 22 14
18 27 13 0
24 14 11 9
13 13 18 5
26 18 3 17
20 7 11 10
11 18 26 22
8 30 10 13
29 1 1 16
5 29 13 11
