32 32
@ . . . . . . . . . . @ . . . . . . @ . @ . @ @ . . . . . . . . 
. @ . . . . . . . . . . . @ . . . @ . . . . . . @ . @ . . . . @ 
. . . @ @ . . . @ . . . . . @ . . @ . . . . . . . . . . . . . . 
. . . . . . . . @ . @ . . . . . . @ @ . . . . . . @ . . . @ . . 
. . @ . @ . @ . . @ . . . . . . . . . . @ . . . . . @ . @ . . . 
. . @ . . @ @ . . . . . . @ . @ . . @ . . . . . @ . . . . . . . 
. . . @ . @ . . @ @ . . . . . @ . @ @ . . . . . . . . . @ @ . . 
. . . . . @ . . . . . . . @ @ . . @ @ . @ . . @ . . @ . . @ . . 
. . . . . . . . . . . @ . . . . . . . @ . . @ . . . . . . . . . 
. @ . . @ . . . . . . . . . @ @ @ . . . . @ . . . @ . . . . . @ 
. . . . . @ @ . . . . . . . . . . . . @ . . . . @ . . . @ . . . 
. . . . . . @ . . . @ . . . . . . . . @ @ . . . . . . . @ . . . 
@ . . . . @ . . . @ . @ . . . . . @ . . . . @ . . . . @ . . . . 
@ . @ . . . . @ . . . @ . . . . @ . . . . . . . . . . . . . . . 
. . @ . . . @ . . @ @ . . @ . . . . . . . . . . . . . . . . . . 
. . . . . . @ . . @ . . . . . . @ . . . . . @ @ . . . @ . @ . @ 
. . . @ . . . . . . @ . . . . . @ @ . @ . @ . . . . . . . . . . 
. . @ . @ . . . . @ . . @ . . @ . . @ . . . . @ . . . . . @ . . 
@ . . @ @ . . . @ @ @ . . . . @ . . . @ . . @ . . . . . . . @ @ 
. @ . . @ . . . . . @ . @ . . . . @ . . . . . @ . @ . . . . . @ 
. . . . . . . . . . . . . . . . . . . . . @ . . . . . . @ . @ @ 
. @ . . . @ @ . . @ . . @ . . . . . . @ . @ . . @ @ . . . . @ . 
. . . . . . . . . . . . . . . . . . . . . . . . . @ . @ @ . . . 
. . . . . . . . . . . . . . . . . . . . . . . @ . . . . . @ . . 
. . . . . @ . . . @ @ . @ . . . . . @ @ . . @ . @ . @ . . . . @ 
. @ @ . . . @ @ . . @ . . . . . @ . . . . . . @ . @ . @ . . @ @ 
. . . @ . . . . . . . @ . . . . . . . . . . . . . . . . @ . @ . 
. . . . . . . . . . . . . . . . . . . . . . . . . . . . . . . . 
. . . . . @ . . . . . . @ . . . @ . @ . . . . . . . . . @ . . . 
. @ . @ . . . . . . . @ @ . . . . . @ . . . . @ . . . . . . . . 
@ . . . . @ . . . . . . . . . @ . . . @ @ @ . . . . . . . . @ . 
. @ . . . . . . . . . @ . . . @ . . . . @ @ . @ . . . @ . @ . . 
40
8 31 28 18
13 10 28 29
2 16 10 21
30 5 2 20
15 21 24 17
6 20 21 25
3 23 2 9
20 9 7 20
31 12 2 8
19 23 10 17
31 4 19 12
31 6 30 23
12 25 7 19
24 14 22 4
29 30 1 10
10 4 26 25
0 11 8 10
28 0 14 1
9 26 24 7
27 10 11 18
17 5 10 28
8 8 2 11
26 17 22 28
7 29 14 17
27 18 19 1
26 26 23 11
18 10 7 0
1 30 8 9
25 26 30 31
13 28 9 19
0 15 3 19
28 9 4 28
14 11 14 23
14 20 25 16
7 28 26 21
16 23 0 4
27 7 27 3
10 26 27 17
28 23 12 2
29 1 20 12
