32 32
. . . . . . . . . . . . . . . . . @ . . @ . . . . @ @ . . . @ . 
. . . . . . @ . . . . . . . . . @ . . . . . . @ . . @ . . . . @ 
. . . . . . @ . . . . . . @ @ . . . @ @ . @ . . . . @ . . @ . . 
. . . . . @ . @ @ . . . . . . . . . @ . . . @ @ @ . @ @ @ . . . 
. . . @ . . @ . . . . @ . . . . . . @ . @ . . . . @ . . . @ . . 
@ . . . @ . . . . . . . . . @ . @ . . . . . . . . . . . . . . . 
. . . . . . . . . . @ . . . . . @ . . . . @ . . . . . . @ . @ . 
. @ . . . @ . . . @ . . . . . . . . . . . . . @ . @ . . . . . @ 
. . . . @ . . . . @ . . . . . . . . . @ . . . . @ . . . . . . . 
. . @ . . . . . . . @ . . @ @ . . . . . . . . @ . . . @ . . . . 
. . . . . . . @ . . . . . @ . . . @ . @ . . . . . . . @ . @ . . 
. . . . . . . @ @ . . . @ . @ . . . . . @ . . . . . @ . . . . . 
. . . . . . . . . . . . . . . @ . . . . @ . @ . . . . . . . . . 
. . . . . . . @ . . . . . . . . . . . . . . . . @ . . @ . . . . 
. @ . . . @ . . @ @ . @ @ @ . . . . . . . @ @ . @ . @ . . . @ . 
. . . . @ . . @ . @ . . . . . . . . . . . . @ . . . . . @ . . . 
@ . . . . . . . @ . . . . @ . @ . . @ . @ . . . @ . @ @ . . . . 
@ @ @ . . . @ @ @ @ . @ . @ . . . . . . . . @ . @ . . . . . . . 
. . . . . @ . . . . @ @ . @ . . . . . . . . . @ @ . . . . @ @ @ 
. . . . . . . . . @ . . @ . . . . . @ . . @ . . . . . . . @ . . 
. . . . . . . . . @ . . . . . . . @ . @ . . . . . @ . . @ . . . 
. . @ . . . . . . . . . . . . @ . . . . @ . . . . @ . . @ . . @ 
@ @ . . @ . . . . @ . . . . . . . . . . . @ @ . @ . . @ . . . . 
. . . . . . @ @ . . @ . . . . . @ . . @ . . @ @ . . @ . @ . . @ 
. . . . . . . . . . . . . @ . @ . . . . @ . @ . @ . . . . . . . 
. @ . . . . . . . . @ @ . @ . . . . . . . . . . . . . . . . . . 
. . . . . @ . . . . . . . . . . . . @ @ . . . @ . . . . . . . . 
. . . . @ . . . . @ @ . . @ . . . . . . . . . . . . @ @ . . . . 
. . . @ @ @ . . . . . . . . @ . . . . . @ . . . . @ . . @ @ . . 
. . . . . . . . . . . . @ . . @ . . . . . . . . . @ . . @ . . . 
. . . . . @ . . . . . . . @ . . . @ @ . . @ . @ . . . @ . @ @ . 
. @ . . . . . . . . . @ . @ . . . @ . . . . . . . . . . @ . . @ 
30
5 4 4 1
15 26 12 30
3 11 30 8
17 1 29 25
6 11 8 4
13 11 14 18
5 16 23 24
5 1 15 14
10 19 24 29
17 15 23 16
20 9 2 10
3 7 29 20
28 26 12 21
20 18 22 31
11 24 18 5
14 31 10 8
19 15 1 20
25 2 26 19
9 12 21 27
27 1 29 11
10 29 17 15
21 0 2 23
12 20 20 2
17 13 9 9
14 22 6 16
11 3 25 23
11 7 20 27
13 22 31 5
7 4 5 11
6 13 1 5
