32 32
@ . . . . . . . @ . @ . . . . . . @ . . . . . . . . . . . . . @ 
. . @ . @ . . . . . @ . @ . @ . . @ . . . . @ . . . @ @ . . . . 
. . . . . . . . . @ @ . . . . @ @ . . @ . . . . . . . . . . . . 
. . . . . . . . . . . . . . . @ . . . . . . . . . . . . . . . . 
. . @ . . . . . . . . . . . . . . @ . . . . . . . . . . . . . . 
. . . . . . . . . . . . . . . . . . @ . . . . @ . @ @ . . . @ . 
. . . . . . @ . . @ . . @ @ . @ . @ @ @ . . . . . . . . . . @ . 
. . . . . . . @ . . . . . @ @ . . . . @ . . . . . . @ @ . @ . @ 
. . @ . @ . . . . . . . . . @ . . @ @ @ . . . . @ . . . . . . . 
. . @ . . . . . @ . . @ . . @ @ . . @ . . @ . . @ . . . @ @ @ . 
. . . . @ . . . . . . @ @ . . . . . . . . @ . . . . . . @ @ . @ 
. @ . . @ . . . @ @ @ . . . . . . . . . . . . . @ . . . . . . @ 
. . . . . . @ . . . . . @ @ @ @ . . . . @ . @ . . @ . @ . . . @ 
. . . . @ . . . . . . @ . . . @ . . . @ . . . . . . . . . . . . 
. . . . . . . . @ @ @ @ . . . . @ . @ . . . . . . . . . . @ . . 
. . . . . . . . . . . . . . @ . . . . . . . . . . . . . . @ @ . 
. . . . . . . . . . . . @ . . . . . . . . . . . . . @ @ @ . @ . 
. . . . @ . . . . . . @ . . . . . . . . . . . . . @ . . @ . . @ 
. . . @ . @ . . . . . . . . @ . . . @ . @ . . @ . . . . . . . . 
. . . @ . . . . . . . . . . . . @ . . @ . . . . . . @ . . . . . 
. . @ . . . . . . . . . . . . . @ . . . @ @ . . . . . . . . . . 
. . . . . . . . @ . . . . . @ @ . @ @ . . . . . @ . @ . . @ . @ 
@ . . . @ . @ . . . @ . . . . . @ . . . . @ . . . . . . . @ . . 
. @ @ . @ @ . @ . . . . . . @ @ . . . . . . . . . . . @ . . . . 
. @ @ . . . . . . . . . . . . @ . . . . . . . . . . . @ . . . . 
. . . . . . . . . . . . . . . . @ @ @ . . @ . . . . . @ . . . . 
. . . @ @ @ . . . . . @ . . . . . @ @ @ . . . . @ . . . . . . . 
. . . @ @ . @ . . . . . . @ . . . . . . . @ . . . @ @ . . . @ . 
. . . . @ . . . . @ . . . . @ @ . . . . . . . . @ . @ . @ . . @ 
. . . . . @ . . . @ . . . . . . . @ . . . . . @ @ @ @ . . . . . 
. . . @ . . . . . . . . . . . . . @ . . . @ . @ @ . . . . @ . . 
@ . . . . . @ . @ . . @ @ . . @ . . @ . . . . . . . @ . @ . . @ 
60
25 13 30 29
24 14 15 17
6 14 30 14
6 24 20 30
8 27 19 5
1 12 29 12
10 8 1 14
22 6 6 2
30 12 2 21
11 23 16 23
7 31 30 2
0 25 9 25
10 18 26 25
31 1 21 7
6 2 22 8
3 3 27 14
10 9 18 24
5 31 19 29
24 1 15 15
9 0 19 25
29 4 30 10
6 13 21 28
28 0 24 27
2 14 1 7
1 14 21 4
20 17 0 9
27 0 21 18
24 10 16 27
11 22 23 14
19 4 28 23
1 22 6 10
21 4 7 29
24 6 2 22
19 28 15 5
12 26 30 4
21 26 10 12
4 19 11 2
19 0 7 28
24 31 12 8
19 15 14 29
26 6 8 5
2 27 23 2
4 18 31 3
3 0 20 21
30 25 27 31
17 9 12 21
27 28 21 19
31 4 20 15
31 22 10 3
30 26 30 3
6 15 24 4
11 20 24 6
26 25 16 26
7 14 27 3
28 8 19 16
3 4 8 6
7 16 25 25
24 23 8 2
28 20 21 31
9 13 26 20
