32 32
. . . . . . . . . . . @ @ @ @ . . . . @ . . . @ . . . . @ . . . 
. . . . @ . . . . . . @ . @ . . . . . . . @ . . . . . . @ . . . 
. . . . . . @ . @ . . . . . . . . @ @ . . . . . . @ . . . . . . 
. . . . . @ . . . . . . @ @ . . @ . . . . @ . . . . . . @ @ @ . 
. . . @ . . @ . . . . . @ . . . @ . . . . @ . . . . . . . . @ . 
. . . @ . @ @ . . . . . . . . @ . . . . . . . @ @ @ . . . . . . 
. . . . . . . . . . . . . @ . . @ @ . . . @ . . . @ . @ . . @ . 
. . . . @ . . @ . . . . . . . . @ . @ . . . . . . . . . . . . . 
@ . . . @ . . @ . @ . . . . . . @ @ . . . @ . . @ . . . . . . . 
@ . . . . . . . @ . . . . . . . @ . . @ @ . . . . @ . . . . . . 
. . . @ . . . . . @ @ @ . . . @ . . @ . . . @ . . . . @ @ @ . . 
. . @ . . . @ . @ . . . . . @ . . . . @ . . @ . . . . . . @ . . 
. . @ . @ . . . . @ . . . . @ . @ . . . . . . . @ @ @ . . . . . 
. @ . . . . . . . . . @ @ . @ . . . . . @ . @ . . . . . . . . . 
. . . @ . . . . . . @ . @ . @ . . . . . . . . . . . . . . . . . 
. @ @ . . . . . . . . . . @ @ . . . . . . @ @ @ @ . . . . . . . 
. . @ . . . @ . . @ @ . . . . . @ . . . . . . . . . . . . . . . 
@ . @ . . . @ . . . . . @ . . . . . . @ . . . . @ . @ @ . @ . . 
. . . . . . . . . . . . . . . . . . . @ . . @ @ . . . . . @ . . 
. . . . . . . @ @ . @ . . . . . @ @ . . . . @ . @ . @ @ . . . . 
. . . . @ . . . . @ . . . . . . . . @ @ . . @ . . . . . . . . . 
. . @ . . @ . . . . . . @ . @ . . . . . @ . . . . . . . . . . . 
. . @ . . . . . @ . . @ . . . . @ . . . . . . . . . . . . . . @ 
. . . @ @ @ . @ @ @ . @ . @ . @ . @ . . . . . . . . . . . . @ @ 
. . . . . @ . . @ . @ . . . . @ . . . . . . @ . . . . @ . . . . 
. @ @ . . . . . . . . . . @ . . . . . . @ . . . @ . . . . @ . . 
. @ . . . . . . . . . . . . . . . . . . . . . . . . . . . @ . @ 
@ . . @ . . . . . . . . . . . . @ . . @ . . . . . . . . . . @ . 
. . . . . . . . . @ . . . . . . @ . . . . @ . . . @ . . . . @ . 
. . . . @ . . . . . . . . @ . . . @ . @ . . . . . . . @ . . . . 
@ . . . . . @ . . . @ . @ @ . @ @ . . . . . . . . @ . . . . . . 
. . . . . @ . . @ . . . . . . . @ . @ @ @ . . . . . . . . . . . 
50
18 30 18 22
25 3 17 0
30 18 17 10
19 16 18 3
7 30 1 2
11 21 23 11
4 15 9 14
28 27 1 29
29 0 29 0
25 19 15 4
1 17 11 25
6 25 12 29
23 9 23 4
11 27 2 31
3 17 0 23
20 26 30 9
11 14 26 0
6 21 26 28
3 21 11 18
14 17 7 27
18 19 28 6
30 29 1 24
0 0 6 31
19 15 4 6
7 18 14 23
3 11 25 20
27 30 10 8
21 25 27 27
4 13 2 6
7 3 13 5
4 14 4 5
22 9 13 16
23 19 8 12
3 31 13 21
24 26 30 0
16 20 0 6
15 28 6 3
6 1 21 31
13 12 6 20
5 19 0 2
0 31 18 14
4 30 4 17
22 26 15 18
0 11 4 4
1 18 11 3
21 24 19 26
29 8 5 9
8 6 31 29
27 13 19 3
13 31 22 29
