32 32
. . . . . @ . . . . . . . . . . . @ . . . . . . . . @ @ . @ . . 
. . @ . . . . . . . . . . . . . . . . . . @ . . @ . @ @ . . . @ 
@ . . . . . @ @ @ @ . @ . . . . . . . . . . . . . . . . . . . @ 
. . . @ . . @ . . . . @ . . . . . . . . . . @ . @ @ . . . . . . 
. . . . . . . . . . . . @ . . . @ . . . @ . . . . . . . . @ . . 
. . . . . . @ . . . . . @ . . . . @ . @ . . @ . @ @ . . . . @ . 
. @ @ . . . @ @ . . @ . . . . . . . . . . . . . . @ . . . . . . 
@ @ @ . . . . . . . . @ . . . . @ . @ . @ @ @ . @ . . . @ . @ @ 
. . . . @ @ . . . @ . @ @ . . . . . @ . . . . . . . . @ . . . . 
. . . @ . @ . . . . . @ . . . @ . . . @ . . @ . . @ . . . . @ . 
@ . . . . . . . . @ . @ . . . . . @ . . @ . @ . @ . . @ . @ . @ 
. @ . . . . . . @ . . . . . @ . @ . . . . . . . . . . . . . . . 
. . @ @ . . . . . . . . @ . . . . . . . @ . . . . . . . . @ . . 
. . . . . . . . . @ . @ . . . @ . . . . . @ . . . . @ . . . @ @ 
. . . . . @ @ @ . @ . . . . . . @ . . . @ . . @ . . . . . . . . 
. @ . . . . . . . . @ . . @ . . . . . . . . . . . . . . . . @ . 
. . . . @ @ . . . . . . . . . . . . . @ @ . . . . . @ . . . . . 
. . . . . @ @ . . . @ @ . . @ @ . . @ . . . . . . . . @ . @ . . 
. . . . . . . . . . . . @ @ . . . . . . . . @ @ @ . . . . . . . 
. . @ . @ . @ . . . @ . . . . . . . . . . @ . . . . @ . . @ . . 
@ . . . . . @ . . . @ . . . . . . . . . @ . . @ . . @ . @ . . @ 
. . . . . . . @ . . . . . . . . . . @ . . . . . . . . . . . @ @ 
. . . . . . . . . . . @ . . . @ . . . . . . . @ @ . . @ @ @ @ @ 
. . . . . @ . . . . @ . . . . . . . @ . @ . . . . . . . . . . @ 
. @ @ @ . . . . . . . . . . . . . @ . . @ . . . . . . . @ . . . 
. . . . . . . . . . . . @ . . . @ . . @ . . . . . . . . . . . . 
. . . @ . . . @ @ . . . . . . . . . @ . . . . . . . . . . . . . 
. . . @ . . . . . . . . . @ . @ . @ . . . @ . . . . @ . . . . @ 
. . . @ . . @ . @ . . . . . . @ . . . . @ . . . . . . . . . . . 
. @ . @ . . . . @ . . . . @ . . . . @ @ . . @ @ . . . @ @ . . . 
. . . . . . . . . . . . . . . . @ . . . @ . . . . . @ @ @ . . . 
@ . . . @ . . . . . . . . . . . . . . @ . @ . . . . . . . . @ . 
80
18 14 25 30
13 24 11 14
28 15 31 5
26 11 21 11
4 1 14 8
18 3 23 24
10 28 8 25
7 22 12 15
26 5 15 20
19 24 3 14
27 13 12 27
25 31 29 29
29 16 3 25
30 8 5 30
24 4 20 11
26 21 26 10
6 13 28 27
7 12 8 20
8 17 14 20
21 23 7 4
19 26 9 24
24 8 2 15
30 28 13 22
23 6 9 22
4 7 28 8
1 3 18 12
29 11 30 2
30 0 21 0
26 7 25 29
6 24 3 5
24 28 1 30
8 16 23 28
7 31 24 17
8 4 13 7
21 22 2 20
10 30 13 3
1 5 10 22
2 22 20 22
27 9 28 15
28 12 11 18
7 8 13 0
15 1 4 28
15 5 23 9
0 28 10 21
24 25 23 15
1 31 28 17
14 24 28 10
14 6 23 7
10 26 25 8
3 7 24 24
20 5 29 14
5 31 18 0
2 3 15 5
23 12 25 2
17 25 17 20
21 0 30 3
11 11 21 15
1 20 25 24
27 27 0 27
28 14 22 11
0 16 12 23
23 8 27 2
29 28 29 26
12 30 15 12
17 9 12 16
15 15 10 4
23 30 17 17
16 23 30 16
17 29 1 8
5 27 8 6
4 4 30 6
13 5 8 30
11 1 5 5
29 2 1 20
16 24 15 8
9 25 22 8
30 18 31 30
12 11 15 11
3 15 2 17
15 19 27 15
