32 32
. . . @ . . @ . . . . . . . . . . . @ . . . @ @ . . . . . @ . . 
. . . . . @ . . . . . @ . . . @ . . . . . @ . . . . @ @ . . . @ 
. . . . . . @ . . . . . @ . . @ @ . . . . . . . . @ . . . . @ @ 
. . @ . @ . . @ . . @ . . . . . . . . . @ . . . . @ . . . @ . . 
. . . . . . . @ . . @ . . . @ @ . . . . . . . . . . @ . @ @ . . 
. . @ @ . . . . @ . . . . . . . . . . . . . . . . . . . @ @ . . 
@ . . @ . . . . @ . . . @ . . . . . . . @ @ . . . . @ @ . . . . 
. . . @ @ . . . . . @ . . . . . . . . . . . . . @ . . . . . . . 
. @ . . @ . . . @ . . @ . @ . . . . @ . . @ . . . . . . . . . . 
. . . . @ . . . . . . . @ . @ . . . . . . . . . . @ . . . @ . @ 
. . @ . . . . . . . . . . . . . @ . . . @ . . . . . . . . . . . 
. . . . . . . . . . . @ . . . @ @ . . . @ . . . . . . @ @ . . . 
. . . . . . . @ @ . @ . . . . . . . . . . . . . . . . . . . . . 
. . . @ . . @ @ @ . . @ . @ . . . @ @ . . @ . . . . @ . . . @ . 
. . . . . . . . . . . @ @ . @ . . . . . . . . . . . . . . . . . 
. . . . . . . . @ . . . . . . @ . . . . @ @ . . . . . . . . . . 
. @ . . . . . . . . . . . . . . . . . @ . . . . . @ . . . @ . . 
. @ . . . . . . . . @ @ . . @ . . . . . @ . . . @ . @ . @ . . . 
@ @ . . . . . . @ . . @ . @ . @ . . @ . . . . . . . . . . . . @ 
. . . @ . . . . . . @ . . . . . . . @ @ . @ @ . . . . . . @ . . 
. @ @ . . . . @ @ @ . . . . . . . @ . . . @ . . . . . . . . . . 
. @ . . . . . . . @ . @ . . . . . . . . . . @ @ . . . . . @ @ . 
. . . . . . . . . @ . . @ @ . . . . @ @ . . @ . @ . . . . . . . 
. @ . . . @ . . . . . . . . @ @ @ @ . . @ . . . . @ @ . . . @ . 
. . . . . @ . . @ . @ . . . . . . . . @ . @ @ . . . . . . . . . 
. . . . . . . @ . . . @ @ @ . . @ @ . . . . . @ . . . . . . @ @ 
. @ . . . . . @ . . . . . . @ . . . @ @ . . . . . . . . . . . . 
. @ . . . . @ . . . . . . @ . . @ @ . @ . . . . . . . . @ . . . 
. . . . . . . @ . . . . . . . . . . @ . @ . . @ @ . . @ . . . @ 
. @ . . . . . . . @ . . . @ . . . . . . @ . . . @ . @ . . . . . 
. . . @ . . . . @ . . . . @ . . . . . @ @ . . . . . @ . . . @ . 
. . . @ . . . . . . . . . . @ . . . . . . . @ . . . . . @ . @ . 
10
23 14 28 19
10 5 26 10
17 26 28 20
15 21 19 25
12 19 28 26
14 10 3 26
21 9 15 14
10 25 19 8
16 0 18 29
27 27 23 30
