32 32
@ . . . . . . @ . . . . . . @ @ . . . . . . . . . . . . . . . . 
. . . . . . @ . . . @ @ . . . . . . . @ . . . . . . . . . . . . 
@ . @ . . @ @ . @ @ . . @ . . . . . @ . . @ @ . . . . . . . . . 
@ @ . . . @ . . . . . . @ . @ . . . . @ . . . . . @ . . . . @ . 
@ . . . . . . . . . . @ . . . @ . @ @ . . . . . @ . . . . . . . 
. @ . . . . . . @ . @ . @ . . . . . . . @ . . . . . @ . . . . . 
@ @ @ @ . @ . . . @ . . . . . . . . . @ . . . @ . . . . . . . @ 
@ . @ . . . . . . . . @ @ . . . @ . . . . . . @ . . . . . . . . 
. . . . . @ . . . . . . . . . . @ . @ . @ . . . . . @ . @ . . . 
. . @ . . . @ . . . . . . @ . . @ . . . . . @ . . . @ @ . . . . 
@ . . . . . @ . . . . . @ . . . . . . . . . . . . . . @ . . . @ 
. . . . @ . . @ . . . . . . . . @ . @ . . . . . @ . . . . . . @ 
. . @ . . . . . . . . . . . @ . . . . . . . . . . . . @ . @ . @ 
. . @ . . . . . . @ . @ . . . . . . . . . . . . @ . . . . @ . . 
. . @ . . . . . @ . . @ . . . . . . . . . . . . @ . @ . . . . @ 
. . . . . . . . . @ . . . . @ . . . . . @ @ . . . . . . @ @ . . 
. . . . . @ . @ . . @ @ @ . . . . . . . . . . . . . @ . . . . . 
. . . @ @ . . . @ . @ . . . . . @ @ . . . . @ . . . . . . . . @ 
. . @ . . @ . . . . . . . @ . @ @ . . @ . . . . @ . @ @ . . @ . 
@ . . . . . @ . . . . . . @ . . . . . . . @ . . . @ . @ . . . . 
. . . . . . . . . . . . . . . . . . . . . . . @ . . . . @ . . . 
@ . . @ . @ . . . . . . . . . . . . @ . . . . @ . . . @ . . @ @ 
@ . . . . . . . . . . . . . . . . @ . . . . . . . @ @ . @ . . @ 
. . . @ . . . . . . . . . . @ . . @ . @ @ . . . . . . . @ . . . 
. . . @ . @ @ @ . . . @ . . . @ . . . @ . . . @ . . @ . . . . @ 
. . @ . . . . @ . . . . . . . . . . @ . @ . @ . . . . @ . @ @ . 
@ @ . . . . @ @ @ . . . @ . . . . . . . . . . . . @ . . . . . . 
. @ . @ . @ . . . . @ . . . . @ @ . . . . . . . . . @ . . . @ . 
. . . . @ @ . . . . . . . . . @ . . . . . . . . . . . @ . @ . . 
. . . @ . @ . . . . . . . . . @ . . @ @ . . . . . . . . . @ . . 
. . @ . . . . . . . @ . . . . @ . . . . @ . . . . . . . . . @ . 
. . . . . . . . @ . . . . . . @ . @ . . . . . . . . . @ . . . . 
50
20 12 4 13
0 25 8 3
21 28 30 31
27 22 10 13
28 1 9 20
14 17 3 3
25 15 7 5
21 30 11 30
23 30 9 8
0 15 7 7
26 1 3 2
20 16 27 8
6 7 2 17
3 12 24 16
12 9 9 7
8 6 29 1
21 11 3 0
26 29 15 16
4 31 10 14
29 24 0 30
10 7 7 30
24 20 23 11
7 13 18 26
21 17 16 16
8 20 9 4
11 23 23 18
20 17 12 0
17 29 25 1
11 11 19 26
12 18 16 22
29 30 18 16
13 13 17 26
9 25 30 1
7 3 21 14
29 20 16 1
7 15 2 3
16 25 20 18
2 27 13 13
23 28 6 21
22 14 0 20
4 19 25 11
22 3 15 1
13 7 22 23
30 11 18 5
0 28 30 4
30 26 6 7
21 6 14 19
31 7 19 21
29 1 14 14
28 13 9 27
