32 32
. . . . . . . . @ . . . . . @ . @ . . . @ @ . @ . @ @ . @ . . @ 
. . . @ . @ . @ @ . . . @ . . . . . . . . . . . . . . . . . @ . 
@ . . . @ . . @ . @ . . . . . . . . . . . . @ @ . @ . . . . . . 
@ . . . . @ @ . @ . . . . . . . . . . . . . . . . . @ . . . . . 
. @ @ @ @ . . . @ @ . . . . . . . . . @ . . . . . . @ . . . . . 
. . . . . . . @ . . . @ @ . . . . . @ @ . . @ . . . @ . @ . @ . 
. . . . @ . . . . . . . . @ . @ @ . @ . @ . @ @ . . . . . . . . 
. . . . . @ . . @ . . . . . . . . . . . . . @ . . . @ @ . . . . 
. @ . @ . @ @ . @ . . . @ . . . . . @ @ @ . . . . @ . . @ . . . 
. @ @ . . . @ @ @ . . . . . . . @ . . @ . . . . . . . . . @ . @ 
. . @ . . . . . . . . . @ @ . . . . @ . . . @ . . . . . . . . . 
. . . . @ @ . . . @ . . . . . . @ . . . . . . . . . . . . . . @ 
. . . . @ . . . . . . . . . . . . . @ . @ . . . . @ . . . . @ . 
. . . . . . . . @ @ . . @ @ . . . . . . @ . . . . @ . . . . @ . 
. . . . . . @ . . . . . . . . . . . @ . . . . @ . . @ . . @ . . 
. . . . . . . @ . @ . @ . . . . . . . @ . . . . . . . . . . . @ 
. . . . . . . . . . . @ @ . . . . . . . . @ . @ . . . @ . . . . 
. . . . . . . . @ @ @ . . . . . @ . . . . . . @ . . . . . . . . 
@ @ . . @ . @ . @ . . . . . . . . . @ . . @ . . . . . . @ . . . 
. . @ . . . . @ . . @ . @ . . . . . . . . . . . . . . . . . @ . 
. . . . . @ . @ . . . . @ . . . @ . . . . @ . @ . . . . @ . . . 
@ . @ . . . . . @ . . . . . . . . . . . @ @ . . . . @ @ . @ @ . 
. . . . . . . . . . @ . . . . . @ . @ . . . . @ . . @ . . . . . 
. . . . . . . @ . . . . @ . . . . . @ . . . . . . . . @ . . . @ 
. @ . . . . . . . . @ . @ @ @ . . . . . . . @ . @ . . . . . . @ 
. . . . . . . . . . . . @ @ . . . . . . . . . . . . . . . . @ . 
. . . . . . . . . . . . . @ @ @ . . . @ . . . . . . . . @ . . . 
. . . . . . . . . @ . . @ . . @ . . . . . . . . . . . . . . . . 
. . . @ @ . . . . . . @ . . . . . . . @ . . . @ . . . . . . @ . 
. . . @ . . . . . . . . . . . @ . . . . . . . . . . @ . @ @ . . 
. . . @ . . @ . @ . . . . . . . @ . @ . . . @ . @ @ . . . . . . 
. . @ . . @ . . . . . . . . . @ . @ . . @ . . @ . . . . . . @ . 
40
25 16 0 31
1 17 8 26
19 25 24 18
30 15 28 23
7 4 6 13
1 7 15 12
5 6 21 3
28 24 15 23
23 25 5 21
17 0 30 20
12 14 21 17
25 21 10 8
30 14 25 23
18 1 29 31
15 11 19 10
14 10 31 27
15 22 18 29
15 21 3 25
3 24 12 31
9 22 14 21
13 2 10 10
14 20 8 11
6 24 18 21
15 15 4 13
11 1 0 10
22 9 16 18
26 23 5 9
16 2 27 10
5 9 19 3
24 27 5 15
22 16 12 22
13 21 10 2
6 16 1 21
31 31 9 6
14 17 4 14
1 5 17 8
13 20 24 17
8 16 31 28
22 8 8 5
0 31 26 8
