32 32
. . . . . . . . . . . . . . . @ . . . . @ . . . @ @ . . . . . @ 
. . . . @ . . . . . . . . . . . . . @ @ . . . . . @ @ . . . . . 
. . @ . . . . . . . @ . . . . . . . . . @ . . . . . . @ . . . @ 
@ . . . . . . . . . . . @ . . . . . @ . @ . . . @ . . @ . . . . 
. . . . . . @ . . . . @ . . @ . @ . . . . @ . . . @ . . . . @ . 
@ . @ @ . . . @ . . . @ . . . @ @ . . . . . @ . @ . . . @ . . . 
@ @ . . . . . @ . @ . . . . . @ . . . . @ @ . . . @ . @ . . . . 
. . . @ . . . . . . @ . . . . . . . . . . @ @ . . . . . @ . @ . 
. . @ @ . @ . . @ . . @ . . @ . . . . . . . . . @ . . . . . . @ 
. . . . @ . . @ . . . . . . . @ . @ . . . . @ . . . . . . . . . 
. @ . . . . @ . . @ @ . . . . . . . . @ @ . . . . . @ . . @ . . 
. . @ . . . . . . . . . . . . . . . . . . . . . . . . . . . . . 
. . . . . . @ @ . . . . . . . @ @ . . @ . . @ . . . @ . @ . . . 
. . . . . . . . . . @ . @ . . . . . . @ . . . @ . . @ . @ . @ @ 
@ . . . . . . . . . . . . . . . . . . @ . . . @ . . . . . . . . 
. . . . . . . . . @ . . . . . . @ . . . . @ @ . . . . . . . @ . 
. . . . . @ . . . . @ . @ . @ . @ . . . . . . @ . . . . . . @ . 
. . . . . @ . . @ . @ . . @ . @ . . @ @ . @ . . @ . . . . . . . 
. . . . . @ . . . . . @ . . . . . . . . @ . . @ . . @ . . . . . 
. @ . . . @ . . . . . . . . . . . @ . @ . . . . . . . @ . . . . 
. . @ . . @ . . . . . . . . . @ . . . . @ @ @ @ . @ @ @ . . . . 
. . . . . . . @ . . @ . @ @ . @ . . . @ . @ . . . . . . @ . @ . 
. @ . . . . . . @ . . @ @ . . . . . . . . . . . . . . . . . @ . 
. . . . . . @ . . @ . . . . @ . @ @ . . . . @ . . @ . . . . @ . 
. . @ @ . . . @ . . @ @ . . . . . . . . . . . @ . @ . . . @ @ . 
. . . . . . . . . . . . . @ . . . . . . . . . . . . . . . . . . 
. . . . @ . . . . . . @ @ . . . . . . . . @ @ @ . . . . . . . . 
@ . . . . . . . . . . . . @ . . @ . . @ @ . . @ . @ . . . . . . 
. . . . . . . @ . @ . . . . . . . . . . @ . . . @ @ . . . . . . 
. . . @ . @ . . . @ . . . . @ . @ . @ @ . @ . . . . . . . . @ . 
@ . . . . . . . @ . . . . . . . . . . . . . . . . . . @ . @ . . 
. . . . . . . . . . . . . @ . . . @ @ . . . . @ . @ @ . . . . . 
10
22 6 19 0
16 1 10 22
0 23 11 28
30 9 5 7
22 14 23 30
26 30 14 15
20 26 23 19
1 25 23 5
16 22 18 10
25 26 12 18
