32 32
. . . . . . . @ @ @ . . . . @ . . . . . . . . . . . . @ . . . . 
. @ . . . @ . . . . . @ . . . . @ . . . . @ . @ . . . . . @ @ . 
@ . @ . . . . . . . @ @ . . . . @ @ @ . . . . . . . . @ . . . @ 
. . . . . . . . . . . . . . . . . . . . @ @ . . . @ @ @ . . . . 
. . . @ . . . . @ . @ . . . . . @ . . . . @ . . . . . . @ . . . 
@ . . . . . . . . . . . . . @ . . . @ . @ . . @ @ @ . . @ @ . . 
. @ @ . @ . . . @ . . . . . . @ . . . . @ . @ . . . @ . @ . . . 
@ . @ . @ . . . @ @ @ . . . . . . . . . @ . . . . . . . . @ . . 
. . . @ @ . . . @ . @ . . . . . . . . . . @ . @ . . @ @ . @ . . 
. . . . @ . . . . . @ . . . . . . . . . . . . @ . . . @ . @ @ . 
. . @ . . . @ . @ . @ . . @ . . @ . @ . . . . . . . . . . . . . 
. . . . . . . @ . . . . . . . . . . . . . . @ . . . . . @ . . . 
@ . . . . . . . . . @ @ . @ . . @ . . . . . . @ . @ . . . . . . 
. . . . . . . . . . . . . . . . . . @ . . . . . @ @ @ . . . . . 
. @ . . . . @ . . . @ . . . . . . . . . . . . @ . . . . . . . . 
. . . @ @ . . . @ . . . . . . . . . . . . @ . . @ . . . . . . . 
@ . . @ . . @ . . @ . . . . . . . @ . . @ @ . . . @ . . . . . . 
. @ . . @ @ @ . . . @ . . . . . @ . . . . . . @ . . . . @ . . . 
. @ . . . . . . . . . . . @ . . . . @ . . . . @ @ . . . @ @ . . 
. @ . . . . . . . . @ . @ . . . . . . @ @ @ . @ . . @ . . @ . . 
@ @ . . . . . . . . . . . . @ . . . . . . . @ . @ . . . . . . . 
. . . . . @ . . . . . . . . . . @ . . . @ . @ . . . . . . @ . . 
@ . . . . . . . . . @ . . . . . . . . . . @ . . . . @ . . . @ . 
. . . . . . . @ . . . . . @ . . . . . . @ . @ . . . . . . . . @ 
. @ . . @ . . . . . . . . . . . . . . . . . . @ . . @ . . @ . . 
@ . . . @ . @ . @ . . . . @ @ . . . @ . . . . . @ . . . @ . @ . 
@ . . . . . . . . . . @ . . @ . . . . . @ . . . . . @ . . . @ . 
@ @ . . @ . . . . . . . @ . . @ . . . . . . . . . . . . @ @ . . 
@ . . . . @ @ @ @ . . . . . . @ . . . . . @ . . . . @ @ @ . . . 
. . . @ . . . . @ . . . . . . . . . . @ . . . @ . . . . . . . . 
. . . . . . . . . . @ . . @ . . @ . . . . . . @ . . . . . . . . 
. . . . . . . . . . . . . . . . . @ . . . . . . . . @ . . . . . 
30
20 14 3 21
11 11 0 11
3 0 17 5
1 12 1 8
11 7 20 12
19 8 18 30
17 3 5 0
27 16 5 19
19 31 26 16
12 8 17 4
20 30 20 27
15 19 31 15
6 23 13 5
31 6 11 21
15 30 26 4
16 31 3 14
20 2 19 7
11 14 17 29
8 20 9 14
17 6 30 3
12 15 14 29
14 19 25 8
24 22 21 5
20 10 31 21
2 0 20 4
12 22 26 14
20 17 11 15
8 18 10 23
27 1 15 13
12 11 31 3
