32 32
. . . @ . . . . . . . @ . . @ . . . . . . . . @ . . . . @ @ . . 
. . . . . . @ . . @ . . @ . @ . . . . @ . . . . . . . . @ . . . 
. . . @ . . . . . . . @ . . . . . @ . . @ . @ . . . . . . @ . . 
. . @ . . . . @ . . . @ . . . . . . . . . . @ @ . . @ . . . . . 
@ . @ . . @ . . . . . @ . . @ . . . . @ . . . . . . . . @ @ @ . 
@ . . @ . . . . . @ . . @ @ . . @ . . . . . @ . @ . . @ . @ @ . 
. . . . . . . . . . . . . . . . @ . . . @ . . . . . . . @ . . . 
. . @ . . . . . . . @ . . . . . . . . . @ . . . . . @ . @ . . . 
. . . . . . . @ . . @ . . . . . . @ @ . . . . @ . . . @ . . . . 
. . . @ . . @ . . . . . . . @ . . . @ @ . . . . @ . . . . . . @ 
. . . . . @ . @ . . . . . . . . . . . . . @ . . . @ . @ . . @ . 
@ . . . @ . . . . . @ . @ . . . . @ @ . @ . . . . . . . . . @ . 
. . . . . @ . @ . . . @ . @ . . @ . . . . . . . @ . . . . . . . 
. . . . . . . . . @ . . . . . . @ . . . . . . . . . . . . @ . . 
. . . @ . @ @ @ . @ . . . . . . @ . @ @ . . . . . @ . . . . . . 
. . . . . @ . @ . @ @ . . . . . . @ . . @ . . . . . . . . . . . 
. . . @ @ @ . . . . @ . . . @ . . . . . . . . . @ . . . @ . . . 
. . . . . . . . . . . . . @ . . . . . . . . . . . . @ . . @ @ . 
. @ . . @ @ . . . @ . . @ . . . . . . . . @ @ . @ . @ . @ . @ . 
. @ . . . . . . . . . . . . . . . . . . . . . . @ . . . . . . . 
. @ . . @ . . . . . . . . . . . @ . . @ @ . . . . @ . . @ . @ . 
. . . @ . . . . . . . . . . . . . . . . . . . . . . @ . @ . . . 
@ . . . . . . . @ . . . @ @ . @ . . @ . . . . . . . @ . @ . . . 
. . @ . . . . . . . . . . . @ . . . . . . . @ . . @ . . . . . . 
@ . . . . . @ . @ . @ . . @ . . . . . . . . @ . @ . . . . . . . 
. . . . . @ . . @ . . . . . . . . . . . . . . @ . @ . . . . . . 
. @ . . @ . . . . @ . . . . . . @ . . . @ . . . . . . . @ . . . 
. . @ . . . . . . . . @ . . @ . . . . @ . @ . . . . . . . . . . 
. . . @ . . . . . . . . . . . . @ @ . . . . . . @ . @ . . . . . 
. . . @ @ @ . @ . . . . @ . . . . . . . . . @ . . @ . . . @ . . 
@ @ . . . . . . @ . @ . @ @ . . . @ . . . . . . . @ . . . . @ . 
. @ . . . . . . . . @ . . @ . @ . . @ @ @ @ . . . . @ . . . @ . 
70
14 31 3 7
6 19 21 22
19 3 1 15
22 8 31 4
25 5 17 24
12 7 14 2
5 9 22 6
21 25 6 23
9 20 31 1
22 1 22 16
21 13 8 3
3 24 3 11
16 10 13 19
6 10 11 17
28 10 5 20
21 0 23 10
23 6 16 24
9 21 0 2
23 31 15 25
31 27 0 16
8 28 16 1
12 9 17 26
28 30 13 4
28 13 19 22
21 5 11 11
9 29 8 9
0 19 6 15
30 14 15 5
12 13 30 16
20 28 22 12
29 25 30 22
19 5 6 26
2 29 25 5
31 1 25 17
8 21 16 7
10 18 23 16
14 30 18 16
8 18 28 3
13 10 12 27
4 25 10 13
9 25 11 22
6 29 8 5
5 30 17 4
19 7 2 13
5 17 30 7
22 13 19 21
23 26 20 10
9 7 15 15
19 29 8 18
15 26 9 21
24 21 26 15
8 20 6 8
1 29 29 11
15 23 1 3
7 16 21 24
26 30 29 30
28 23 1 24
1 21 19 25
25 22 6 4
0 13 18 23
17 21 22 22
7 30 17 16
11 29 1 21
23 9 20 25
7 21 18 28
27 13 31 7
9 16 4 7
27 4 19 12
31 10 19 7
25 24 14 21
