32 32
. . . . @ @ . . . . . . . . . . . . . . . @ @ . . . @ . . . @ . 
. . @ . . . . . . . . @ . . . . . . . @ . @ . . . . @ . . @ . . 
. . . . . . . @ @ . @ . . @ @ . @ . @ . . . . . . @ . . @ @ . . 
. @ . @ . . @ . . @ . . . . @ . @ . . @ @ . @ . @ @ . . . . . . 
. . . . @ . . . . . . . . . . . @ . . @ . . . . @ @ . . . @ . . 
. . . . . . . . . @ . . @ . . . . . . @ . . . . @ @ @ . . . . . 
. @ . . . . . @ . . . . . @ @ . . . . . @ @ . . . @ . @ . . . @ 
@ . . . . . . . @ . . @ . . . . . . . . . . . @ @ . . . . @ @ . 
. . . . @ . . . . . @ . . . . . . . . @ . . . . . . . . . . . . 
. . @ . . . . . . . @ . . . . . . . . . . @ . . . . . . . . . . 
. . . @ . . . . . . . . @ . . . . . . . . . . . . @ . . . . . . 
. . . . . . . . . . @ @ . @ . . . . @ . . . . . @ . . . . . @ @ 
@ . . . . . . @ . @ . . . . . . . . . . . . . . . . . . . . . . 
. . . . . . . . . . . @ . . . . @ . . . . . @ . . . . . . . @ @ 
. . . . . . . . . . . . . . . @ . . @ . @ . . @ . . . . . . . . 
@ . @ @ . . . . . . @ . @ . . . . . @ @ . @ @ . . . . @ . . . @ 
. . @ . . @ @ . . . . . . @ . . . . . . . . . @ . . @ . . . . . 
. . . . . . @ . . . @ . . . @ . . . @ . @ @ . . . . . . @ . . @ 
. . . @ . . . . . . . @ . . . . . . . @ @ . . . . . . . . . . . 
@ @ . @ @ . @ . . . . . . @ . . @ . . . @ @ . @ . . . @ . . . @ 
. . . . . . . . . @ @ . . @ . . @ . . . . . . . . . . . . . . . 
@ @ . . . . . . @ . @ . . . . . . . @ . . @ @ . . . . . . . . . 
. . . . . @ . . . . . @ . . @ @ . @ . . . . . @ . . . . . . . . 
@ . . . . . . . . . . . @ . . . . . . . . . @ . @ . @ @ . . . . 
@ . . @ . . . . . @ . . . . . . . . . . . . . . @ @ . @ . . . . 
. . . . . . . . . . . . @ . @ . . . @ . . . . . . . . . . @ @ . 
. . . @ @ . . . . . . . @ . . @ . . @ . @ . . . @ . . @ @ . . . 
. . . . . . . . . . . . . . . . . . @ . . @ . . @ . . . @ . . @ 
. . . . @ . . @ @ @ . . @ . . @ . @ . . @ . @ . @ . . . . . @ . 
. . . . @ . @ @ @ . . . . . . . . . . . . . @ . . . . . . . @ . 
. . . . . @ . . . . . @ . . . . . @ . . . . . . . . @ @ @ . @ . 
. . . . . . @ . . . . . . . . . @ . . . . . . . . . . . . . . . 
60
9 17 28 9
15 19 10 5
0 22 6 30
17 17 25 28
27 29 23 15
11 12 14 24
25 31 1 11
15 8 14 4
16 18 19 11
17 5 10 27
10 3 16 15
13 5 5 28
5 14 2 31
23 0 28 15
30 8 25 1
4 9 2 22
21 18 12 9
20 25 7 15
17 25 26 31
12 6 18 12
26 20 17 15
13 22 5 7
14 26 12 30
21 30 5 2
11 2 28 14
9 19 2 24
6 13 9 17
30 21 7 19
2 23 5 17
17 0 13 27
29 23 3 2
2 3 8 25
15 21 20 25
18 8 1 0
12 16 18 18
3 12 10 18
22 17 23 13
10 18 29 21
25 1 24 14
25 13 14 0
21 25 19 20
13 12 13 5
15 11 27 14
12 21 10 16
11 10 14 14
31 23 3 27
15 7 31 24
6 20 31 0
3 28 15 19
16 30 22 18
28 24 16 22
1 20 5 26
25 15 15 11
10 1 22 5
31 8 24 8
25 9 22 24
1 24 12 31
24 25 15 4
3 20 11 27
19 23 0 9
