32 32
. . . . . . . . . . . . . @ . . . . . @ @ . . . . . . . . . @ . 
. . . . . . . @ . . . @ @ . . @ . . . @ . . . . . . . . . . . . 
. . . @ . . . . . . @ . @ . . . . . . @ . . . . . . @ @ @ . @ . 
. . @ . . . @ . . . . @ . . @ . . . . . . . . @ @ . . . . @ . . 
. . . . . . . . @ @ . . . . . . . . . . . @ @ @ . . @ @ . . . . 
. . . @ . . . @ . . @ . . @ . . . @ . . . . . @ . . . . . @ . . 
@ . . . @ . . . . . . . . . . @ @ @ @ . . @ . . . . . . . . . . 
@ . . @ . . @ . . @ . @ . @ . . . . . . . . @ . . . @ . . . . . 
. @ . . . . . . . . . . . . . . . . . . . . @ . . . . @ . . . . 
. . . . . . . . @ @ . . . . . @ . . @ @ . @ . @ . . @ @ . . @ . 
. . . . . @ @ . . @ . . . . . . . . . . @ @ . . @ . @ . . @ . . 
@ . . . . . . . . . . . . . @ @ . . . . . . . . @ . @ @ @ . . . 
@ . . . . . . . @ . . . . . @ . . . . . . . . . . . @ . . . @ . 
. @ . . . . . . . . . . . . . . . . . . . . @ @ . . . . . . . . 
. . . . . @ . . @ . . . . . @ . . . @ . . . . . . . @ . . . . . 
. @ @ . . . . @ @ . . @ . . . . @ . . @ @ . . . . . . . @ . . @ 
. . . . . . . . @ . . . . . . . . . . . . . . . . . @ . . . . @ 
. . . @ . . . . . . . @ @ @ . @ @ @ @ . . . . @ . . . @ . @ . @ 
. @ @ @ . . . @ . . . . . . @ . . @ . @ . . . @ . . . @ . . . @ 
. . . . . . @ . . . . . @ @ . . . @ . . . . @ . . . . . . . @ . 
. . . . . . . . . . @ . . . @ . . . . . . . . . . @ . . . @ @ . 
. . . . . . . . . . . . . . . . @ . @ @ @ . . . @ . . . . . . . 
. . . . . . . . . @ . . @ . . @ . . . @ . . @ . . . . @ . . . @ 
. . . . . @ . . . @ . . . . . . . @ . @ . . . @ . . . . . . . . 
. . . . @ . @ . . . . @ . . . . @ . . . . . . . . . . . . . . . 
. . . . . . . . . . @ @ . . . . . . @ . . . @ . . . . @ . @ . . 
. . @ . . . . @ @ . . . . . . @ . . . . . . . @ @ . . . @ . . @ 
. . @ @ . . . @ @ . . @ . . . . . . . . . . @ . . . . . . . @ @ 
. . . . . @ . . . @ @ . . . . . . . . . . . . . . @ . . . . . . 
. . @ . . . . . . @ . . . . . . . . . . . . . . . . @ . . @ . . 
. @ . . . . . . . . . . . . @ . . . @ @ . . . . . . . . . @ . . 
. . . . . . . . @ @ . @ @ . . . . . . . . . @ @ . @ . . . . . @ 
20
16 19 3 28
16 2 29 1
29 31 24 16
28 23 12 30
26 5 6 14
6 18 24 29
1 29 4 25
7 29 22 23
8 13 27 14
18 7 8 3
14 24 17 2
20 2 12 10
28 14 24 18
31 3 9 20
17 20 10 13
22 30 25 6
20 30 28 8
1 19 19 8
14 28 22 26
26 3 11 30
