32 32
. @ . . @ . . . . . . . . . @ @ @ . . . . . @ @ . @ . @ . . . @ 
. . . . . . . . @ . @ . . . . . . . . @ . . . @ . . . @ . @ . . 
. . . @ . @ . . . . . . . . . @ . . . . . . . . . . . . . . . . 
. @ . . . . . . . . . . . . . . @ . . . . @ @ . @ . . . . . . . 
. . . . . . . @ @ . @ @ . . . . . . . @ . . @ . . . @ . . . . . 
. . . . . @ . . . . . . . . @ @ . . . . . . @ @ . . . . . . . . 
. . . . . . . @ . . . . @ . @ . . . . @ . . . . . . . @ @ . . . 
@ . . . . . . . . . . @ . . . . @ . @ . . . . @ . @ . . . . . . 
. . . . @ . . @ . @ @ . @ . . . . . . . . . . . . . . . . . . . 
. @ @ . . . @ . . . @ . . . . . . . . . . @ @ . . @ . . @ . @ . 
@ . @ . . . @ . . . @ . . . . . . . . . . @ @ @ . . . . . @ . . 
. . . . @ . . . . . . @ @ @ . . . @ . . . . . @ . @ . @ . . . @ 
. @ . . . . . . @ . . . . . . @ . @ . . . . . @ . . . . . . . @ 
@ @ @ . . . . . . . . . . . . . @ . @ . . . @ . . . . @ . . . . 
. . . @ . . . . . . . . . . . . . . . . . . . . . . @ . . @ . . 
. . . . . @ . @ @ @ . . . . . @ . . . . @ . . . . . . . . @ . @ 
. @ . . @ . . . . . . . . . . . @ . @ . . . . . . . . . . @ . @ 
@ @ . . . . @ . . . . . . . . . . @ . @ . . @ . . . . . . . . . 
. . @ @ . . . . . . @ . . . . . @ . . . . @ . . @ @ . . . . @ . 
@ @ . @ . . @ . . @ . . . . . . . . @ . . . @ . @ @ . . . . . @ 
. . @ @ . . . . . . . . . @ . . . . . . . . . . @ . . . . . . . 
. . . . . . . . . . . . . . . . . . . . @ @ . . . . . . . @ @ . 
. . . . . . @ . . @ . @ . . @ . . @ . . @ . . . . . . . . . . . 
. @ . @ . . @ . . @ @ . . @ . . . . . . . . . . . . . . @ . . . 
. . . @ . . . . . . . . @ . . . . . . . . @ . . . @ . . . . . @ 
. . . . . . . . . @ . . . @ @ . @ . . . . . . @ . @ . . . . @ . 
@ @ . . . . . . . . . @ . . . . @ . . . @ . . . . . @ . . @ . . 
. . . @ . @ @ . . . . . . @ . . @ . . . . . @ . @ @ @ . . . . . 
. . . . . . @ . . . . . . . . . . @ . . . . . . @ . . . . . . . 
. . . @ @ . . @ . . . . . . . . . . . . . . . . . @ . . . . @ . 
. . . . . . . . . . @ . . . @ @ . . @ . . . . . . . . . . . . . 
. . . . . . @ @ . @ @ . . . . . . . . @ . . @ @ @ . . @ . . . @ 
60
22 2 18 10
3 5 14 1
5 17 3 11
2 11 5 23
6 29 17 19
17 26 17 3
2 27 19 8
0 5 5 9
10 28 8 3
14 10 30 30
9 9 13 21
22 15 31 22
15 20 25 5
8 23 25 1
25 1 6 8
8 16 13 22
17 30 17 31
18 6 28 27
29 27 24 29
11 16 5 28
7 17 4 12
29 24 26 21
1 7 11 19
22 30 4 4
1 30 4 20
23 4 22 28
25 17 7 0
15 24 22 20
29 30 15 21
20 0 21 29
23 26 19 0
31 27 6 0
17 0 2 5
7 2 31 21
5 30 22 2
31 30 1 30
2 7 7 3
10 21 10 13
4 22 1 24
14 15 8 8
2 16 24 5
7 9 13 16
7 23 22 12
30 2 24 22
24 1 23 24
17 8 17 9
20 3 7 10
16 12 18 26
22 26 19 20
26 3 24 11
28 24 7 17
7 11 27 2
5 10 28 26
6 7 31 10
29 4 27 15
19 25 29 11
13 18 17 18
0 25 8 0
9 5 0 29
19 20 1 14
