32 32
. . @ . . . @ . . @ . @ . . . . . @ . . . . . . . @ . . @ . . @ 
. . . @ . . @ . . . @ . . . @ @ . . . @ . . @ . . @ . . @ . . . 
. . . . . . . . . . @ @ . . . . . . . . . . . . . . . . . . . . 
. . . @ . . . . . @ . @ . @ @ @ . . . . . @ @ @ @ . . . . @ . . 
. @ . . . . . . . . @ . @ . . . . . . @ . . . . @ . . . . . . . 
. . . . . . @ . . @ . . . . @ . . . @ . . . . . . . . . . . . . 
. . . . . . . . . @ . . . . @ . . . . . . . . . . . . . . . . . 
. . . @ . . . . @ . . . @ . . . @ @ . . . . @ @ . . . . @ . . @ 
. . . . . @ . . . . . . . . . . @ . . . . . . @ @ . @ . . . @ . 
. . . . . @ . . . . . @ @ . . @ . . . . . @ . . @ . . . . . . . 
. . . . . . @ . . . . @ . . . . @ . . . . . . . @ @ . @ . . . . 
. @ . @ @ . . . . . . . . . . . . . . @ . . @ . . @ . . . . @ . 
. . . . . . . . . . . . @ @ . . . . . . . @ . @ . @ . @ . . . @ 
. @ @ . . . @ . . @ . . @ . @ . . @ @ @ . @ . . . . . . . . . . 
. . . . @ . @ . . . . . . . . . . . . . . @ . . . . . @ @ @ @ . 
. . . . . . . . . . . . . @ . . . @ . . . @ . @ . @ . . . . . . 
. . . . . . . . . . . . . @ . . . . . @ . . @ . . . . @ . @ . . 
. . . . . . . @ . . . @ . . . . @ . . . . . @ . @ . . . . . . . 
. . . . . @ . . . . . @ . . . . . . . . . . . . . @ @ @ @ . . . 
. . . @ . @ @ . . . . . @ @ . @ @ . . . . . . @ . . . . . @ @ . 
. . . . . . . @ . . . @ . @ . . . @ . . @ . @ . . . . . . . . . 
. @ @ . @ . . . @ @ . . . . . . @ @ . . @ . @ . . . . . . @ . . 
. . @ . . . . . . . . . . . . . . . . . . . . . . . . . . . . . 
@ . . @ . . @ . . . @ @ . @ . @ . . @ . . . . @ . . . . . @ . . 
. . . @ . . . @ . . . . @ . . . . . @ @ . . . . . . . . . . . . 
. @ @ @ . . . . . . . . . @ . . . . . . @ @ . . . @ . . @ . . . 
. . . . . . . . . . . . . . . . . . @ . . . . . . . . . . . . . 
. . . . @ . . @ . . @ . @ @ . . . . . . . . . . . . @ @ . . . . 
. . @ @ . . . . . . . . . . . . . . . . . . . . @ . . @ . @ . @ 
. . . . . @ . . . @ @ . . . . . . @ @ . . . . @ @ . . . @ @ . . 
. . . @ @ @ . . . . @ . . . . . . . . . . . . . . . . . . . . . 
. @ . . . . . . . @ . . . @ . @ @ . . @ . . . . @ . . . . . . . 
60
4 1 26 7
8 28 31 27
31 17 22 23
4 3 8 3
1 23 4 26
8 1 21 4
27 20 23 1
31 30 29 13
13 9 22 6
31 11 20 30
4 4 2 7
21 28 11 21
12 5 15 29
15 11 21 17
7 5 11 11
14 25 21 19
17 1 2 10
23 28 11 7
0 3 8 19
25 14 8 24
22 13 14 10
1 27 4 10
7 22 30 25
11 8 19 17
0 26 13 8
17 2 29 9
28 5 10 13
5 6 16 13
28 10 1 9
2 23 14 12
26 16 13 6
25 7 7 6
24 12 30 21
16 23 19 30
11 30 30 30
14 26 25 3
4 19 11 15
7 14 30 22
6 20 29 6
2 26 29 18
21 21 4 16
5 23 4 4
16 15 21 6
16 24 25 29
10 10 29 8
17 17 3 10
7 23 0 0
0 24 20 24
7 6 24 5
24 13 4 17
9 27 19 12
23 10 6 12
5 10 30 24
28 12 11 26
14 11 9 19
7 0 27 6
26 2 30 23
13 2 2 5
31 23 18 8
6 22 20 18
