32 32
. . . . . . @ . . . . @ . . . @ . . . . . . . . . . . @ @ . . . 
. . . . @ . . . . . . . . . . . . . . . @ . . . . @ . . . . . . 
. . . . @ @ @ . . @ . @ @ @ . . . . @ . . @ . . . . . . . . . . 
@ . . . . . . . . . @ . . . . . . . . . . @ . . . . @ . . @ . . 
. . @ . . @ . . . . @ . @ . @ . . . . . @ . . . @ . . @ . . @ . 
. @ @ . . . . . . . . . . @ . . . . . . . . . . . @ . . . . . . 
. @ . . @ . . . . . . . . @ . @ . . . @ . . . . @ @ . . . @ . @ 
@ @ @ . . @ . . . . @ . . . . . . @ @ . . . @ . @ . . . . . . . 
. @ @ . . . @ . . @ . . . . . . @ . . @ . @ @ . . . . . @ @ . . 
. . . @ . . . . @ . . . . . . . @ . . . . . @ . . . . . . . . . 
@ . . @ . . . @ . . . . . . . . . . . . . . . . @ . . . . @ . . 
. . . @ . @ @ . . @ . . @ . . . . . @ . . . @ . . . . . . . . . 
. . . . . . . . . @ . . . . . . . . @ . . . . . . . . . @ . . . 
. @ . . . @ . . . @ . @ . . . . . . . @ . . @ @ @ . . . . . @ . 
. @ . @ . . @ . @ . . . . . . . . . @ . . . . . . . . @ . . . @ 
. . . . @ . . . . . @ @ @ . . . . @ . . @ @ . . . @ . . . . . @ 
. . . . . @ . . . . . . @ . . . . . . @ . . @ . . . @ @ . @ @ . 
. . . . . . . . . . . . @ . . @ . @ . @ . . . . . . . . . . @ @ 
@ . . @ . . . . . . @ . . . @ . . . . . @ . @ . . . . . . . . . 
. . . . . . . @ @ . . . . . . @ . @ . . . . . @ . . . . . . . . 
. @ . . . . . . . . @ . @ . . . . . . . . . . . . . . . @ @ . . 
@ . . . . @ @ . . . . . @ @ . . . . . . . . . . . . . . @ . . . 
. . . @ . . . @ . . . . . . @ . . . . . . @ . . . . . . @ . . @ 
. . . . . @ . @ . . . . @ . . . . @ . @ . . . . . . . . . . . . 
. . . . @ . . @ . . . . . . . . @ @ . . @ @ . . . . @ . . @ . . 
@ . . . . . . @ . . . . . . . . . . . @ @ . . . @ @ . . . . . @ 
. . . . . . . . . . . . @ . . @ . . . @ @ . . . . . . @ . . . . 
. . . . . . . . . . . . . @ . . . . . @ . @ . . . . . . @ @ . . 
. . . . . @ @ . . . . @ @ @ @ @ . . . . . @ . . @ . . . @ @ . . 
. . . @ . . @ . . . . . . . . @ . . . . . . . . . . . . . . . . 
. . . . . . . . . . . @ @ . . . . . . . . . . @ . . . . . @ @ . 
. . @ . . . . . . @ . @ . . . . . . . . @ . . . . . . @ . . . @ 
10
16 21 14 13
13 17 29 21
17 10 0 24
2 16 8 21
14 23 28 5
25 17 15 31
9 10 14 23
14 27 9 26
23 23 13 31
28 14 23 6
