32 32
. . . . . . . . . . . . . . . @ . @ . . . @ . . . @ @ . . . . . 
. . . . @ . . . @ . . . . . . @ . . @ . @ . @ . @ . . . . . . . 
. @ . . @ . @ @ . . . . . . . . . . . . @ . . . . @ . . . . @ . 
. . . @ @ . . @ . . @ . @ . . . . @ . . @ . . . . . . . @ . . . 
. . . . . . . . . . . . @ . . . . . @ . . @ @ @ . . . @ . . @ @ 
@ . . . . . . . . . . . . . @ . . . @ . . . @ . . @ @ @ . . . . 
. . . @ @ . . . . @ . . . @ . . @ . @ . . . . . . . . @ . . . . 
@ . . . . . . . . . . . . . . . . . . . . . . . @ @ . . . . . @ 
. . . . . . . . . . @ . . . . . . . . @ @ . . . . . @ . . . . . 
@ . . . . . . . @ @ . @ . . @ . . @ @ . . . . . @ . . @ @ . @ . 
@ . . . . . . . . . . . . . . . @ . . . . . @ @ . . . . . . . @ 
. . @ . . @ . . . . . . . . . . . . . . . . . . @ @ @ @ . . . @ 
. . . . . . @ @ @ . . . . . . . @ . @ . . . . . . . . . . . . . 
. . . . . . . . . @ . @ . . . . . . . . . @ @ @ . . . . . . . . 
. . @ @ . . . @ . @ . . . @ . . . . . . @ . @ . . . . . . . . . 
@ . @ @ . . . @ . @ . . . @ . . . . . . . . . @ . . @ @ @ . . . 
. . . . . . . . . . . . . . . @ . @ . . @ . . @ . . . . . @ . . 
. . . @ . . @ . . . . @ . . . . . @ . . . . . . . . . @ . . . @ 
. . . . . @ . . . . . . . . . . . . . . @ . . . . . @ . . . . . 
. . @ . @ . . . . . . @ . . . . . @ . . . . @ . . . . . . . . . 
. . . @ . @ . . @ . . . . . . . . . . @ @ @ . . @ . . . @ . @ . 
. . . . . . . . . . . @ . @ . . . . . . . . @ . @ @ . . . . . . 
. . . . . . . . . . @ . @ . . . . @ . . . . . . . @ . @ . . @ . 
@ . . . . . . @ . . . . @ . @ @ . . . . . . . @ . @ . . . . . . 
. . . . . . @ . @ . @ @ . . . . . . @ . . . @ @ . . . . . . . @ 
@ . . @ . . . . . . . . . @ . . @ @ . . . . . . . @ . . @ . . . 
. . @ . . . @ @ @ . . . . . . . . . @ @ . . . . . . . @ . . . @ 
. . . . . . . . . . . @ . @ . . . . . . @ . . . . . . . . . . . 
@ . . . . . . . . @ . . @ @ . . . . . . . . . . . @ . . . . . . 
. @ . . . @ . . . . . @ . . . . @ . . @ . . . . . . . . . . . . 
. @ . @ @ . . @ . . . . . . . . @ . . . . @ . . . . . . . . @ . 
. @ . . . @ @ . . . . . . . @ . . . @ . @ @ . . . @ . . . . . . 
90
20 19 12 25
6 5 13 3
29 14 27 28
1 14 14 18
27 21 11 6
27 14 30 24
29 7 6 5
28 30 8 5
29 1 9 30
19 16 9 8
28 10 22 25
0 21 25 4
10 19 26 28
16 9 4 12
12 15 5 12
11 11 22 20
20 12 27 2
2 30 3 29
16 0 3 5
10 1 5 6
21 11 31 0
28 28 27 29
9 8 8 3
21 3 8 25
22 3 3 27
12 29 8 15
24 30 2 22
23 29 0 12
4 28 10 11
19 25 20 29
19 11 6 4
15 7 4 21
29 15 7 7
28 5 2 3
11 1 13 19
23 28 9 31
24 10 19 24
14 11 5 1
31 30 1 19
15 24 20 10
16 28 4 7
30 25 23 22
26 13 12 18
22 27 9 0
31 15 2 13
13 8 5 14
12 2 23 27
15 9 13 17
28 22 13 23
12 16 4 28
15 26 26 30
26 23 14 13
23 19 6 29
2 6 20 28
9 4 27 16
5 14 2 7
30 13 16 22
6 7 12 0
11 31 12 26
6 22 22 16
5 17 20 25
25 18 0 4
4 13 2 9
10 14 18 30
0 11 19 7
12 7 22 15
2 24 21 1
30 6 30 29
0 27 0 8
24 22 7 25
27 1 13 13
22 30 12 24
8 19 3 31
27 10 26 22
24 19 28 14
21 25 26 19
24 2 28 24
12 0 12 15
13 11 31 6
7 8 7 29
7 10 9 22
29 23 26 31
3 0 22 23
16 27 16 15
7 22 31 29
10 25 7 13
7 9 27 8
3 24 13 8
15 27 31 25
3 13 11 22
