32 32
. @ . . . @ . . @ . . . . @ @ . . . . . . . @ @ . . . @ . @ . . 
. @ . . . . . @ . . . . . . @ @ @ . @ @ @ . . @ . . . . . . . . 
@ . . . . . . @ . . . . . . . . . @ . . . . . . . . . . . @ . . 
. . . . . . . . @ . @ . . . . . . . . . . . . @ . @ . . . @ . . 
@ . . . . . . . . @ @ . . . . . @ @ . . . . . . . . . . . . . . 
@ . . . . . @ . @ . . . . @ . . . . @ . . . . . . . . . . @ @ . 
. @ @ . . . . . . . . . . @ . . . . @ @ . . . @ . . . . . . . . 
. . . @ @ . . @ . . @ . . . . . . . . . . . . . . @ . @ . . . @ 
. @ @ . . . . . . @ . . . . . . @ @ . @ . @ . . @ . . . . @ . . 
. . . . . @ . . . . . . . . @ . @ . . . . . . . . . . . . . . . 
. . @ . . . . . . . . @ . . . . @ . . . . . . . . @ . . . . . @ 
. . . . . . @ . . . . @ . . . . @ @ @ . . . . . . . . . @ . . . 
. . . . @ @ . . . . . @ . . @ @ . . @ . . . . . . @ . . . . . . 
@ . . . @ . . @ . @ . @ @ . . . . . . . @ . . . . @ . @ . . . . 
. . . . . . . . . . @ . @ . . @ . . . . . . . . . . . . . . . . 
. @ . . . . . @ . @ . . . . . . . . . @ . . . . . @ @ @ . . . . 
@ . . . . @ @ . . . . . . . . . . . . . . . . . . . . . . . . @ 
. . . @ . . . . . . . @ @ . . . . . . . @ . . . @ . @ @ . . . . 
. . . @ @ . . . . . . . . . . . . . . . . . . . @ . . . . @ @ . 
. . . . @ . . . . . @ . . @ . . . . . . . . . @ . . @ @ . . . . 
. . . . . . @ . @ @ @ @ . . . . @ . @ . . @ . . @ . . @ . . . . 
. . . . . @ . . . . . . . . . . @ . @ . . . @ . . . . . . . @ . 
@ . . . @ . . @ . . . @ . . . @ . . . @ . . @ . . . . . . @ . . 
. @ . . @ . @ . . . @ @ . . @ . . . @ . . . . . . . . . . . . . 
. @ . . . . . . . . . . @ . . . . . . @ @ . . . @ . . . . . . . 
@ . . @ . @ @ @ . . . @ . . . . . @ @ @ . @ . . @ @ . . . . @ . 
. @ . @ . . . . . . . . . . . . . . . . . . . . . . . . . @ . @ 
. @ . . . . . @ . . . . . . . @ . . @ @ . . . @ . @ @ . . . @ . 
. . @ . . . . @ . . . . . . . . . . . . . . . . . . . . . . . . 
. @ . . . . @ . @ . . . . . . . . . @ . . . . . @ . . . . . . @ 
. . @ . . @ . . . . . . @ . . @ . . . . . . @ . . . . . @ . . . 
. . . . . @ . . . @ . @ . . . . . . . . . . . . . @ @ . @ . . . 
70
14 24 2 4
20 30 15 25
22 31 22 23
27 23 25 17
2 23 26 7
5 6 31 14
6 13 14 31
5 1 25 6
4 25 25 24
31 5 19 14
15 15 30 13
15 28 8 1
30 3 2 29
20 4 31 3
20 27 12 6
15 2 12 29
14 26 10 26
10 16 7 3
13 28 8 10
11 6 17 31
31 13 18 8
24 15 23 4
10 2 14 25
4 29 31 9
12 28 26 21
3 2 10 25
15 19 13 30
25 17 11 3
2 9 2 7
31 20 6 2
14 14 25 19
27 12 25 0
2 27 8 28
2 2 25 22
11 29 12 28
15 11 18 19
27 21 29 23
0 15 24 4
16 24 19 3
29 10 4 10
0 10 20 11
29 27 31 25
2 7 24 0
13 20 0 17
24 16 23 10
28 28 24 26
12 6 29 28
20 22 24 6
3 6 28 29
26 11 17 30
27 29 25 2
31 23 9 25
9 5 26 26
1 16 15 9
31 1 28 18
7 24 2 22
19 2 31 15
29 28 1 14
4 10 4 17
16 5 22 1
26 22 3 22
26 16 12 23
19 19 26 24
10 12 26 2
9 6 17 19
23 15 28 28
26 3 17 16
7 16 13 31
14 25 6 17
18 19 29 13
