32 32
. . @ . . . . @ . @ . . . . . . . . . . . . . . @ . . . . . . . 
@ . . . @ . . . . . . @ . . . . @ . @ . . . . . . . . . @ @ . . 
. . . . . . . . . . . . . . . . . . . @ . . . . . . . . . . @ . 
. . . . . @ . . . . . . . @ . . . . . @ . . . . . . . . . . . @ 
. . . . . . . . . . . @ . . @ . @ . . . @ . . . . . . @ @ @ . . 
. . . . @ @ . . . @ . . @ . . @ . . . . . . . . . . . . @ . . . 
. @ . . . . . @ . @ . . @ . . . @ @ . @ . @ . . . @ . . @ . . . 
. . . . @ . . . . . . . . . . . . . . . . . . . . . . . @ . . . 
. @ . . . . . . @ . . . . . . . . . @ @ . . @ @ . @ . . . . . . 
. . @ . . . . . . @ . @ . . . . @ . . . . . . . . @ . . . . . . 
. @ @ . . @ . . . @ @ . . . . . . . . @ @ . . . . . . . @ . . . 
. . @ @ @ . @ . . . @ . . . . . . . @ . @ . @ . . . . @ . . @ . 
. . . @ . @ . . @ . . . . @ @ . . @ . . . . . . @ @ . . . . . @ 
@ . . . . . . . . . @ . . . . @ . . @ . @ . . @ . . . . . . . . 
@ . . . . . . . . . . . . @ @ @ . @ . . . . . . @ . . . @ @ . . 
@ . . . @ @ . . . @ @ . . . @ . . . . . . @ @ . . @ . . @ . @ @ 
@ @ . . . . . @ . . . . @ . . . . . @ . @ . . @ . . @ . . . . . 
. . @ . . . . @ . @ . @ . . . @ . . . @ . . . . . . . . . @ @ @ 
. . @ . @ . . . . . . . . . @ . . . @ . . . . @ . @ . @ . . @ . 
. . . . . . . @ . . . . . . . @ . . @ . @ . . . . . . . . . . . 
. . . @ . @ . @ @ . . . @ . @ . . . . . . @ . . . . . . @ . . . 
. . . . . . . @ . @ . . @ . . . . . . . . . . . . . . @ . . . . 
. . . . . . . . @ . . . @ @ . . . . . . . . . @ . @ . . . . @ . 
. . . . @ @ . . . . . . . . @ . @ @ . @ . . . . . . @ . @ @ . . 
. @ . . . . . . . . . . . . . @ . . . . . . . . . . . . . . . . 
. . . @ @ . . . . . . . @ @ . @ . @ . @ . . @ . . . . . . . . . 
. . . . . . . . . . . . . . . . . . . . . . . . . . . . . . . @ 
. . . . @ . . @ . . @ @ . . . . . . . . @ . . @ . @ . . . . . . 
@ . @ . . . . . . . @ . . . . @ . . . @ . @ . . . . . . . @ @ . 
. . . . . . . . . . . . . . @ . . . . . @ . . . . . . @ . . . . 
@ . @ . . . @ . . . . . . . . . . @ @ . . . . . @ . . . . . . . 
@ @ . . . @ . . . . . . . @ . . @ . . . . . . . @ . . . . . . . 
40
24 15 7 28
8 27 31 8
19 30 18 5
5 22 17 29
29 29 7 26
27 1 12 31
1 5 6 25
29 24 20 14
4 12 1 9
16 27 25 3
8 29 25 30
31 18 1 3
26 1 19 29
23 29 29 6
21 10 7 13
28 31 3 4
3 7 21 17
22 28 16 27
24 29 27 8
18 2 16 16
0 4 19 1
10 21 25 13
17 26 22 12
16 10 27 1
2 3 28 28
30 26 14 28
2 2 4 2
25 30 16 22
10 16 24 7
14 27 13 9
1 17 0 23
4 31 3 2
11 0 13 21
3 18 16 2
24 23 6 28
5 25 23 10
5 30 5 24
16 15 8 7
26 13 4 24
28 26 13 20
