32 32
. . @ . . @ . @ @ . . . . . . . . . . @ . . . . . . . @ @ . . . 
. @ . . . . . . . @ . . . . . . @ . . . . . . . @ . . . @ . . . 
@ . . . @ @ . . . . . . . . . . @ . @ . . . . . . @ . . . . . . 
. @ . . . . @ . . @ . . . @ . . . . . . . . . . . . . @ . . . . 
@ . . . @ . . . . . . . . . . . . . . . . . @ . . . . . . @ . . 
@ . . . . @ @ . . . . . . @ . . . . @ . . . . . . . . @ @ . . . 
. . . . @ @ @ . . . . . . . . . . . @ @ @ . . . . . . . . . @ . 
. . . @ . . . . @ @ . . . . . @ . . . . . . . . . @ @ . . @ . @ 
. @ . . . . . . . @ . . @ . @ . @ . . . . . @ . . @ . . @ . . . 
. . . . . . . . . . @ . . . . . . . . @ @ . . . . . . @ . @ . . 
. . . . @ . @ . . . . . . . . . . . . @ @ . . . . . . . . @ . . 
. . . @ . . . . @ . . @ . @ . . . . . . . . . . . . @ @ . . . . 
. . . . . . . @ . . . @ . . . . . . . . . . @ . . . . @ . . . . 
. . . . . . . @ . @ @ . . . . . . . . . . . . . @ . . . . @ . . 
. @ . . @ . @ . . . . . @ . . @ . . . . . @ @ @ . . . . . . . @ 
. . . . . @ @ . @ . . . . @ . . . . . @ . . . . . @ . . . . . . 
. @ . . . . @ . @ . . @ . . . @ . . . . . . @ . . . . . . . . . 
@ . . . . . . @ @ . . . @ . . . . . . @ . . @ . . . @ . . @ . . 
. . . . . . . . . . . . . @ @ . . . . . . @ . . . . @ . . . . . 
. . . @ . . . . . . . . @ . . @ @ . . . . . . . @ @ . . @ . . @ 
. . . . . @ @ . . @ . . . . @ . @ . . . . @ . . . . . . . . . . 
. . . . @ . . @ . . . . . @ . . . @ @ . @ @ . . . . . @ . . @ @ 
. . @ . . . . @ . . . . . . @ . . @ @ . @ . . . . . @ . . . . @ 
. . . . . . . @ . . . . . . . @ . . . . . . . @ . @ . . . . . @ 
. @ @ @ . . @ . . @ @ @ . . . . . . . . @ @ . . . . . . . . @ @ 
. . . . @ @ . . . . . . @ . . . . . . @ . . . . . . . . . . . . 
. @ . . @ . . . . . . @ . . . . . . . @ @ . . . . @ . . . . . . 
. . . . @ . @ . . . @ . . . . . @ . . . . . . . . @ @ . . . . . 
. . . . @ @ . . . . . @ . @ . . . . . . . . . . . . @ . . . . . 
@ . . . . . . . @ . . @ . . . . . . . . . . @ . @ . . . . . . . 
. . . . @ . @ . @ . . @ . @ . . . . . @ . @ . . . . . . . . . . 
@ . @ . . . . @ . . @ . . @ . . @ . @ . . . . . @ . . . . . . . 
20
0 8 5 10
30 26 8 23
24 10 1 19
5 12 25 24
26 2 30 2
9 6 15 12
17 15 29 16
22 15 23 24
7 20 16 25
26 19 14 16
28 11 9 25
16 12 5 19
28 2 26 4
20 15 1 6
3 27 23 10
24 18 0 27
21 31 26 0
18 3 10 17
13 29 8 28
22 23 29 21
