32 32
. @ . @ @ . . . . . . . @ . . . . @ . . @ @ . @ . . . . . . . . 
. . . @ . . . . @ . @ . @ . . . @ . . . . . . . . @ . . . . @ . 
. . . @ . . @ . . . . @ . . . @ . . . . . . . . . . . . @ . . . 
. . . . . . . @ . . . @ . @ . . . . . . @ . . . @ . @ @ . . @ . 
. @ . . . @ . . . @ . . @ . . @ @ . . . . . . . @ . . . . . . @ 
. . . @ . . . . @ . . . @ . . . . . . . . @ . . @ . . . . @ . . 
. . . . @ . . . @ . . . . . . @ . @ @ . . . . @ . @ . . . @ . @ 
. . . . . . . . . . . . . . . . . . @ . @ . . @ . . . @ . . . @ 
. . . . . . . . . @ @ . . . . . . . . . . . . . . . . @ . @ . . 
. . . . . . @ . . . @ @ . . . @ . . . @ @ @ . . @ . . @ . @ . . 
. @ @ . . . . . . . . @ . @ . . @ . . . @ . . . . . @ . . . . . 
. @ . . @ . . . . @ @ . . . . . . . . . @ . @ @ . @ . . . . @ . 
@ . . . . @ . . . @ . . @ . . . . . . @ . . . @ . . . . . . . . 
. . . @ . . . . . . . . . . . @ . . . . . . . . . . . . . . . . 
. . . @ . . . @ @ . . . @ . . . . . . . . . . @ . @ . . . . . . 
. @ . . . . . . . . . . . . . @ . . . . . . . . . @ . . . . @ . 
. . . . @ @ . . . . . @ . . . . . . @ . . . . . . . . . . . . . 
. . . . . . . . . . . . . . . . @ . . @ . @ @ . . . . . @ . @ @ 
. . . . . @ . . . @ . . . @ . . . . @ . . . . . . . . @ @ . . . 
. . . . . . . . @ @ . . . . . . . . . . . . . . . @ . . . . @ @ 
. @ . @ . . @ . . . . . @ . @ @ . . . . . . . @ @ . . . . . . . 
. . @ . . . . . . . . . . . . . @ @ . . . @ . @ . . @ . . . . . 
. @ . . . . . @ . . @ . @ @ . . . . . . . @ . . . @ @ . . . . . 
. . @ . . . . . . @ . . . . . . . . @ . . . . . . . . . . @ . . 
. . . . . . . . . . . . @ @ @ . . . . @ . @ . . . . . @ . . . . 
. @ . . . . . . . . . . . . . . @ . . . . . . . @ . . . . . @ . 
@ . . . . . . @ . @ . . . . . @ . . . . @ . @ . . @ . . . @ . . 
. @ . . @ . . . . . @ @ . . . . . . . . @ @ . . . @ . . . . . @ 
. . . . . . . . @ @ @ . . . . @ . @ . . . . . . . . . . . . . . 
. @ . @ @ . @ . . @ . . . . @ . . . . @ . . . . @ . . . . . @ . 
@ @ . . . . . . @ . . . @ . . . . . . . . . . . . @ . . . . @ . 
. . . . @ . . @ @ @ . . . . @ . . . . . . . . . . @ . . . . . . 
40
0 13 5 0
10 29 5 2
24 28 3 16
12 27 12 8
25 28 23 8
1 7 10 18
13 13 16 19
31 30 3 24
26 27 28 13
10 17 8 23
11 26 25 25
17 13 10 14
7 2 27 14
25 24 5 19
22 28 7 20
10 25 0 15
27 30 29 18
12 2 13 13
13 15 16 12
16 13 31 29
31 11 15 23
2 26 7 18
2 24 8 13
27 12 10 2
16 7 3 15
13 14 11 30
0 23 3 17
20 8 4 12
26 1 13 6
30 22 24 12
29 31 11 25
22 16 0 0
6 23 15 27
11 1 10 19
19 4 20 12
4 30 22 5
26 0 12 16
5 19 10 15
25 10 27 15
3 3 9 1
