32 32
. . . . . . . . @ . . . . . . . . @ . . . . @ @ . @ . @ . . . . 
. . . . @ . @ . . @ . . . . . @ . . . . . . . . @ . . . @ . . . 
. . . . . . . . . @ . @ @ . . @ . . . . . . . @ . . . . . . . . 
@ . @ @ . . @ . . . . @ . @ . . . @ . . . . . . . . . . . . . . 
. @ . . . . . . . . . @ . . . . . . . . . . . @ . . . . . @ @ . 
. . . . . . . . . . . . @ . . . . . @ . . . . . . . . @ . . . . 
. . @ @ . @ . . . . . . . . . @ . @ @ . . . . . . . @ . . . @ . 
. . . . . . . @ . . . . @ . . . . . @ . . . . . . . . . . . . . 
. . . . . . @ @ . @ . @ @ . . . @ . . @ . . . . . . . . . . . . 
. @ . . . . @ . . @ @ . . . . @ . . . . . . . . . . . @ . . . . 
@ . . . . @ . . @ . @ . . . . . @ . . . @ . . @ . . @ @ . . . . 
. . @ @ . @ . @ . . @ . . @ . . . . @ @ @ . . @ . . @ @ . . . . 
. . . . . . . . . . . . . . . . . @ . . . @ . . . . . . @ . . . 
. . . . . . . . . @ . . . . . . . @ . . @ . . . . @ @ . . . . . 
@ @ . @ . @ @ . . @ . . . @ . . @ . . . @ @ . . . . . . . . . @ 
. . @ . . @ . . . . . . . @ . . . . . . @ . . @ @ . . . . . . @ 
. . . @ . . . . . . . . . . . . . @ @ . @ . . . . . @ . . . @ . 
. . . . . . . . . . . @ . @ . @ . . . . . . . . @ . . . . . @ @ 
. . @ . @ . @ @ . . . . . . . . . . . @ . @ @ . . . . . . . . . 
. . . . @ . . @ @ . . . . . . . . . @ . @ . . . . . . . @ . . . 
. . . . @ @ . . . . . . @ . . @ . . . . . . @ . . @ . @ @ . . . 
. @ . . . . . . @ . @ . . @ . @ . . . . @ . . @ . . . @ . . . . 
. . . . . . . . @ . . . @ . . . . . . . . @ . . @ . @ . . . . . 
. . . . . @ @ . . . . . . . . @ @ . . . . . . . . . . . . @ . . 
. . . @ @ . @ . . . @ . . . . . . @ . . . . . . . . . . . . . @ 
. . @ . . . . @ . . . . . . @ . . . . @ . . . @ @ . . . @ . . . 
. . . . . . . @ . . . . . . . . @ . . . @ @ . . @ . . . . . . . 
. . @ . . @ @ . . @ . . @ . . . . . . . . . . . . . . . . @ . . 
. @ @ . @ . . . . . . @ @ . . @ . . . . @ @ . . . . . . . . . . 
. . . . @ @ . . @ . @ . @ . . . . . . . . . . . . . . . @ . . @ 
. @ . . . . . . . . . @ . . . . . . @ . . @ . . . . . @ . . @ . 
. . @ . . . @ . . @ . . . . . . . @ . . . . . . . . . . @ . . . 
40
10 1 1 24
4 4 29 11
22 27 1 10
25 8 3 0
25 1 29 6
17 2 13 16
27 7 0 23
31 27 8 12
5 1 13 23
13 29 14 14
2 5 27 31
16 22 19 22
23 13 10 20
29 28 26 27
0 5 29 21
31 0 15 5
9 16 25 17
28 21 25 10
0 25 6 29
29 18 24 16
30 2 8 27
12 31 23 14
21 1 28 16
0 4 29 29
22 6 24 4
29 29 20 9
15 27 11 20
11 16 13 28
27 17 22 7
0 13 0 5
21 6 27 19
8 23 17 10
16 20 23 22
14 28 14 7
23 30 0 26
1 31 18 0
23 18 14 18
23 31 18 27
29 12 14 22
14 7 27 8
