32 32
@ . . . . . . . . . . @ . . @ @ . . @ . . @ @ . . . . @ . . . . 
. . . . . . . . @ . . @ . . . . . @ . . . . . . . . . . . . . . 
. . @ . . @ . . . . @ . . @ . . . . . @ . . . . . . . . @ . . . 
. @ . . . . . . . . . @ . . @ . @ . . @ @ . @ . . . . . . . . . 
. @ . @ @ . . @ . . . . . @ @ . . . . . . . . . . . . . @ . . . 
. @ @ . . @ . . . . . . . . . . @ . @ . . @ . . . @ . @ . . @ @ 
. . . . @ . . . . @ . . . . . . . . @ . . . . . . . @ . . . . @ 
. . . @ @ . . . . . @ @ . @ . . . . @ . . . . . @ . . . . . . . 
. . . @ . . . . . . . . . . . . . . . . . . . . . . . . . . @ . 
. . . . . . . . @ . . . . . . . . . . @ . . . . . . @ . . . @ . 
@ . . . @ . . . . . . . . . . . . . . @ . @ . . . . @ . . . . . 
. @ . . @ . @ . . . . @ . . @ . . @ . . . . . . . @ @ . . . . @ 
. @ . @ . . . . . . . @ . @ . . . . @ . . @ . @ . . . . . . . @ 
. . . @ . . . . . @ . @ . . @ . . . . . . @ . @ . . @ . . . . . 
. @ . . . . . . . . . . . @ . @ @ . . . @ . . . . . . @ . . . . 
. . . . . . @ @ . . @ @ @ . . . . . @ . . . . . . @ . . . @ . . 
. . . . @ . . . @ . . . . . . @ . . @ . . . @ . . . . . . . . . 
. . @ . . . . . . . . . . . . . . . . . . . . . . . . @ . @ . . 
. . @ . . . . . . . . . . . . . . @ . @ . . @ . . @ . . . . . . 
. . . . @ . . @ . . . . . @ . . . . . @ . . . . . @ . . . . . . 
@ @ . @ @ . @ @ @ . . @ . . . . . . . . . . . . . . . . . . . . 
. . @ . . @ @ . . . . . . . . . . @ @ . . @ . @ @ . @ @ @ . @ . 
. . . . . . . @ . . . . . . . . @ . . @ . . . @ . . @ . . . . . 
. . . . . @ . . . . . . . . . . @ . . . @ @ . . . . @ . . @ . @ 
. . . . . . @ . . @ @ . . . . . . . . @ @ . . . . @ @ . @ . . . 
. . . . . . @ . . . . @ . @ @ . . . . . @ . . . @ . . . . . . . 
. . . @ . . . @ . . @ . . . @ . . . . . . . . . . @ . . . @ . . 
. . . . . . . @ . . . . . @ . . . . @ @ @ @ @ @ . . . . . . . . 
. . . . . . . . . . . . . . @ . . . . @ @ . . . . . . . . @ . . 
. . . . . @ @ . @ . . . . . . . . . . . . . . . . . . . . . . @ 
. @ . . . @ . . . @ . @ @ . @ . . . . @ @ . . . . . . . @ . . . 
@ . . . @ . . . @ . . . @ . . . . @ @ . . . @ . . . . . . . . . 
30
1 13 23 29
26 7 28 25
5 25 17 20
16 19 28 27
2 28 15 7
3 2 19 1
8 19 28 18
1 26 14 27
0 19 26 3
29 0 10 31
16 25 30 0
6 7 22 24
11 29 23 19
5 12 30 13
22 2 6 26
2 3 30 7
1 24 26 25
26 2 9 27
20 29 29 8
8 26 11 4
20 19 5 22
17 8 11 23
14 27 25 12
22 7 3 6
20 4 30 24
30 14 18 11
13 9 4 12
11 2 31 16
17 5 0 19
27 2 18 19
