32 32
. . . . . @ . . . . . . . . . . . . . . . @ @ @ @ . . @ . . . . 
@ @ . . . . . . . . . @ . @ . . . . . . @ . . . . . . @ . . . . 
. . . . . . @ . . @ . . . . @ . @ . . . . . . . . . . . . . . . 
. . . . . . @ . . @ . @ . . . . @ . . . . @ . . . . . . @ @ . . 
@ . . . . . @ . . . . @ . @ . . . . . @ . . . . . . . . @ . . . 
@ . . . . . . . @ . . . . . . . . . . . . . . . . . . . @ . . . 
. @ . . . . . @ . . . . . @ . . . . . @ . @ . . @ . @ @ . @ @ . 
. @ @ . . . . . . . . . . . @ @ . @ . @ @ @ . . . . . . . . . . 
. . . . . . @ . . . . . . . . @ . . . . . . @ @ @ . . . @ . . . 
. @ . . . . . . @ . @ @ . . @ . . . @ . . . . @ . . . . . @ . . 
. . . @ @ . . @ @ @ . @ @ . . @ . . . @ @ . . . . . . . . . . @ 
. . . . . . @ . . . . @ @ . . . @ . . . . . . @ @ . . @ @ . . . 
. . . . @ . . . @ @ . . . @ . . . . . @ . . . . @ @ . . . @ . . 
. . @ @ . . . @ . . @ . . . . . . @ @ . . . . . . . . . @ @ @ . 
. . . . . . . . . . @ . . . . . . . . @ . . . . . . . . . @ . . 
@ . . . . . . . . . . . . . . . . . . . . . @ . . @ . . . . . @ 
. . @ . . . . . . . . @ . . . . . . . . . . @ . @ . . . . . . . 
. . @ @ . . . . . . . . @ . . @ . . . . @ . . @ . . . . . @ . . 
@ . . . . . . @ . . . @ . . @ . . . @ . . . . . . . @ . . . . . 
. . . . @ @ . . . . . . . . . . . . . . . . @ . . . . . . . . . 
. . . . . . . . . @ . . . @ . . . @ . @ . . . @ . @ @ @ . . . @ 
. . . . @ . . . . . . @ . . @ . . . . . . . @ . . . . @ . . . @ 
@ . . . . . . . . . @ . . . . @ . @ . . . @ . . . . . . . . . . 
. . . . . . . . @ @ @ . . . . @ . . . . . . . . . . . . . @ . @ 
@ . . . . . @ . . . . . . . . . @ . . . . @ . . @ . . . . @ . . 
. @ @ @ . . . . @ . @ . @ . . . . @ . @ . . . @ . . . . . . . . 
. . . . . @ . . . . . . . . . . . . @ @ . @ . . . . . . . . . . 
. . @ . @ . . . . . . . . . @ . . . . @ . . . @ . @ . @ . . . . 
. . @ . . @ . . . . . @ . . . . . . @ @ @ . . . . . . @ . @ . @ 
. . . @ . . . . . @ @ . . . . . . . . . . @ . . . . . @ . . . . 
@ . @ . . . . . @ . . . . . @ . . . . . . . . . @ . . . . . . . 
. @ . . @ . . . . . . . . . . . . . . @ @ @ . . . . . . . . . @ 
30
26 31 4 29
17 18 1 0
27 5 21 5
15 31 3 24
24 22 16 0
28 21 5 20
21 28 18 10
30 19 3 6
5 1 7 26
15 25 13 18
11 14 5 22
9 30 13 29
2 21 7 3
13 28 7 9
27 14 7 12
7 21 6 26
29 29 28 17
22 14 15 4
29 10 22 3
15 6 1 2
31 11 10 26
2 31 18 21
14 15 5 10
13 17 20 4
15 0 2 26
31 24 18 7
7 15 24 28
28 31 29 25
11 22 1 18
26 16 11 15
