32 32
. . . . . @ . . . . . . . . . . . . . @ . . @ . . . @ . . . . . 
@ . . . @ . . . . . . . . . @ . . . . . . . . @ . . . . @ . @ . 
. . . . . . . @ . . . @ . @ . . @ @ . . . . . . . . . . @ @ . . 
. . . . . @ . . @ . . . . @ . . . . . . @ . @ . . . @ . . . . . 
@ . . . . . @ . . . . . . . . . . . . @ @ . . . . . . . . . . . 
. . . . . . . @ . . . . . . . . . @ . . . . . @ @ . @ . . . @ . 
. @ . . . . . . @ @ . @ . . . . . . . . @ @ . . . . . . . . . . 
@ . . @ . . . . . . @ . . . . . . @ @ . . @ . @ . . . . . . . . 
. . @ . . . @ . . . . . @ . . . . . . @ @ . . . . . . . . @ . . 
. . . . . . . . . . . . . . . @ . . . . @ @ . . . . . . . @ . @ 
. . . . . . @ @ . . @ . . . . @ . . . . . . . . . . @ . . . . . 
. @ . . . . . . . . @ . . . @ . . . . . . @ . . . . . . . . . . 
. . . @ @ . . @ . . . . @ . . . . . . @ . . . . . . . . . . . . 
. . @ . . . . . . @ . . . . . @ @ @ @ . . @ . . . . . . . . . . 
. . . . . . . @ @ . . . @ . . @ . . . @ . @ . . . @ . . . @ . . 
@ @ . . @ . . . . . . . . . . . . . . . @ @ . . . . . @ . . . @ 
. . . . . @ . . . . . . . . . . . @ . . . . . . @ @ . . . . . . 
. . . . @ . . @ @ . . . . @ . @ . . @ . . . . . . . @ @ . @ . . 
@ @ . . . @ @ . . . . . @ . . @ . . @ . @ . . @ . . . @ . . @ @ 
. . . @ . . . . . . . . . . . . . . @ . . . . . . @ . . . . @ . 
. @ . @ . . . . . @ . @ @ @ @ . . . . . @ . . . . . . . @ . . . 
. . . . . . . . . . . . . . . . . . . . . . . @ . . @ . . . . . 
. . . . . @ . . . . . . @ . . . . . . @ . . . . . . . . . . . . 
. . . @ . @ . . . . . . . @ . . . . . . . . @ @ @ @ . . @ . . . 
. . @ @ . . . . @ . . . . . . @ . . . @ . . . . . . @ . @ . . . 
@ . @ . @ . . . . @ . . . . @ . @ . @ @ . @ . . . . . @ . . . . 
. @ @ . . . . . . @ . . . . @ . . . . . . . . @ . . @ . . . . . 
. . @ . . . . . . . . . . . @ . . @ . @ . . . . . . . . @ @ @ . 
. . . . @ . . . . . . . . @ @ . @ @ . . . @ . . . . @ . . . . . 
. @ . . @ . . . . @ . . @ . . . @ @ . . @ @ . . . @ . . . . . . 
. . . . . . . @ . @ . . . . @ . @ @ . @ . . @ . . . . . . . . @ 
. . @ . . @ @ . . . . . . . . @ @ . . . . . . @ . . . . . . . . 
80
1 13 22 12
2 10 18 30
22 28 6 9
29 28 1 8
29 3 10 15
16 16 31 19
17 4 30 6
17 6 10 0
25 11 14 6
17 0 27 12
29 31 2 23
8 28 30 8
26 18 24 3
16 3 0 10
30 26 11 21
10 13 28 29
11 28 13 8
17 23 26 27
10 14 21 10
5 4 29 22
16 4 21 26
25 26 19 20
24 11 2 12
0 31 17 9
10 21 10 4
20 27 10 13
5 9 31 5
3 9 22 10
29 26 0 23
27 6 20 13
20 26 22 26
30 25 6 5
9 12 27 0
26 11 1 27
2 5 3 26
17 12 30 30
12 16 31 27
15 4 9 17
22 26 29 11
15 11 13 27
30 7 18 9
29 18 14 9
27 5 19 11
31 27 16 24
27 13 26 7
30 15 14 31
0 29 5 7
21 19 3 25
8 22 3 11
4 30 9 12
3 0 0 0
10 24 31 7
30 22 30 13
25 12 14 19
2 30 0 6
22 24 25 15
27 10 20 24
0 3 14 4
27 7 7 29
15 23 18 20
21 3 15 26
18 6 4 19
11 9 15 21
29 15 23 20
3 1 22 19
9 24 30 26
19 26 2 10
8 4 7 4
10 19 8 26
27 3 7 1
6 22 27 26
14 7 13 25
8 2 6 7
2 15 15 12
10 8 15 15
11 10 20 27
2 0 20 23
26 9 22 7
2 16 11 29
20 10 25 3
