32 32
. . . . . @ . @ . . . . . . @ . . @ @ @ @ . . . . . . . . . @ . 
@ . . . . . . . . . @ . . @ . . . . . @ . @ . . . . @ . @ . . @ 
. . @ @ . . @ . . @ . . . . . @ @ . . . . . @ @ . @ . @ . . . . 
. . @ . . . . . . . . . . . @ . . . . . . @ . . . @ . . @ . . . 
. . . . @ . . . . . . . . . . @ . . . . . @ . . @ . . . . . . . 
. . . . @ . @ . . @ . . @ . . . . . . . . @ . . . @ @ @ . . @ . 
. . @ . . . . . . . . . . . . . @ . . @ . . . . . . . . . . . . 
. . . . . . @ . . . . . . . . . . . . . . @ . . . . . . . . . . 
. . . . . . . . @ . . . . . @ . . . . . . @ . . @ . @ . . . . @ 
. . . . @ . . . . . . @ @ . . . . . . . . . @ . . . . . . . . . 
. . . . . . . . @ @ . . . . . . @ . . . . @ . . . @ . . . . @ @ 
. . . . @ . . . . . . . . . . . . . . . . . . . . . . . . . . . 
@ . . @ . . . . . @ . . @ . @ . @ . . . . . . . . . . @ @ @ . . 
. . . @ @ . . @ . . . . . . . . . @ . . . . . . . @ . . @ @ . . 
. . @ @ . . . . . . . . . . . . . . . . @ . . . . . . . . . . @ 
. . @ . . . . . . . . . . . . . . . @ . . . . . . . . . . . . . 
. @ . . @ @ . . . . . . @ . . . . @ . @ . @ . . . . . @ . . @ . 
. . . @ . . @ . . . . @ . @ . . . @ . @ . @ . . . . . . . . @ . 
@ . @ . . . . . . . . . . @ @ . . @ . . . . . . . . . @ . . . . 
. . . . . . . . . . . . . . @ @ . . @ . . . @ . . . . . . @ @ . 
. . . . . . . . . . . @ . . . . . . @ . . @ . . . . . @ . . . @ 
. . . . @ . . . . @ . . . . . . . . @ . . . . @ . @ @ @ . @ @ . 
. @ . . . . . . @ @ . @ @ @ . . . . . . . . . . . . . . @ @ @ . 
. @ . . . . . . @ . . . @ . @ @ . . . @ . . . @ . @ . . @ @ @ . 
@ . . . . . @ . . . @ . . . . . @ . . . . @ . . . . . @ @ . . @ 
. @ . . . . . . . . . . . . . . . . . . . @ @ . . . . . . . . . 
. @ . . . @ . @ . . . . . . . @ . . . @ . . . . . . @ @ . . @ . 
. . . . @ . . . . . . @ . @ . . . . . . . . . . @ . @ . . . @ . 
. . . @ . . . . . . . . @ . . . . . . . @ . . @ . . @ . . . . . 
. . . . @ . @ . . . . . . @ . @ . . @ . . . . . . . @ . . . . @ 
. . . . . . . . @ . . . . . . . @ @ @ . . . . . . . . . . . @ . 
. . . @ . @ . . . . . @ . @ . . @ . @ @ . . . . . . @ . . . @ @ 
20
8 7 11 14
23 15 6 10
27 9 10 27
29 26 10 31
24 23 27 8
29 2 13 10
23 8 18 24
0 2 15 17
0 4 27 29
16 11 10 3
26 18 17 1
21 18 28 25
9 3 18 25
29 31 5 20
13 13 30 25
12 15 1 14
9 7 26 13
16 29 12 24
17 5 9 8
17 25 23 12
