32 32
@ . . . . . . @ . . . . . . . . . . . @ . . . @ . . . . . @ . . 
. . . . . . . . @ . . . . . . . . . . . . . @ . . . . . . . . . 
. . . . . . @ . . . . . . @ . . @ . @ . @ . @ . @ @ . . . . . . 
@ . . . . . . . . . . @ . . . @ . . . . . . . . . . . @ @ . . . 
. . . . . . @ . @ @ @ . . @ . @ . . . @ @ . . . . @ . . @ . . . 
@ @ . @ . . . . . . . . . . . . . . . . . . @ . @ . . . . . . . 
. @ . . . . @ . . . . @ . . . @ @ . . . . . . @ . . . . . . . . 
. . . . . . . . . . @ . . . . . . . . . . . @ . . @ . . . . . . 
. . . . . . . . . . . @ . . . @ . . . . . . @ . . . . . . . . . 
. . . . . . . . . . @ @ . . @ . . . . . . @ . . . . . . @ . . . 
. . . . . . . . . @ . @ . @ . . @ . . . . @ . . . . . . . @ . . 
@ . . . @ . @ . @ @ @ . . . . . . . . . . . . . . . . . . . . . 
. . . @ . @ @ . . . . . @ . . . . . @ @ . . . . @ . . . . @ . . 
. . . . @ . . . . . . . . . . . @ . . . . @ . @ . . . . . . . . 
. . @ . . @ @ @ @ @ . @ . . @ . @ . @ . . . @ . . . @ @ @ . . . 
. . . @ . . . . . . . @ . . . . . @ . @ . . . . . @ . . . @ @ . 
. @ . @ @ @ . . . . . . . . . @ . @ . . @ . . . . . . . . . @ . 
. @ . @ . . @ . @ . . . . . . . . . . . . @ . . . . . . . @ . @ 
. . . . @ . . . @ . @ . . . @ @ . . . . . . . @ . . . . . . . . 
. . . . . . . . . @ . . . . . . . . . . . . . @ . . . @ . . . . 
. @ . . . . . @ . . . . . . @ . . . . . . . . @ . @ . @ . @ @ @ 
. . . . . . . . @ . . . . . @ . . . @ . . . . . . . . . . . . . 
. . . . @ . . . . . @ @ . @ . . . . . . . . . @ . . @ . @ . @ . 
. . . . . . . . . . . . . . . . . @ @ @ . @ . . @ . @ @ . . . . 
. . . . . @ @ . . @ . . . @ . @ . . @ @ . . . . . . . . . . . @ 
. . @ . . @ . . . . @ . . . . @ . @ . . . @ . . @ . @ . . . @ . 
. . . . . . . . @ . . . . @ . . . . . . @ . . . . . @ . . . @ . 
@ @ @ . . . . . @ @ . @ . . @ . . @ . . . . @ @ . . . . @ . . . 
. . . . . . . . . . . . . . . . @ @ . . . . . . @ . . . . . . . 
. . . . @ . . @ . . . . . . . . . . @ @ . . . . . . . . . . . . 
. . . @ . . . . . . . @ @ . @ . . . . . @ . . . . @ @ . . @ . @ 
. @ . . . . . @ . @ . @ @ . . . . . . . @ . . . . . @ . . . . . 
60
13 19 1 4
22 15 7 18
5 30 20 5
1 0 4 4
27 10 24 1
23 24 4 9
2 1 26 16
6 21 0 26
22 9 8 5
13 25 20 22
28 25 7 10
26 0 11 19
7 11 11 0
3 3 1 18
17 13 11 13
1 26 5 11
11 28 22 4
17 5 14 16
2 16 16 4
7 25 16 24
3 29 5 26
12 4 2 18
14 2 25 24
4 31 16 25
30 30 1 7
15 14 11 26
13 17 22 28
3 23 30 8
9 17 6 7
31 25 18 3
0 1 6 10
7 6 6 27
21 11 10 15
17 3 26 15
17 20 0 15
26 20 6 31
16 12 0 10
3 20 9 8
18 22 8 19
16 11 21 22
16 27 22 13
24 11 7 27
17 10 19 25
13 7 27 28
30 18 26 8
0 31 22 17
5 23 31 21
5 5 30 13
6 27 25 23
0 30 31 5
30 17 0 24
12 18 18 18
31 13 2 23
28 21 31 31
2 21 16 15
11 7 4 0
1 11 8 25
20 12 30 0
18 11 20 21
20 10 6 16
