32 32
. . . . @ @ . . @ . . . . . . . . . @ . . . . . . . . . . . . @ 
. . . . . . . . . . . . . . @ @ . . . @ . . . @ . . . . . . . . 
. . . @ @ @ . . . @ . . @ @ . @ . . . . . . . . . . . @ @ . @ @ 
. . . . . @ @ . @ . . @ . . . . @ . . . . . . . . @ . . . @ @ . 
. . . . . . @ . @ @ . . . . . . . . . . . . @ . . . . @ @ . . . 
@ . . . . . . . . . . . @ . . . . @ . . . . @ . . . . @ @ . . . 
@ . @ . . . . @ . . @ @ . @ . @ . @ . . . . . . . . @ . . @ @ @ 
. . . . @ @ . . . . . . . . . . . . . . @ . . . . . . . . . @ . 
. . . @ . . . @ @ . . . . . . . . . . . . . . . . @ . . . . . . 
. @ . . @ . @ . . @ . . . @ @ . . . . . . . . . @ @ . . . . . . 
. . . . . . . . @ . . . . . @ . . . . . . . @ . . . . . . . . . 
. . . . @ @ . . @ . @ . . . . . @ . @ . . . . . . @ . . . . . @ 
@ . . @ . . . . . . . . . . . . . @ . . . . . . . @ . . . . @ @ 
. . . . . . @ . . . . . . . . . . . . . . . . . . . . @ . . . @ 
. . @ . . . . . . @ . . . . . . @ . @ . . . . . . . . . . . . . 
. @ . . . . . @ . . . @ . . . . . . @ @ . . . . . . . . . . . . 
. . . . . . @ . @ @ . . . @ . . . @ . . . @ . . . . . . . . @ . 
. . . . . . . . . @ . . . . . . . . @ . @ . . . @ . @ . . . . . 
. @ @ . . . @ . . . . @ @ . . . . . . . . . @ . . . . . . . . . 
. . . . . . . . . . . . @ . @ @ . . . . . . . @ . @ . . . . . . 
@ . . . . . . . . . . . . . . @ . . . . @ . . . . . . . . . @ @ 
. . . . . . . . . @ . . . . . . . . @ . . . . . . . . . . . . . 
. . . . . @ . . . . . @ . . . . . @ . . . . . . . . @ . @ . . . 
. . . @ @ @ . . . . . . . . . . . . . . . @ . @ . . . . . . . . 
. @ . @ . . . . . . . . @ . . . . . @ . . @ @ . @ . . . . @ . . 
. . . . . . . . @ @ . . . @ @ @ . . @ . @ . . @ . . @ . . . . . 
. . . . . . . . . . @ @ . . . . @ . @ . . . . @ . @ . . . . . @ 
. . . @ . @ @ . @ @ . . @ . . . . . . . @ @ . . . . . @ @ . . . 
. . . . . . . . @ . . . . . . . . . @ . . . . @ . . . @ . . @ . 
. . . . . . @ @ . . . @ @ . . . . . @ . @ @ . . @ . . . . . . . 
@ . . @ @ @ . @ . . @ . . . . . . . . . . @ . . . . @ . @ @ . . 
@ @ @ . . . . . @ . . @ . . . . . @ . @ . . @ . @ . . . . . @ . 
60
10 8 10 2
4 28 8 26
9 1 1 21
11 23 25 2
19 21 5 26
10 25 11 23
13 24 24 3
12 0 27 23
19 30 21 18
2 28 31 19
22 16 20 4
0 9 16 6
12 28 8 14
14 0 26 20
20 0 15 30
25 6 7 23
12 30 27 16
31 18 9 0
20 11 16 13
4 8 16 30
29 17 5 4
9 10 0 9
22 20 22 30
3 18 20 24
13 7 12 4
11 14 8 30
27 17 24 19
20 4 20 12
27 0 27 24
0 24 16 8
8 9 3 19
9 24 28 6
17 26 17 24
12 22 28 0
16 12 28 31
27 19 27 14
31 28 26 7
1 26 0 25
29 26 31 28
28 11 18 13
8 29 9 23
27 3 2 27
14 22 31 10
28 8 27 15
7 21 7 20
17 11 13 7
15 27 1 16
2 7 25 18
30 13 7 17
17 20 13 19
15 18 1 8
29 14 15 22
31 15 27 12
8 23 13 22
24 19 4 12
10 29 4 29
20 19 29 0
6 20 29 27
11 8 21 11
10 16 17 8
