32 32
. @ . . @ . @ . . . . . . . . @ . . . . . . @ . . . . . @ . . @ 
. . . @ . . @ . . . . . . . . . . @ @ . . . . @ . . . . . . . . 
. . @ . . @ . . @ @ . . . @ . . . . . . . . @ . . . . . . @ . . 
. @ . . . @ . . . . . @ . . . . . . . @ . . @ . . . @ . . . . @ 
@ . . . . . @ . . . . . . . . . @ . . @ . @ @ . . . . . . @ . . 
. . . . . @ . @ . . . . @ . @ . . @ . . . . . . @ . . @ . . . . 
. . . @ . . . . . . . . . @ . @ . . . . . . @ . . . @ . . @ . @ 
. @ . . . . . @ @ . . . . . . @ . . . . . . . @ . . . @ . . @ . 
. . . . . . . . . . . . . @ . . . . . @ @ . . . . . . . @ @ @ @ 
. . @ @ . . . . @ . . . . . @ . . . @ . . @ . . @ . @ . . . . . 
. . @ . @ . . . . . . . . . . . . . . . @ @ . . . . . . . @ . . 
. . . @ . . . @ . . @ . . @ @ . . . @ @ . . . . @ . . . @ . @ . 
. . . . . . . . . . . @ . . . . . . . . . . . . . . . . . . . . 
. . @ . . . . . . . @ . @ . . . @ . . . . . @ . . . . @ . . . . 
@ . . . . @ . @ . . . . @ . . . . . . . . . . @ . @ @ . . . . . 
. . . . . . . . . . . . . . . . @ . . . . @ . . @ . . . . . . @ 
. . . . . @ . . . @ . @ . @ @ . . . @ . . . . . . @ @ . . . . @ 
@ . . . . . . . . . . . . . . @ . . . . @ . @ @ @ . @ . . @ . . 
. @ . @ @ . . . . . . @ @ . @ . . . . . @ . . . @ . . . . . . . 
. . @ . . . . . . . . . @ . . . . . . . . @ . . @ . . . . . @ . 
. . . @ . . . . . . @ @ @ . . @ . @ . . . . . @ . . . @ . . . . 
. @ . . @ @ . @ @ . . . . . . . . . . . @ . . . . . . . . . . . 
. . . . . . . . . . . . . . . . @ . . . @ . . . @ @ . . . . . . 
. . . . @ . . @ . . . . . . @ @ . . . . . . . . . . . . @ . . @ 
. . @ . @ . . . . . . . . @ . . . . . . . @ . . . . . . @ . . . 
. . . . . . @ . . . . . . . @ . . @ . . @ @ . . . @ . . . . . . 
. @ . . @ . . . . @ . . . . . @ . . . @ . . @ . . . . . . . . . 
@ @ . . . @ . . @ . . . . . @ . . . . . @ . @ . . . . . . @ . . 
. @ @ . @ . . . @ . . @ . . . . . . @ . . . . . . . . . @ . . @ 
. . . . . . . . . . . . . . @ . . . . @ . . . . @ . . @ . . . . 
. . . . . . . . . . . . @ @ . . . . . @ @ . . @ . . . . . . . . 
. . . . . . . . . . @ . . . @ . . . . . . @ . @ @ . @ . . . . . 
20
17 6 6 16
9 29 31 19
5 0 28 12
21 6 1 31
8 24 8 13
18 25 30 0
22 25 24 25
12 1 10 5
23 18 21 17
0 10 27 0
5 12 29 11
5 15 23 10
11 25 21 26
10 14 6 14
26 29 0 12
3 25 4 14
9 8 27 27
19 23 16 19
30 17 4 27
20 6 8 5
