32 32
. . . . @ . @ @ @ . @ @ . . . . . . . @ . . . . @ . @ . . . . . 
. @ . . . . @ @ @ . . . @ . . . . . . . . . . . . . . . . . . . 
. . . . @ @ @ . . . . . . @ . . . . . . . . @ . @ . . @ . . . . 
. . . . . . . . . . . . . . @ . . . . @ . . . @ . . @ . . @ @ @ 
. . . . . . . . . . . . @ @ . . @ . . . . . . . . . . . . . . . 
. @ . . . . @ . . . . . . . . . @ . . . . @ . . @ . . . . . @ . 
. . . . . . . @ @ . @ . @ . . @ . . . . @ . . . . . . . . @ . . 
. @ . . . . . @ . . . @ . . . . . . . . @ . . . . @ . . . @ . @ 
. @ @ . . . @ . @ @ . . . . . . . . . @ @ . @ . . . @ . . . . @ 
. . . . @ . . . . . . . . . @ @ . @ . . . . @ . . . . . @ . . . 
. . . . . . @ . . . @ . . . . . . . . . . . . . . @ @ . . . . @ 
. . @ @ . . @ . . . . . . . . . . . . . . . . @ . @ . . . . . @ 
@ . . . . . . . . @ . . . . . . @ . . . . . . . . . . @ . . . @ 
. . @ @ . . . . . @ . . @ . . . . . @ . . . . . . . . . . . . . 
. @ . . . . . . @ . . . . @ . . . . . . . . . . . @ @ . @ . . . 
. @ @ . @ . . . . . . . . . . . . . . @ . . . . . @ @ . . . . . 
. . @ . . . . . . . . . . @ . @ @ . . @ @ . . . . . . . . . . . 
. . . . . . . . . . . . . . . . @ . . . @ . . . . . @ . . . . @ 
. @ . . . . . @ @ @ @ @ @ . . @ @ . . . . @ . @ @ . @ . . . @ . 
. . . @ . . . @ . . . . . . . @ . @ . . . . @ @ . . . . . @ . . 
@ . . @ . . . . . . . . . . . . . . . . . . . @ . . . . . . . . 
@ . . . . @ . . . . . . . @ @ . . . . . . . . . . @ . . . . . . 
. . . . . . . @ . . . @ . @ . @ . @ @ . . @ . . @ . . . . . . . 
@ . . @ @ . . . . . . . . . . @ . . . . @ . . . . . @ . @ . . @ 
. . . . @ . . . . . . @ . . @ . . . . . . . . . . . . . @ . . @ 
. @ @ @ . . . . . . . @ . . . @ . . . . . . . . . @ . @ . . @ . 
. . . . @ @ . . . . . . . @ . . . . @ . . . . . @ . . . . . . . 
. . . . . @ . . @ . . . . @ . @ . . . . . . . @ . . @ . . . . . 
. . @ . . . . @ . . . . . . . . . . . . @ . . . . . . . . . . . 
. . . @ . . . . . @ . . . . @ . @ . . . . . @ . . . . . . . . . 
. . @ . @ . . . . @ . @ . . @ @ @ . @ @ @ @ . . . . . . . . @ . 
. . . @ . . . . @ . @ . . . . . . @ . . . . . . . . . @ . . . . 
40
2 20 15 2
7 17 13 9
5 23 10 7
1 13 24 25
20 2 15 24
31 20 5 13
10 3 3 3
18 7 6 31
4 17 8 9
9 15 24 30
25 28 25 3
12 21 13 17
6 31 23 25
3 27 13 18
28 10 7 9
24 4 8 7
0 30 15 12
19 10 11 11
14 23 3 17
22 5 15 20
17 30 0 5
12 20 13 1
14 6 0 10
0 2 22 28
6 16 12 28
5 7 0 3
21 8 10 8
29 23 23 6
6 9 29 11
3 2 18 18
10 2 10 22
27 18 6 13
9 19 18 29
4 25 22 3
1 23 3 2
14 16 21 29
8 20 19 21
0 4 28 16
10 26 25 20
8 17 3 27
