32 32
. . . . @ . . . . . @ . . . . . . . . @ . . . @ . . . . . @ @ . 
. . . @ . @ . . @ . . . . @ . @ . @ . . . . . @ . . . . . . . @ 
. . @ . . . @ . . . . @ . . . . @ . . . . . @ @ . . . . . @ . . 
. . . . @ . . @ . . . @ . . @ . . . . . @ . . @ . . . . @ . . @ 
. . @ @ . . . @ . @ . . . . . @ . . . . . . . . . . . . . . . @ 
. . . @ . @ @ . . @ . @ . @ . . . . @ . . . . . . . . . . @ @ . 
@ . . . . . . . . . . . @ . . . . @ . . . . @ . @ . . . . . . . 
. @ . . . . . . . . . . . . . @ . . . . . @ . @ @ @ @ @ . . @ . 
. . . @ @ . . . . . . . . . . . @ @ . . @ @ . . . . @ . . . . @ 
. . . . . . . . . . . . @ . . . . . . . . @ @ . . . . . . . . . 
. . @ . . . . . . . . . . . @ . . . . . . . . . . @ . . . . . . 
. . . @ @ . . . . . . . . @ @ . @ . . . . . @ . . . . . . . . . 
@ @ . . . . . . . . . . . @ @ . . . . . . . . @ . . . . . @ . . 
@ . . @ . . . . . @ . @ . . . @ . . . . . . . . . @ . . @ . . . 
@ . . . @ . . . . . . . . @ . . . . @ @ @ . . . @ @ @ . @ . . . 
. . . . @ . . . . . . . @ . . . . . . . . . @ . . . . . . . . . 
. . @ @ . . @ . . . . . . . . . . . . . @ . . @ . @ . . . @ . . 
. . . @ . . . @ . . . . @ . . . . . @ . . @ @ @ . . @ . @ . . . 
@ . @ . @ . . . @ @ @ . . . . . @ . @ @ . . . . . . . . . . . @ 
. . . . . . . . . . . . . . . . . . . @ . . . . @ @ @ . . . . . 
. . @ . . . . . . . . . @ @ . . . . . . @ @ . . . @ . @ . . . . 
. . @ . @ . . . . . . @ . . . @ @ . . . . . . . . . . . . @ . . 
. @ . @ . @ . @ . . . . . . . @ . . . . . . . . . . . . . . @ . 
. @ . . . . . . @ . . . . . . @ . @ . . . . . . . . . . . . @ . 
. @ @ . . . . . . . @ @ . . . @ . . . @ . . @ @ . @ . . . @ @ . 
. . . . . . . . . . @ . . . . . . . . . . @ . . . . . . . . @ . 
. @ . . . . @ . . . . . . . . . . . . . . @ @ . . @ . @ . . . . 
. . . @ . . @ @ . . . . . . @ . @ . @ . . . . . . . . . . @ . @ 
. . . . . @ . . . @ . @ . . @ . . . . . . . . . . . . . . . . . 
@ . @ . . . . @ @ . . . @ . . . . . . . . . . . @ . . . . . . . 
@ . . . . . . @ . . . . . . . . . . . . . . . . @ . . . . . . @ 
. @ . @ . . . . . . . . . . . . . . . . . . . . . . @ . . @ . . 
50
18 4 26 0
26 2 10 20
4 31 8 4
12 26 2 27
3 25 7 19
25 30 31 6
10 16 19 28
27 21 22 14
23 31 8 31
15 5 12 14
26 10 14 23
23 14 27 14
14 15 24 12
16 31 22 21
10 8 2 8
28 1 25 11
15 11 22 27
12 8 5 23
13 10 14 20
4 17 10 16
1 14 22 0
20 15 14 4
1 6 0 2
26 25 24 31
8 4 30 20
14 22 2 15
26 9 7 28
12 21 7 15
9 29 18 28
18 20 2 3
18 1 7 16
22 19 16 22
7 0 15 27
13 2 15 8
21 29 20 23
14 14 29 9
5 27 8 20
16 14 0 24
9 17 19 2
27 17 5 0
11 23 21 11
28 29 9 17
9 1 0 20
21 30 13 9
8 9 0 25
12 23 16 14
26 1 14 24
31 9 26 27
0 15 11 17
0 5 22 23
