32 32
. . @ . @ . . . . . . . . . . . . . . @ . . . . . . . . . . . . 
@ . @ . . . . . . . @ . @ . . @ @ . @ . . . . @ @ . . . @ . . . 
. . . . @ . . @ . . . . . . . . . . . . . . @ . . . . @ . . @ . 
@ . . . . @ @ . @ @ . . . . . . . . . . . . . . . . @ @ . . . . 
. . . . . @ . . @ @ . . @ . . . . . @ . . . . . . . . . . . . @ 
. . . . . . @ . @ . . . . . . . . . . @ . . . . @ . @ . . . . . 
. . . . . . . . . . . . @ . . . @ @ . . . . @ @ . . . . . . . . 
@ . . @ . . . @ . . @ @ . . . . @ . @ . . @ . . . . . . . . . . 
. . . . . . . . . . . . . . . . . . @ . @ . . . . . . @ . . @ . 
@ . @ @ . @ . . . . . . . . . . . . @ . @ . . . . . @ . . @ . @ 
. . @ @ . . . . . . . . . @ . . . @ . . . . . . . @ . . . . . . 
. . . @ . . . . . . . @ . . . . . . . . . . @ . @ . . @ @ @ . . 
. . . . . @ . . . . . . . @ . . . @ . @ . . . @ @ . . . . . @ @ 
@ . . . @ . . . . . . . @ . @ @ . . . @ . @ . @ . . @ . . . @ . 
. . . . @ . . . . @ . . @ . . . . @ . . . @ . @ . . . . @ . . . 
. . . . . . . . . . . . . . . . @ . . . . . @ @ . . . . . . . . 
. . . . . . . . . . . @ . . . . @ . . . . @ . @ @ . . . . . @ . 
. . . @ @ . . @ . . . . . . . @ . . . . @ . . @ . @ . @ . . . . 
. . . . . . . . @ . . . . @ . @ . @ . @ . . . . . . . @ . . . . 
. . . . . . . @ . . . . . . @ . . . . . . . . . . @ @ . . @ @ . 
. . . . . @ . @ . . . @ . . . @ @ . . @ . . . . . . @ . . @ . . 
. @ . . . . . . . . . . . . . @ @ . . . . . . . . . . . . . @ . 
. . . @ . . . . . . . @ . . . . . . . . . . . . @ . @ . @ . . . 
. . . . . . . . . . . @ . @ @ . . . . @ . . . @ . . @ . . . @ . 
. . . @ . . @ . . @ . . . . . @ @ . @ . . . . . @ @ . . . . . . 
. . . . . . . @ . @ @ . . . . @ @ . . @ @ . . . . . . . . . @ @ 
. @ . . . . . . . @ . . . . @ . . @ . . . . . . @ . . . @ . . . 
. . . . . . . . . . . . . @ . @ . . . . . . . . . . . . @ . . @ 
. . @ . . . . . . . . . . . . @ . . @ . . . . @ . . @ . . . @ . 
@ . . . . . . . . . . . . . . . @ . . . . . . @ . . . . . . . @ 
@ . . . . . . . @ . . . . . . @ . @ . @ . . @ . . @ . @ . . . . 
. . @ @ . . . . . @ . . . . @ . @ . . . . . . . . . . . @ . . @ 
10
12 27 3 29
5 25 0 20
19 17 1 0
23 3 14 16
3 12 24 0
4 4 3 18
14 0 6 23
10 23 27 7
12 26 2 7
29 26 26 25
