32 32
@ . . . . . @ . @ . . . . @ . @ @ . . . . . @ . . @ . . . . . . 
. . . @ . . @ . . . . . . . @ . . . . . . . . . . . . @ . @ . . 
. . . . . . @ . @ . . . . . . @ . . . . . . . . . @ @ . . @ @ . 
. @ . @ . . . . . . . . . . . @ . . . . . @ . . . @ @ . . . . @ 
@ . . . . . . . @ . . . . . . . . . . . . . @ . . . . . . . . . 
. . . . @ . . @ @ . . @ . . @ . . @ . . . . . . @ . . . . . @ . 
. @ @ . . . . @ . . . . . . . . . . . . . . . @ . . @ . . @ @ . 
. . @ . . . . . @ . . . . . . @ . . . . . . . @ . . . . . . @ . 
@ . . . . . . . . . . . . . . . @ . . . . . . . . @ . . . . . @ 
. . . . . . . . @ . . . . . . @ @ @ . . @ . . . . @ . . . . . . 
@ . . . . . @ . . . @ . . . . . . . @ . . @ . . . @ @ . . @ @ . 
@ . . @ . . . . . . . . . . . @ @ . . . @ . . @ . . . . . @ . . 
@ . . . . . @ . . . @ @ @ . . . @ . . . . @ @ . . @ . . @ . @ @ 
. . @ @ . . . @ . . . . . . . @ . @ . . . . . . . . . . . @ . . 
. @ . @ . . . . . . . . . . . . . . . @ . . . . @ . . @ @ . @ . 
. @ . . . . @ . . . . . @ . . @ . . . . . @ . . . . . . . @ . . 
. . . @ . . @ @ . . . . . . @ . . @ . . @ @ . . . . . . . . . . 
. . @ . . . . . . @ . . . . . . . . . . . . . @ @ . . . @ . . . 
. . . . . . . . @ . . @ . . . . . . . . . @ . . . @ . . . . . . 
. . . @ . @ . . . . . . . . . . . . . . . @ . . . @ . . . . . . 
. . . @ @ . . @ . . . . . . . . . . . . . . . . . . . . . @ . . 
. . @ . . . . . . @ . . . . . . @ . . . . . @ . . @ . . . . @ . 
. @ . . @ . . . . . . @ @ . . . @ . . . @ . . . . . @ . @ @ . . 
. . . . . . . . @ . . . @ @ . . . . . . . @ . @ . . . . . . . . 
. . . @ @ . . . . . . . . . . @ . . @ . . . . . @ . . . . . . . 
@ @ . . . @ . . . @ . . . @ . . . . . . @ @ . . . . . . @ . . . 
. . . . @ @ . @ . @ . . . . @ @ @ . @ . . . . @ . . . . . . . . 
. . @ . . . . @ @ @ . . . . . @ . . . @ . @ @ @ . . @ . @ . . . 
. . . . . . . . . . . . . . @ . . . . . . . . . . . @ . . . @ . 
. . . @ . . . . . . . . . . . . . . . @ . . . @ . . . . @ . . @ 
. . . @ @ . . @ @ @ . . . . . . @ . . . @ . @ @ . . . . @ . . . 
. . . . . . @ . . . . . . . . . @ . . . . . . . . . . . . . . . 
30
30 18 12 16
5 20 13 30
9 4 4 14
26 30 10 17
23 14 28 19
21 6 12 2
19 12 29 18
8 6 10 7
17 27 5 21
9 2 5 13
23 8 27 26
21 17 24 26
12 18 1 16
18 7 15 10
1 0 22 22
26 5 26 25
11 29 25 11
12 25 15 30
30 15 28 18
9 5 14 31
19 28 12 9
11 9 16 6
23 25 20 23
31 16 2 14
24 22 30 26
7 12 14 9
4 31 7 11
12 30 24 11
11 15 1 24
3 23 15 18
