32 32
@ . @ @ . . . . . . . . . @ @ . . . . . @ . . @ @ . @ . . . . . 
@ . . . @ . . @ @ . . @ . . . . @ @ @ . . @ @ . . . . . . . . . 
. . @ . @ @ . . @ . . @ . . @ . @ @ . . . . . . . . . . . . . . 
. . . . . @ . . @ @ . . . . . @ @ . . . . . . . . @ . . . . @ . 
@ . . @ @ . . . . . . @ . @ . . . . . . . . @ . . . . . . . @ . 
. . . . . . . . . . @ . . . . . . . . . . . . . . . . . . . . . 
. @ . . . . . . . . @ @ . . . . . . . . . . . . . @ . @ . @ @ . 
. @ . @ . @ . . @ @ . . . . . . . . @ @ . . . . . . . @ . @ . . 
. @ . . . @ @ . . . . @ . . . . . . @ . @ . . . . @ . . . . @ . 
. . . . . . . . . . @ . . . . . @ . @ . . . . . . . . . . . @ . 
. . . @ . . . . . . . @ . . . . . . @ . @ . @ . . @ . . . . . . 
. . @ @ . . @ @ . @ . @ . . @ . . . . . . . . . @ @ @ . . . . . 
. . @ @ . . . @ . @ . . . . . . . . . . @ . . . . . . . . . . . 
. . . . . . . . . . . @ . . . . . . @ @ @ . . @ . . . . . . . . 
. . . @ . . . @ . . . @ . . . . . . . . . . . . . @ . . . . . @ 
. . . . . . . . . . . . . @ . . . . @ . . . . . @ . . . . . . @ 
. @ . . . @ . . . . . . . . . . . . @ . . . . . . . . . . . . . 
@ @ . . . @ . . . . . . . . . @ . . @ . . . . . @ . . . @ . . . 
. @ . . @ . . @ . . . . . . . . @ . . @ . . @ . . . . . . @ @ @ 
. . @ . . @ . . . . . @ . . @ . . . @ . . . . @ . . . . . . . @ 
. . . . . @ . . . . . . . . . . @ @ @ . . . . . . . . . . . . . 
. . . @ . . . . . . . @ . . . . . @ . . . . . . . @ . . . . . . 
@ . . @ . . @ . . . . . . . . @ . . . . . . . . . . @ . . . . . 
. . . . . . . . . . . . . . . . . . . . . @ . @ . . . @ . @ @ . 
. . . . . . . @ @ . . @ . @ . @ . . . . . . @ . . . . . . . . . 
@ . . @ @ . . . . . . . . . @ . @ . . @ @ . . . . . . . . . @ . 
@ . @ . @ . . . . . . . @ @ . . . . @ . . @ . . @ . . . . . @ @ 
. . . . @ . . . . . . . . . . . . . . . . . . @ @ . @ . . @ @ . 
. . . . . . . . . . . . . . . . . @ @ @ @ . @ . @ . . . . . . . 
. . @ . . . . @ . . @ . . . @ . . . . . . . . . . . @ . . . . . 
. . . . @ . @ @ . . . . . . . . @ . . . . . . . . @ . . @ . @ . 
@ . @ . . . . . . . @ . . . . . @ . @ . @ . . . . . . . . . . @ 
80
27 14 20 9
20 20 30 29
5 9 28 15
4 12 15 6
13 20 0 7
14 16 22 12
0 13 19 27
27 31 10 28
23 9 8 13
30 2 14 8
25 23 20 5
11 31 19 26
0 12 31 1
15 13 7 31
24 6 8 11
28 15 24 31
24 16 17 15
26 17 30 16
31 12 8 14
23 11 7 7
6 5 21 13
19 31 18 6
2 9 3 8
17 3 17 14
12 10 29 28
17 8 24 14
16 21 22 2
27 0 17 26
19 5 5 24
13 29 15 8
3 15 18 5
26 30 17 29
23 18 6 4
0 18 5 13
30 0 14 13
30 28 4 5
13 16 28 18
10 22 11 12
14 31 3 13
0 27 23 15
11 5 17 31
22 13 9 9
27 21 22 14
25 9 29 5
28 28 22 25
17 0 4 9
4 16 5 30
29 11 7 9
15 21 9 0
30 17 13 13
30 7 27 11
6 21 21 27
18 4 16 15
28 25 2 7
21 15 2 5
21 28 20 11
27 27 14 6
9 27 21 8
13 8 11 26
13 23 27 1
12 6 22 21
23 29 31 23
16 4 3 16
8 27 17 12
8 22 22 9
28 19 6 19
11 23 26 3
21 24 16 23
1 10 24 12
24 12 26 15
12 18 8 10
0 28 10 15
2 23 9 14
27 13 15 16
11 20 8 18
0 10 2 23
10 15 9 16
26 19 6 0
11 3 2 8
22 19 8 20
