32 32
. . . . . . . . . @ . . . . . . . @ . . . @ . . . . . . . @ . @ 
. @ . . . . @ . . . . . . . . @ . . @ . . . . . . . . . . . . @ 
@ . . . . @ . @ . . . . . . . @ . @ @ . . . . @ . . . . . . . . 
. . . . @ . . . . @ . . . @ . . . . . @ . . . . . . . . . . @ . 
. . @ . . . @ . . . . @ . . . @ . . . @ . . . . . . . @ . . . @ 
. . . . . . . . . . . . . . . . . . . . . . @ . . @ @ . @ . . . 
. . . @ . . . . . . . . . . . . . . . . . . @ @ . . . . @ @ . . 
. . . . @ . @ @ . . @ . . . . . @ . . @ . @ . @ . @ @ . . . . . 
@ . . . . . . @ . . . . @ . . @ @ . . . @ . @ . . . . . . . @ . 
@ . . . @ . @ @ . . . . . @ . . . . @ @ @ . @ . . . . . @ . . . 
. . . @ . @ . @ @ @ . . @ . . . . . @ . . . . . . . . . . . @ . 
. . . @ . . . @ @ . . . . @ . . @ . . @ . . @ . @ . . . . . . . 
@ @ . . . @ . . @ @ . @ . . . . . @ @ . . . . . . . . . . . . . 
. . . . . @ . . . . . . . . . . @ . . . @ . @ . . @ . @ @ . . . 
@ . . . . . . . @ . . . . . . . . . . . . . . . . . . . @ . . . 
. . @ . . . @ . @ . @ . @ . . . . @ @ . . . . . . . @ @ . . . . 
. . @ @ @ . . @ . . . . . . . . . . @ . . . . . @ . . . . . . . 
. . . @ @ . . . . . . @ . . @ . . @ . . . . . @ . . . . @ @ . . 
. . . . . . . @ . @ . . . @ . . . @ @ . . . . . @ . . . . . . . 
. . . . . . . . . . . . . . . . . . . . . . . . . . . @ . . . . 
@ . . @ . . . . . @ . @ . . . . . . . . . @ . @ . . . . . . . . 
. . . . . . . . @ . . @ . . . . . @ . . . . . . . . . . . @ @ . 
. @ . . . . . . @ . . . . . . . . . . . . . . . . @ @ . . . @ . 
. . @ . . . . . @ . . . . @ . . . . . . . . . . . . @ . @ . @ @ 
. @ . . @ @ @ @ . . @ @ . @ . . . . . . . . @ . . . . . . @ . @ 
. @ . . . . . . . @ . . . @ . @ . . . . . . @ . . @ . . . . @ @ 
. . . . . . @ . . . . . . . . @ . . . . . . . @ . . . . . @ . . 
. . @ . . . @ . . . . @ . . . . . . . . . . . . . . . . . . . . 
. . . . . @ . . . . @ . . . @ @ . . . . . . . . @ . . . @ . @ @ 
@ . . . @ . . . . . . . . @ . . . . @ . . @ . . . . . . @ . . . 
. @ . . . . . . . . @ . . @ . . . . . . . . . . . . @ @ . . . . 
. @ . . . . . . . . . . . . . @ . . . . . . . @ @ @ . . . . . @ 
30
8 8 5 19
12 7 15 29
17 5 2 28
19 24 22 15
31 5 17 11
31 9 1 26
2 30 30 14
6 25 4 4
16 6 15 21
28 26 14 27
9 4 18 11
20 4 10 14
16 2 14 0
16 10 28 8
19 20 23 24
14 0 6 13
21 9 26 6
5 30 12 3
15 14 4 10
27 2 20 26
16 30 20 17
18 4 10 12
10 0 5 17
7 30 30 18
17 30 30 26
3 8 19 10
22 4 3 8
18 22 26 1
4 18 25 26
28 0 18 5
