32 32
. @ . . . . . @ . @ . . . @ . . . @ . . . @ . . . @ @ . . . . @ 
. . . . . @ . . . . @ . @ . . . . . . . @ . @ . . . . . . @ @ . 
. . @ . @ @ . . . @ . . @ . . . . @ . . . @ . . . . @ . . @ . . 
@ @ . @ . . . @ . . . . . @ . . . . . . @ . . . . @ . . . @ . . 
@ . . . . . . . . . . . @ . . . . . . . . . . . . . . . . . . . 
. . . @ . . . . . . . . @ . . . . @ . . . @ @ . @ . @ . . . @ @ 
. . . @ . . @ . . . . . @ . . . @ @ @ . . . . . . . @ . . . . @ 
. . . . . . . . . . @ . @ . . @ . @ . . . . . @ . . @ . . . . . 
. . . . . @ . . . @ . . . . . . . . . @ . . . . . . . . . . . . 
. @ @ . . . . . . . . . . . . . . . . . . . @ . . . . . . @ . . 
. . . . . . . . . @ . . . . . . @ . . . . . . @ . . . . @ . . @ 
@ . . @ . . . @ @ @ @ . . . . . @ . . @ . . . . . . . . . . . . 
. . @ @ . . @ . . . . . . . @ @ . . . @ @ . . . . . . . . . . . 
@ . . . . . . . . . . @ . . . @ @ . @ . @ . . . @ . . @ . . . @ 
. . . . . . . . . . . . @ . . . . . . @ . . . . . @ . @ . . . @ 
@ . . . . . @ . @ . . . . . . . . . . . . @ . @ . @ . . @ . . . 
. . @ @ . . . . . . . . @ . . . . . . . . . . . . . . @ . . . . 
. . . @ @ . . . . . . . @ . . . . . . . . @ . . . . . @ . . @ @ 
@ @ . . . @ @ . . . . . . . . . @ . @ @ . . . . . . @ . . @ . . 
. . . . . . . . . . @ . @ @ . . . . . . . . . . @ . . . . . . . 
. @ . . . . . . @ . . . . . . . . . . . . @ @ . . . . @ . . . . 
. . . . @ @ . @ @ . . . @ . . . . . . . . @ . . . @ . @ . @ . . 
. . @ . . . . . . . . . . @ . . . . . . . . . @ . . . @ . @ . . 
. . @ @ . . . . . . . . @ . . . @ . . . . . . . . . . . . . . . 
. . . . . . . . . . . @ . . . . @ . . . . . . . . . . . . @ . . 
@ . . . . . . . @ . . . @ . . . . . . . @ . . . . . @ . . . . . 
. . . . . . . . . . . . . . @ @ @ @ . . . @ . . . . . . . . . . 
. . @ . @ @ . . . . . . . @ @ . . . . . . . @ @ . @ . . . . . . 
. . . . . @ . . @ . . . . @ . @ . . . . . . . . . @ @ . . . . . 
. . . . @ . . @ . @ @ . . . @ . . . . . . . @ @ . . . . . @ . . 
. . . . . . @ @ @ . @ . . @ . . . . . . . . . . . . . . . @ . . 
@ @ . . . . @ . . . . @ . @ . . . . @ . . @ . @ . . . . . . @ @ 
10
24 10 15 5
28 21 10 10
6 17 28 16
25 30 12 27
1 15 21 11
16 16 23 5
0 14 19 10
18 10 2 4
9 20 7 24
25 29 7 4
