32 32
. . . . . . . . . . . . . . . . . . . . @ . . . . . . . . . . . 
. . @ . . @ . . . . @ @ . . . . . . . @ @ . @ . @ . . . @ . . . 
. . . . . . . . @ @ . @ . . @ . @ . . . . . @ . . . . . @ . . @ 
@ . . . . @ . . . . . . . . . . @ . . . @ . . . . . . . . . . . 
. @ . . @ . . . . . @ . @ . @ . @ . . . . . . . . . . . . . . . 
. . . . . . . @ . . @ @ . @ . . . . @ . . . . . . . @ . . @ @ . 
. . @ . @ . @ . @ . . . . . . . . @ @ . . @ . . . . @ . . . . . 
. . . . @ @ . . @ . . . @ . . . @ . . @ . . . . . . . . . . . @ 
. . . . . . . . @ . . . @ @ . . . . . . . . . . . . @ . . . . . 
. @ . . . . . . . . . . . . . . . . @ . @ . @ . . . @ . @ . . . 
. . @ . . . . . . . . . . @ . . . @ . . @ . . . . . . . . . . . 
. . @ @ . . . . . . . . . @ . @ @ . @ . @ . @ . . . . @ . . . . 
. . . . . . . . . @ @ . . . . . @ @ @ @ @ . @ @ @ @ . . . . . . 
. . . . . . . @ . . . . . . . . . . . @ @ . . . . . . @ . . . @ 
. . . . . . . . @ @ . . . . @ . . . . . @ . . . . . . . . . . . 
. @ . . . . @ . . @ . . . . . . . @ . . . . @ . . . @ . . . . . 
. . . . @ @ . . @ . @ @ @ . . . . . . . . . . . . . @ @ @ . . . 
. @ @ . . @ . . @ . @ . . @ . . . @ . . @ . . . . . . . . . . . 
. . . . . . . @ . . . . . . . . @ . @ . . . . . . . . @ @ . . . 
. . . . . . . . @ . . . . . . . . . . . . @ . . @ . . . . . . . 
@ . . . . @ . . . @ . . . @ . @ @ @ . . @ . . . . @ . . . . . . 
. . . . . . . @ . . . . . . . . . . @ . @ . . . . @ @ @ . . . . 
. @ . . . @ . @ . @ @ . . @ @ . . . . @ . . . . @ @ . . . . . . 
. . . . . . . @ @ . . . @ . . . . . . . . @ @ @ . . @ . . . @ . 
. . @ . . @ . . . . . . . . . . @ . . @ . . . @ . @ @ . . . @ . 
. . . . . . . . @ . . . @ . . . . . . . . @ @ . . @ . . . . @ . 
@ @ . @ . . . . . . . . . . . . . . . . @ . . . . . . . . @ . . 
@ . . . @ @ . @ . @ . . @ . . . @ . . . . . . . @ . . . . . @ . 
. . . . @ . . . @ . . . . . . . . . . . . . @ . @ . @ . @ . . . 
. . @ . @ . . . . . . . . . . . . . . . . . . . . . @ . . @ . . 
. . @ @ . . . . . . . . . . . . . . . @ . . . . . . . . . . . . 
. . . . . @ . @ . @ . . . . . . . . . . @ . . . . . @ . . . . . 
60
6 2 13 23
30 17 15 10
29 17 14 24
27 8 21 3
19 2 27 14
16 9 22 31
12 24 6 16
0 6 21 21
30 16 14 29
15 8 24 9
19 3 3 1
24 15 18 22
1 2 12 19
31 0 10 30
23 7 3 16
22 19 6 27
14 7 11 31
24 0 26 13
23 8 0 7
6 9 9 13
27 0 12 28
16 23 6 20
27 24 0 0
26 26 7 25
25 14 23 31
8 24 13 26
20 15 28 5
0 17 30 3
25 11 12 3
29 18 27 19
20 29 9 3
16 25 8 26
1 29 11 0
2 15 31 11
14 23 1 8
28 31 15 23
27 26 14 12
0 28 0 17
18 30 0 30
5 9 24 4
15 27 11 17
7 24 26 1
28 29 0 29
18 14 18 15
0 5 4 17
23 18 7 1
30 19 4 5
14 6 3 8
26 1 15 8
23 2 7 20
11 25 5 30
28 27 15 15
11 18 27 6
11 27 29 24
9 11 11 11
10 23 17 29
6 7 21 2
28 20 28 27
5 8 0 23
16 22 28 11
