32 32
. . . . . . . . . . @ @ . . @ @ . . . . . . . . @ . . . . . . . 
@ . @ . @ @ . @ . . . . . . . . . . . @ . . . . . . . . . . . @ 
. . @ . . . @ . . . . @ . . . . . . . . . . . . . . . . @ . . @ 
. @ . @ @ . . . . . . . . . . . . @ . . @ @ . . . . @ @ . . . . 
. . . . . @ @ . @ @ . . . . . . . . . . . . . . . @ @ . . . . . 
. @ . . . . . . @ . . . . . . . . . . . . . . @ . . . . . . . . 
. . @ . . . @ . . . . . . . @ . . @ @ . @ . . . . . . @ . @ . @ 
. . @ . . . . . . @ . . @ . . . . . . . . @ . . . . . . . . . . 
. . . . . @ . . . . . . . . . @ . . . . @ . . . @ . . . . . @ . 
. . . . . @ . . . . . @ . . . . @ . . . . . @ @ @ @ @ . . @ . @ 
@ . . . . . . . . @ . . . . @ @ . @ @ . @ . . @ . . . @ . . . . 
@ . . @ @ @ @ . . . @ . . . . @ . . . . . . . . . . . . . @ . . 
. . . . . . . . . . . . . . . . . . . . . . . @ . . . . . @ . . 
. . . . . . . . . . @ . . . @ . . . . . . . . . . . . @ . . . . 
@ . . @ . . @ . @ . . . . @ . . . . @ . . . @ . . . . . @ . @ . 
. . @ . @ . . . . @ . @ . . . . . . . @ @ . @ . . . . . @ . . . 
. . . . . . . . . . . . . @ . . . . @ . . . . . . . . . . . . . 
. . @ . . . . . . . . . . . . . . . . @ . @ . . . . . @ @ . . . 
. . . . . . . . @ @ . . . . . . . @ . . . . @ . @ . . . . @ . . 
. . . @ @ . @ . @ . . . . . . . @ @ . @ . @ . . . . @ @ . . . . 
. . . . @ . . @ . . @ . . @ @ . . . . . . . . . . . . . . @ @ . 
@ . . . . @ . @ @ . . . . . . . @ . . @ . . . . . @ @ @ . . . @ 
. . . . . . . @ . . . @ . . @ . . . @ . . @ @ . . . . . . . @ . 
. . . . . . . . . . . . @ @ . . . . . . . . . . @ @ . . . @ @ . 
. @ . . . . . . . . . . @ . . @ . . . . . . @ . . . @ @ . . @ . 
. . . . @ . . . . . . . . @ . . . . . . . . . . . . . . . . . @ 
. . . . . . @ @ . . . . . . @ . @ . . . @ . . . . . . . . . . . 
. . @ @ . . @ @ . . . . @ . . . @ . . . . . . @ . @ . @ . . . . 
. . . @ . . . . . . . . . . @ . @ . . . . . . . . . @ . . . . @ 
. . . @ . . . . @ . . @ . . . . . @ . . . . @ . @ @ . . . . @ . 
. . . @ @ . . . . . @ . . . . @ . . . . @ . . . . . @ . . . . . 
. @ . . . . . . @ . . . . @ . . . . . @ . @ . . . . @ . . @ . . 
30
6 30 22 11
7 10 17 15
11 23 8 30
12 29 2 12
2 19 21 12
3 23 19 8
13 19 12 9
3 25 5 30
2 28 9 14
18 12 7 12
17 13 30 19
11 18 17 21
17 16 9 12
3 15 19 30
14 30 7 0
12 11 1 14
9 25 2 19
24 2 9 31
30 30 12 10
0 30 15 18
24 19 23 25
16 22 14 5
9 6 24 2
18 28 21 25
16 18 20 16
13 13 30 10
7 2 12 15
25 24 4 10
1 28 1 2
0 25 26 18
