32 32
. . . . @ . . @ . . @ . . @ @ . . . . . . @ . . @ . . . . . @ . 
. . @ @ @ . . . . . @ . . . . @ . . @ . . . . . . . @ . @ . @ . 
. @ . @ @ @ @ . . . . . . . @ . . . @ . . . . . @ @ . . . . @ . 
. @ . . . . . @ @ @ . @ . . @ . . . @ . . . . . @ . . . . . . @ 
@ . @ . . @ . . . . . @ . . @ . . . @ . . . @ @ @ . . @ . . @ . 
. @ . . . . @ . . . @ @ . . . . . . . . @ . . @ . . . @ . . @ @ 
. . . . . @ . . @ . . . @ . . . . . @ @ . . . . . . @ . . . @ . 
. . . . . @ @ . . . @ @ . . . . . . . @ . . . @ . . . . . . . . 
. @ . . . . . . . . @ . . . . @ . . . @ . . . @ . . . . . . . @ 
@ . . @ . . . . @ @ . . @ . . . . @ @ . . . . . . . @ . . . . . 
. . . . . . . . . . . . @ . . . . . . . . . @ . @ @ @ . . . . . 
. . . @ . @ . . . . . . . . . @ . @ . @ . @ . . . . . . . @ . . 
. . . . . . . @ . @ @ . . . . @ . . . . . @ . . . . . . . . . . 
@ . . . . . . . . . . @ . . . . . . . . . @ . . . . . . @ . @ . 
. @ . . . . . @ . . . @ . . @ . . . . . . @ . . . . . . . @ . @ 
. . @ . @ . . . . . . . . . . @ . . . . . . . . . . . . . . . . 
. . . @ . @ . . @ @ . @ . . . . . . . . . @ . . @ . . . . @ . . 
. @ . . . . . . . . @ . . . . . . . @ . . @ . . . . . . . . . @ 
. @ @ . . . . @ . . . . @ . @ @ . . . . . @ . . . . . . . . @ . 
. . . . . . . . . @ . . . . . . . . . . . . . . . . @ . . . . . 
. . . . . . . . @ . . . . . @ @ . . . . . . . . . @ . . . @ . @ 
. . . . . @ . @ . . . . . . . . . . . . . . @ . . . . . @ @ . . 
@ . . . . . . . . . . . . . @ . . . @ . . . . . . . . . . . . . 
. . @ . . @ @ . . . . . . . . . . . . . . . . . . . . @ @ . . @ 
. @ . . . . . . . . @ . . @ . @ . . . . . . . . . . . . . . . . 
. . @ . . . . . . . . . . . . . . . . . @ . . . . . . @ @ . . . 
. . . . . . . . @ . . . . . @ . @ . . . . . @ . . . . @ @ . . . 
@ . . . . . . . . . . . @ . . . . @ @ . . . . @ . @ . . . . . . 
. . . . . . . . @ . . . . @ . @ . . . . . @ . . . @ . . . . . . 
@ . . . . . . . . @ . @ . . . . . . . . . . @ @ @ . . . . . . . 
. @ . . . @ . . . . . . . . @ @ . . . . . . . . @ . . @ . . . . 
. @ . . . @ @ . . . . @ . . . @ . . . @ . . . . . @ . . . . @ @ 
20
22 20 26 29
10 2 3 26
9 7 6 6
6 28 21 26
15 21 17 30
28 20 20 24
22 11 31 24
9 28 18 10
14 21 23 2
12 7 2 9
4 27 19 15
28 3 8 4
22 19 8 18
15 0 8 19
12 3 12 26
6 22 29 12
0 12 0 19
13 17 27 18
24 21 28 7
3 25 11 6
