32 32
. . . . . @ . . @ . . . . . . . . . . . . . . . . . . . . . . . 
. @ . @ . @ . . . . . . @ @ . . . . @ . @ . . . . . . . . . . @ 
. . . . . @ . . @ . . . @ . . @ . . @ . @ . . . . . . . . @ . @ 
. . . . @ . . . . . . . . . . @ . . . . @ . @ . . . . . . . . . 
. . . . . @ . . . . . . . . . . . . . . @ @ . @ . . @ . . . . @ 
. . . . @ . . . . @ . . . . . . . . @ . . . @ @ . @ . . . . . . 
. . . @ . . . . . . . . . . @ @ . @ . . . . @ . . @ @ . . . . . 
. . . @ . . . @ . . . . . . . . @ @ @ . . @ @ . . . . . . . . . 
. . . @ @ . . . . . . @ . . . . @ . . . . . . . . . . @ . . . . 
. @ . . . . . . . . . . . . . . @ . . . @ @ . . . . . . . . . . 
. . . @ @ . . . . . . . . . . . @ @ . . . . . . . . @ . . . . . 
. . . . . @ . . . . . . @ @ . . . . . . . . . . @ . . . . . . . 
. . . . @ . @ . @ . . . . . . . . . . . . . @ . @ @ . . @ . . . 
@ @ . . . @ . . . @ . . @ . . . . . @ . . . . . . . . . . . . @ 
@ . . @ @ . . . @ . @ . . . . . . . . . . . . . . . . . . . . . 
. . . . . . . @ . @ @ @ . . . . @ @ . . . . . . . . . . @ . . . 
@ @ @ . . . . . @ @ @ . . . . . . @ . @ @ . . . @ . . . @ . . . 
. . . . . . . . . @ . . . . . . . . . @ . . . . . @ . @ @ . . @ 
. . . . . . . . @ . @ . . . . . . . . . . . . . . . . . . . @ . 
@ . . . . . @ @ . @ . . . . . . . @ . . . . . . . . . . . . . . 
. . . @ . . . . @ @ . @ . . . . . . . . @ @ . @ @ . . . @ . . . 
. . . . . . . . . . . . . . . . . . @ . . @ . . . . . . . . @ @ 
. . . . . . . . . . . . . . @ . . @ . . . . . @ . . . . @ . . @ 
. . . @ . . @ . . @ @ . @ . . @ @ . . . . . . . . . . . . . . . 
. . . @ . @ . @ . . . . @ . . . . . . @ . @ . @ @ . . @ @ . . . 
@ @ @ . . . @ . . @ . . . . . . . . @ . @ . . @ . @ . @ . . . . 
. @ . . . . . . . . . . . . . . @ . @ . @ . . . . @ . . . . . . 
. . . . . . . @ . . . @ . . . . . . . . . . . @ . . . . . . @ . 
@ . . @ . . . . @ . . . . . . @ . . . . . @ . @ @ . . . . . @ . 
. . . . . @ @ . . . . @ . . . @ . . . @ . @ . @ @ @ . @ . @ . @ 
. . . . @ . . . . . . . @ . . . . . . . . . . @ . @ . @ . @ . . 
. . @ . . . . . . . . . . . . @ . @ . . @ . @ @ . . @ . . . . . 
20
16 3 8 24
12 9 18 16
23 21 27 0
6 9 13 20
12 29 6 8
5 8 10 6
29 13 21 23
27 27 13 4
21 2 13 27
11 3 0 23
8 22 14 7
4 20 23 12
28 2 29 27
5 3 29 13
14 7 11 12
18 4 6 11
30 19 30 17
14 16 23 0
24 14 29 16
9 29 22 11
