32 32
. . . . . . . . . . . . . . . @ . . . @ . @ . . . . . . . . . . 
. . . @ . . . . . . . . . . @ . . . . @ . . . . . . . . . . . @ 
@ . . @ . . . @ . . . . . . . . . . . . @ . . . @ . . . . . . @ 
. . . . . . @ @ . . . . . . . . @ @ . . . . . . . . . . @ . . @ 
. . . @ . . @ . . . . . . . @ . . . @ . . . @ . . . . . . . . . 
. . . . . . . . . . . @ . . @ . @ . . @ . . . . . . . . . . . . 
. . . . . @ . . . . . . . . . . . . . . . . . . @ @ . . . . . . 
. . @ @ . . . @ . . . . @ . . . . . @ . @ . . . . . . . . . . . 
. @ . . @ @ . . . @ . . . . . . . . . @ . . . . . @ . @ @ . . . 
@ . . . @ . . . . . @ . . . . @ @ . . @ . . . @ . . . . . @ . . 
. . . @ @ @ . . . @ . . . . . . . . . . . . . . . . . . . . . . 
@ . . . . . . . . @ . . . @ . . . . . . . . . . . . @ . . . . . 
. . @ @ . . . . . . . @ . . . @ . . @ . . @ . . . . @ . . . @ . 
. @ @ . . . . . . . . . . . . . . @ . . . @ . @ . . . @ . @ . . 
. . . @ . @ @ . . . . @ . . @ . . @ . . @ . . . . @ . . . . . . 
. . . . . . . . . . . . @ @ . @ . . . . @ . . @ . . . . . . @ . 
@ . @ . . . . . @ . . . . . @ . @ @ . . . @ . . . @ . . . . . . 
@ . . . . . . . . @ . . . . . . . . . @ . . . . . . @ . . . . . 
@ . . . @ . . @ . . . . . . . . @ @ . . @ . @ . @ @ . . . . . . 
. . . . @ . . @ @ @ . . . . . . . . . . . . @ . . . . @ . . @ . 
. @ . . . @ . . . @ @ @ . @ . . . . . . @ . . . . . . @ @ . . . 
. . . . . . . @ . . . @ . . . . . . @ . @ @ . @ . . @ . . . @ @ 
. @ . @ . . . . @ . . . . @ . . . . . @ . . @ . . . . . @ . . @ 
. @ . . . . @ @ . . . . @ @ . . . . . . . . . . . . @ @ . . . . 
@ @ . @ . . . . . @ . @ . @ . . . . . @ . . @ @ . . . . . . . @ 
. . . . . . . . . . . . . . . . . . . . . . . . . . @ @ . . . . 
. . @ @ . . . . @ @ . . @ . . . . . @ . . . . . @ . . . @ . @ . 
. . . . . @ . . . . . . . . . @ . @ . . . . . . @ . . . . @ . @ 
@ @ @ . . . . . . . . . @ . . . . @ . @ . . . . @ @ @ . @ . . . 
@ . @ . . . . . @ . @ . . . . @ . . . @ . . . @ . . @ @ @ . . . 
@ . . . . . . . . . . . . . @ . @ . . . . . . . . . . . . . . . 
. . . . . . . . . @ . . . . . . . . . . . . . . . . . @ . @ . . 
20
23 23 2 27
25 30 8 5
27 26 9 6
2 2 28 21
20 23 20 8
29 21 25 21
24 13 26 19
10 12 18 3
12 5 25 10
18 18 1 17
23 1 3 5
28 2 14 11
31 20 12 21
0 8 21 31
2 17 25 22
14 2 30 3
10 3 14 20
4 15 12 12
22 27 25 15
5 13 26 9
