32 32
. . . . . . . . . . . . @ @ . . . . . . @ . @ . . . . @ . . . . 
. . @ @ . . . . . . . . . . . . @ . . . . . . . . @ . . . . @ . 
. . . @ @ . . @ . . . . . . . . . . . @ . . @ . . @ @ . . . . . 
. . . . . . . @ . . @ . . @ . . @ . . . . . @ @ . . @ . . . . . 
@ . @ . . . . @ . . . . . . . . . . @ @ @ @ . @ @ . . . . . @ @ 
@ . @ . . . @ . . . . . @ . . @ . . . . . . . . . . . . . . . . 
. . . . . . . @ . @ . . . @ . . . . @ . @ . . . @ . . . . . . . 
@ . . @ @ . . . @ . . . @ . @ . . . @ . . @ . . . . . . . . . . 
@ . . . . . @ . . . . . . . . . . . . @ . @ . . . . . . . . . . 
. . @ . . @ . . . @ . . . . . @ . . . @ . . . . @ . @ . . @ . . 
. . @ . . . . . . . . . @ . . . @ @ . . . . . . . . . . . @ . . 
. . . @ . . . . @ . . @ . . . @ @ . . . . . . . . . . . . . . . 
. . . @ @ . . . . . @ . @ . . . @ . . . @ . . @ . . . . . . . . 
. . . . . . @ . . . . . . @ @ . . . . . . . . . . . @ . . @ . . 
. . . . . . @ . . . . @ . . . . . . . . . . . . . . . @ . . . @ 
. . . . . . . . . . @ . . . . . . . . @ . @ . . . . . @ . . . . 
@ . @ . . . . . @ . . . . . . . @ . @ . . . @ . . . . . . . @ . 
. . . @ . . . @ . @ . . . . @ . . . . . . . @ . . . . . . . @ . 
. . . . @ . . . . . . . . @ @ @ . . . . @ . . . . . . . . . . @ 
@ @ @ @ . . . . . . . @ @ . . . . . . . . . @ . . @ . . @ . . . 
. . . @ @ . . @ . . . . . . . . . . . . . . . @ . . . . . . . . 
@ . . . . . . . . @ . . @ . . . . . . . . . . . @ . . . . . . . 
@ . . . . @ @ . . @ . @ @ . . . . . @ . . . . @ . @ . @ @ . @ . 
. @ . . @ . . . . . . . @ . . . . . . . . @ . . . @ . . . . . . 
. . @ . @ . @ . . . . . . . . . . @ . . @ . @ . @ . . . . . . . 
. . @ . . . . . @ @ . . . . . . . . . @ . . @ . . . @ . @ . . @ 
@ . . @ . . @ . @ . . . @ . . . @ . . . . . . . . . . . . . . . 
. . . . . . . . @ @ . . . . . @ @ . . . . . . . . @ . @ . . @ @ 
. . @ . . . . . . . . . . . . . . @ . . @ . . . . . . . @ . . . 
. . . . . @ . @ . . . . . @ @ @ . . @ . @ . @ . . . . . . . . . 
@ . @ @ . . @ . . . . . . . . . . . . . . . . @ . . @ . . . . @ 
. . . . . @ . . . . @ . . . . . . @ . . . . . @ @ @ . . . . . @ 
80
27 24 9 7
28 6 1 20
9 13 27 31
6 25 7 11
7 18 0 12
14 4 18 9
24 13 27 19
8 2 9 31
9 1 5 24
1 13 15 6
30 9 9 23
19 23 31 1
16 21 20 23
28 20 31 26
9 24 5 4
14 6 20 13
23 24 23 24
15 15 26 15
17 9 16 14
13 28 9 29
17 16 22 31
9 8 6 20
8 8 30 14
1 16 17 26
0 20 28 12
22 8 30 5
14 19 26 27
25 0 16 20
27 7 6 15
0 23 24 14
25 6 18 30
25 5 10 18
19 27 21 19
31 9 6 7
5 16 11 15
28 12 19 5
16 23 3 31
13 20 22 5
14 1 9 16
22 1 0 0
8 10 4 27
11 4 13 31
12 25 13 15
23 6 7 10
3 23 8 0
14 0 6 9
27 1 24 0
7 28 1 27
21 26 3 29
10 17 26 26
8 12 7 1
15 1 22 8
22 5 11 13
21 29 30 10
26 19 25 25
17 27 28 11
15 12 5 7
20 3 21 10
7 8 30 0
24 2 18 10
24 3 8 8
27 16 7 27
5 17 18 15
9 7 14 2
1 28 2 12
21 10 8 20
8 19 11 26
11 18 17 17
21 14 9 13
7 27 21 22
24 22 19 26
5 3 26 22
6 29 4 25
23 9 16 15
21 27 17 19
18 24 13 1
6 18 11 8
25 30 10 26
14 11 29 27
11 25 28 13
