32 32
. . . @ . @ . . . . . . @ @ . . . . . . . . . . @ @ . . @ . . . 
. . . @ . . . @ . . . . . . . @ @ . @ @ . . . . . . . . @ . . @ 
. @ . . . . @ . @ . . . @ @ . . . . . . . @ . . . . . . . . . . 
. . . @ . . . . . . @ . @ . . . @ @ . . . . . . . . . . . . . @ 
. . . . @ . . . . . . @ @ . . @ . . . . @ . . . @ . . . @ . . . 
. . . . . . . . @ . . . @ . . . . . . . . . . . . . . . . . . . 
@ . . . . . . . . . . . @ . . @ @ . . . . . . . . . . @ . . @ . 
. . . @ . @ @ . . . . . @ . @ . @ . . . @ @ . . @ @ . . @ . . . 
. . . . . @ . . . . . . @ . . . . . . . . . @ . . . . . . @ . . 
. @ . . . . @ . . . @ @ . . . @ . . @ . . . . . . . @ . . . . . 
@ @ . . @ . . @ @ . . . . . . . . @ . . . . @ . . . @ . . . . . 
. @ . . . @ . . . . . . . . . . @ . . . . @ . . . . . . . . @ . 
. . . . . . . . . . @ . . . . . . . . @ @ @ . . . @ . . . . . . 
. @ @ . . . . . . . . @ . @ . . . @ . . . . . . . . @ . . @ . . 
. @ @ . . . . @ . . . . . . . . @ . @ @ @ . . . . . . . . . . . 
. . . . . . . . . . . . . . . . . . . @ . . . . . . . @ . @ . @ 
. . . . . . . . . @ . . . . . . . . . @ . @ . . . . @ @ . . . . 
. . . . @ . . . . . @ @ . . . @ . . . . . . . . . . . @ . @ . . 
. . . . @ . . . . . @ . . . . @ @ . . . . @ . . . . . . . . @ . 
. . . @ @ . . @ @ . . . . @ . @ . . . . . . . . . . . . . . . . 
@ @ . . . . . . . . . . . . . . . . . @ @ @ . . . . . @ . @ . . 
. . . . . @ . . . @ . . . @ . . . . . . @ . . . . . @ . @ . . . 
. . . . . @ . . . . . . . @ . . . . @ . . . . . . . . . . . . . 
@ . . . . . . . . . . . . @ . . . @ . @ . . @ @ . . . . . . . @ 
. . . @ . . . . . . @ . @ . . . . . @ . . . . . . . . . @ @ . . 
. . . . . . . . . . @ . . . @ . @ . @ . . @ @ . . . . . . @ @ @ 
. @ . . . . . @ . . . . . . . . . . @ . . . @ . @ . . . . . . @ 
@ . @ . . . @ . . @ . @ . . @ . @ . . . @ . . @ . . . @ . . . . 
@ . . . @ . . . . . . . . . . . . . . @ . . . . . . @ @ @ @ @ . 
@ . . . @ . . . . . . . . . . . @ . . . . . . @ @ . . . . . @ . 
. . . . . @ . . . . @ @ . @ . @ . . . . . . . . . . . . @ . @ . 
. . . . . . @ . . . . @ . . . . . . . . @ . . . @ . . . @ . @ . 
20
0 14 19 0
7 12 21 10
24 22 18 13
25 11 16 8
9 19 8 17
2 23 18 18
21 4 22 17
13 4 21 5
9 17 6 24
17 31 2 23
2 28 19 5
1 4 27 30
21 10 17 28
21 5 13 3
3 21 9 5
29 23 0 4
0 5 8 12
7 25 13 9
29 27 12 13
9 10 6 1
