32 32
. . . . . . . . . . . @ @ . . . . . @ . . @ . . . . @ . . . . . 
. . . @ @ @ . . . @ . . . . . . . . . . . . . . @ . @ . . . . . 
. . . . . . . . . . . . . @ . . @ . . . @ . . . . . . . . . . . 
. . @ @ . . . . . . . . . . @ . @ . . . . . . . . . @ . . . . . 
. . . . . . . . @ . . . . . @ . . . @ . . . . . @ @ . . . . . . 
. . . @ . . . . @ @ . . . . @ . . . . . . . @ . @ @ @ . . . @ . 
. . . . . . . . . @ . . @ . . @ . @ . . . @ . . . . . . @ . . @ 
. @ . . . . . . . . . . . . . . . @ . . . . . . . . @ . . . @ . 
. . . . @ . . . . . . . @ . . . . . . . @ . . @ @ . . @ . @ . . 
. . . . . . . . . . . . . . . . . . . . . . . . . @ @ . @ . @ . 
. . . @ @ . . . . @ . . . . . . . . . . . . . @ @ . . . . . . . 
@ . . . . . . . . . . . @ . . . . . @ . . @ . . . . @ @ . . . . 
. . . . @ @ . . . . @ . . . . . . . . @ . . @ . @ . . @ . @ . . 
. @ . . . . @ . . . . . @ . . . @ . . . . . @ @ . . . . . . . . 
. . . . @ . . . . . . . . . . @ @ . . @ . . . . . . . . . . @ @ 
. . @ . . @ . . . @ . . @ . @ . @ @ . . . . @ . . @ . @ . . . . 
. @ . . . @ . . . . @ . . . . . . . . . . . . . . . . . . . . @ 
. . . . @ . . . . . . . . @ . . . . . . . @ . . . . . . . . . . 
. . . . . . . . . . . . . @ . @ . @ @ @ . @ . @ . . . @ . . . . 
. . @ . . . . . . . . . @ . @ . . . . . . . . . @ . . . . @ . . 
. . . . @ . @ . . @ . . . . . . @ . . @ . . @ . @ @ . . @ @ . . 
@ . . . . . @ . @ . . . . . . . . . . . . . . . . . . . . . . . 
. . . . . @ . . @ . . . @ . . . . . . . @ @ . . . @ . @ @ . @ . 
@ . . . . . . @ @ . @ . . . . . . . . . . . . . . . . . @ @ . @ 
. . . . . . . . . @ . . . . . . @ . @ @ . . . . . . . @ . . . . 
@ . . @ @ @ . @ @ @ . . . . . . @ @ . . . . . . . . . . @ @ . . 
. . . . . . @ @ . . . @ . @ @ @ . . @ @ . . @ @ . . . . . . . @ 
. . . . . . @ . @ . . @ . . . . . . . . . . . . . . . . . . . . 
. . . . . . . . . . . . . . @ . . @ . . . . . . . . . . @ . . @ 
. . . . . . @ . @ . . . . . . . . . . . @ . . . . . . . . @ . . 
. @ @ . . @ . . . . . . . . @ . . @ . . . . . . . . . @ @ . . . 
. @ @ @ @ . . @ . . . . . @ @ . @ . @ . . . @ @ @ @ . @ . . . . 
60
20 11 9 27
25 24 0 26
13 0 16 8
22 10 27 13
18 2 0 19
13 16 11 14
6 17 7 4
23 14 2 2
23 30 3 8
21 2 0 6
14 17 8 13
7 0 13 10
22 19 29 28
30 30 4 24
27 13 11 21
3 15 22 18
26 16 1 19
27 28 9 7
25 8 17 29
0 12 10 20
10 10 29 2
29 17 23 7
20 25 11 3
26 19 25 19
22 0 14 20
16 22 24 21
23 1 1 0
11 25 29 14
9 2 7 10
10 27 0 15
16 6 20 11
20 27 30 4
0 18 25 1
23 11 2 29
0 22 21 10
5 14 14 12
5 4 21 3
12 18 29 10
11 1 1 22
1 15 26 27
10 4 27 5
2 0 3 11
4 9 29 13
20 14 13 12
18 6 12 10
22 2 19 21
14 2 4 19
5 10 8 31
19 28 0 28
30 3 27 7
7 3 12 31
23 25 0 20
29 13 10 24
25 26 10 26
24 7 19 5
24 25 9 4
25 3 12 20
4 16 19 29
22 7 0 31
6 25 3 0
