32 32
. . @ @ . @ . . . . . . . . . . . . . . . . . . . . . . . @ . . 
. @ . . @ . . @ . . . @ . @ @ . . . . . @ @ . . . @ @ . . . . . 
. . . @ . . . . @ . . . . . . . . . . . @ . @ . . @ . @ . @ @ . 
@ . . @ . . . . . @ . @ . . . . @ . . @ @ . . . . . @ @ @ @ . . 
. . . . . . . @ . @ . . . . . . . @ . @ . @ @ . @ @ . . . . . . 
. . . . . . . . . . . . . . . . @ @ . . . . @ . @ . @ . . . @ . 
. . @ . . @ @ . @ . . . . . . . . . @ @ @ . . . . . . . . . . . 
. . . . . . . . . @ . . . @ . . . . @ . . . . . . . . . . . . . 
@ . @ . . . . . @ . . . . . . . . @ . . . @ . . . @ . @ . . . . 
. . . . . . . . @ . . . . . . . @ @ . . . @ . @ @ . @ . @ . . . 
. . @ . . @ @ @ . @ . . @ . . . @ . . . . . . . . . . @ . . @ @ 
. . . @ . . . . . . . . . . . . . . @ . . . . . . . . . . . . . 
. . @ . @ . . . . . . . . . . . . . . . . . . @ @ . . . . . . . 
. . . . . . . . . . . . . . . . . @ . . . @ . . @ @ . . . . @ . 
. . @ . . @ . . @ . . @ . . . . @ . . . . . . . . . @ . . . . . 
. . . @ . . . . . . @ . . . . . @ . @ . . @ @ @ . . . . . . . . 
. . . . @ . . . . . . . @ . @ . . . @ . . . . . . @ . . . . . . 
. . . . . @ . . . @ @ . . . . . . @ . . . . @ . . . . . . . . . 
. . . @ . @ . . . . . . @ . . . . @ . . . . @ . . . . @ . . . . 
. . . . . @ @ . @ . . . . . . @ . @ . . . . . . . . . @ . . . @ 
. . . . . . . . . . . @ . @ . . @ . . . . @ . . . @ . . . . . . 
. @ . . . . . . . . . . . . @ . @ . . . . . . . . . . . . . . . 
. . . . . @ @ . . . . . . . . . . . . @ . . @ . . . . . . @ . . 
@ . @ . . . . . @ . . . . . @ . . @ . . @ . . . @ . . . . . . . 
. . @ @ . . . . . @ . . . . . @ . @ . . . . . @ . . @ . . . . . 
. . . . . . . . @ . . . . . . . . . . . . . . . . . . . . . @ . 
. . . @ . . . . . @ . . @ . . @ . . . . @ @ . @ . . . . @ . . . 
. . . . . . . . . . . . . . @ @ . . . @ @ . @ @ . . . @ . . @ . 
. . . . . . . . . . @ . @ . . . . @ . . . @ . . . . . . . . . . 
. . . . . . . @ . . . . . @ @ . @ . . . @ @ @ @ . @ . @ . . . . 
. . @ @ . . . @ . . . @ @ . . . . . . @ . @ . . . @ . . . . . . 
@ . . . . . . . . . @ . @ . . . . . @ @ . . @ . @ . . . @ . . . 
30
26 29 30 3
0 14 22 28
7 7 29 20
31 16 18 4
1 12 14 3
27 12 9 23
6 2 2 2
14 31 19 21
10 4 7 15
25 26 18 20
16 0 21 3
13 28 0 17
4 5 8 10
4 2 7 9
10 9 5 13
23 0 4 19
15 18 13 3
17 30 12 0
1 28 25 26
21 10 22 25
1 14 21 14
9 19 7 21
1 13 28 24
13 17 12 13
15 23 3 20
6 5 23 5
18 20 3 1
6 15 10 24
6 16 23 20
16 24 30 28
