32 32
. . . @ . . . . . @ @ . . . . . . . . . . . . . . . . . @ . . @ 
. . . . . . . . . . @ . . . . . @ . . . . . . @ . @ . . @ . . . 
. . @ @ . @ @ . . . . . . . . . @ . . . . . . . . . . . . . @ . 
. . . . . . @ . @ . . . . . . @ . . . . . . . . . @ @ . . . . . 
. @ . . . . . @ . . . . . @ @ . . . @ . @ . . @ @ . . . . . . . 
. . . . . . . . . . . @ . . . . . . . . . . . . @ . . . . . @ . 
@ . . . . @ @ . . . . . @ . . . . . . . @ . @ . . . . . . @ . . 
. . . . @ . . . . . @ . . . . . . . . . . . . . . . . . @ . . . 
. . @ . . . . @ . . . . . . @ . . . . @ . . . @ . . @ . . . . . 
. . . . @ @ . . . . . . @ . @ . . @ . . . @ . @ . . . . . . @ @ 
. . @ . . @ . . . . . . . . . . @ . . . . . . . . . . . . @ . @ 
. . @ . @ . . . . . . . . . . . . . . . @ @ . . . . . . . @ @ . 
@ . @ . . . . . . . . @ @ . . . . @ . . . @ . . . . . . . @ . . 
@ . . . @ . . . . . . . @ . . . @ . @ . . @ @ . . . . . . . @ @ 
@ . . . . . . . . . . . . @ . . . . . . . . . . . @ . . . . . . 
. @ @ . @ . . . . @ . . . . . @ . @ . . . . . . . . . @ . . . @ 
. @ @ . . . @ @ . . . @ . . @ @ . . @ @ . . . @ . . . . . . @ . 
. . . @ . @ . . @ . . @ . @ . . . . . . . . . . . . . . . . . . 
. . @ . @ . @ . . . . . . . . . . . . . . . . . . . . . . . . @ 
@ @ . . . . . . . @ . @ . @ @ . @ . @ . . . . . @ . . . . . . . 
. . . . . . . @ . . . . . . . . . @ . . . . @ . . . . . . . . . 
. . . @ @ . @ . @ . . @ . . . . . . . . . . @ . . . . . . @ . . 
. . @ . . . @ . . @ . @ . . . . . . . . . @ . @ . . . . . . . . 
. . . . . . . . . @ . . @ . . @ . @ . . . @ . . @ @ . @ @ . @ . 
. . @ . . . . . . . . . . . . . . . . . @ . @ . . @ . . . . . . 
. . . @ . . . . . . . . . . . . @ . . . @ . @ . . . . . . . . @ 
. @ . . @ . . . @ . . . @ . . @ . . . . @ . . . @ . . . . . . . 
. @ @ . . . . . . . . . . . . . . . . . . . . . . . . . . . . . 
@ . @ . . . . . . . . @ @ . . @ . . . . @ . . . . . . . . . . . 
. @ @ @ . . . . . . @ . . @ . . . @ . . . . . . . @ . @ @ . . . 
. @ . @ @ . . . . . . @ . . . . . . . . . @ . @ . @ . . . @ . @ 
. @ . . . @ . @ . @ . @ @ . . . . . . @ @ @ . . . @ . . @ @ . . 
30
31 27 12 14
6 25 5 24
25 25 8 16
12 1 16 14
25 12 28 12
20 15 8 8
6 9 12 1
5 21 5 3
15 29 13 5
13 24 12 29
27 25 16 17
8 23 19 30
25 26 7 3
26 17 30 22
19 18 18 31
1 21 31 16
6 12 12 20
10 5 26 5
25 18 3 3
31 8 9 5
15 1 11 6
16 26 18 10
31 29 11 1
26 18 22 27
15 6 31 2
16 22 1 7
21 17 9 14
18 14 3 6
31 1 21 14
10 11 7 24
