32 32
. . . . . . . . . . . @ . @ . . . . . @ . . . . . . . @ . . . . 
@ . . @ @ @ . @ @ . @ @ . . . . . . . . . . @ . . . . . @ . . . 
. . @ . . . . @ . . @ . . @ . . . @ @ @ . @ . @ . . . @ . . @ . 
. . . . @ . . . . . . . . . @ . . . . @ . . . . . . . @ . . . . 
. . . . . . . . . @ . . . @ . . @ @ . . . @ . @ . . . . . @ . . 
. . . . . . . @ . . . . . . . @ . . . . . . . . . . @ . . . @ . 
. . . @ . . @ . . . . . . . . . . . . @ . @ . . @ . . . . @ @ . 
@ . . . . . . @ . . . . . . . . . . . . . . . . @ . . . . @ . . 
. . . . . @ . . . . . . . . . . @ . @ @ . . @ . . . . . . . . . 
. . @ . @ . . . . . . . . . . . . @ @ . . . @ @ @ @ . . . @ . . 
@ . @ . @ @ . @ . . @ @ . . . @ . . . . . @ . @ . . @ @ . . . . 
. . . . . . . . . . . . . . . . . . . . @ . . . . . . @ @ @ @ . 
. . @ . @ . . . . @ . . . . . . . . . . . . . . @ . . . . . . . 
. . . @ . . @ @ . . . . . . @ . . . . . . . . . . . . @ @ . . . 
. . . @ . . . . @ . . . . . . . . . . @ . @ . @ . . . @ . . . . 
. . . . . . . . . . . . @ . . . @ . . . . . . @ @ . . . . . @ . 
. @ . . . . . . . . @ . . . @ @ . . . . . . . @ . @ . . @ . . . 
@ . . . . . . . . @ . . . . . @ @ @ . . . @ . @ . . . . . . . . 
. . . . . . . . @ @ @ . . @ . . . . . . . . . . . . . . . @ . . 
. . . . . . . . . . . @ . . @ . . . . @ . . . . . . . . . . @ . 
. @ . @ . . . . @ @ . . . @ @ @ . . . . @ . . @ . . . . . . . . 
. @ . @ . . . . . @ . . @ @ @ @ . . . . . . . . . . . . . . . . 
. . . . . . . . @ @ . . @ . . . @ . @ . . . . . . @ . @ . . . . 
. . @ @ . . @ . . . . @ . . . . . . . . . . . . . . . . . @ . . 
@ . . . @ . . . . . @ . . @ . . @ . @ . . @ . . . . . @ . @ . . 
. . @ @ . . . . @ . . . . @ @ . . @ . . . . . . . @ . . . . . . 
. . . . . . @ . . . . . . @ . . . . . . @ . . . . . . @ . . . . 
@ . . . . . . . . . . . @ . @ . . @ @ . . . . . . @ . @ . . @ . 
. . . . . . . . . . . . @ . . . . . . . @ . . . . @ . @ . . . @ 
. . . . . . . . . . . @ . . . . . @ . @ . . @ . @ . . @ . . . . 
. @ . . @ . . . . . . . . . . . . @ . @ . . . . . . . . . . . . 
@ . . . . . . @ . @ . . . . . . . . . @ @ . . . . . . @ . @ . . 
10
5 17 5 3
16 5 22 16
16 20 23 28
20 9 16 6
18 21 13 12
12 16 3 7
27 21 11 28
8 8 11 16
28 21 3 5
6 21 1 22
