32 32
. . . . @ @ . . . . . @ @ . . . . . . @ . . . @ @ . . . . . . @ 
. . . . @ . @ . . . . . . . . . . . @ . @ . . @ . @ . . @ @ @ . 
. . . @ @ . . . @ @ . . @ . . . . . . . . . . @ . . . . @ @ . . 
. @ @ . @ @ . . @ . . @ . . . . . . . . . . . . . @ . . . . . . 
. . . . . . . . . @ . . . @ . . . . . @ . . . @ . @ @ . . @ . . 
. @ . . . . . . . . @ . . @ . . . . . @ . . . @ . @ @ . @ @ . . 
@ @ . . . @ . . . @ . . . . . @ . . . . . . . @ . @ @ . . @ @ . 
. . . . . . . . . . . @ . . @ @ . . . . . . . . . . . . . . . . 
. . . . . . . . . . . . . . . . . . . . @ . . . . . . . . . . . 
. . . . . . . . @ @ . . . . . @ . . . . . . . . . . . . . . . @ 
. @ @ . . . @ . . . . . . . . @ . @ . . . . . . . . . . . . . . 
@ . . . . . . @ @ @ . . @ . . . . . . . @ . . . . . . . . . . . 
. . . . . . . . . . . . @ . . . . . . . @ . @ . . . . @ . @ . . 
. . . . @ @ . @ . @ . . . . . . . . . . @ @ . . . . . . . . . . 
. @ . . . . . . . . @ @ . . @ . . . . . @ . . @ @ . @ @ . . . . 
. . . . . . . @ . . . . @ . . . . . . . . . . . . . . @ . . . . 
. . . . @ . . . . . . . . . . . . . . . . . . . . @ . . @ . @ . 
. . . . . . . . . . @ . . . . . . @ . . . . . . . . @ @ @ . . . 
. @ . . . . @ . @ . . . @ . @ . . . @ . . . . @ . . . . . . . . 
. @ . . . . . @ . . . @ . @ @ . @ . @ . . . @ . @ . . . . . . . 
. . . @ . . . . . . . . . @ . . . . . @ . @ . . . . . . . . . . 
. . . . . . . . @ @ @ . . . @ . . . . . . . . . . . @ . . . . . 
@ @ . . . . . . . . @ . . . . . . @ . . . . . . @ . . . . . @ @ 
. . . . . @ . . . @ @ . @ . . @ . . @ . . . . . . @ . . . . . . 
@ @ . . . @ . @ . . . . . . . . . . . . @ . . . @ . @ . @ . . . 
@ . @ . . . . . . . . . . @ . . . . . . @ . . . . . . @ . . . . 
. @ . @ . . . . . @ @ @ . . . . . . . . . @ @ @ . . @ . @ . . . 
. @ . . @ . . . @ . @ @ . . . . . @ . . @ . . . @ . . . . . . . 
. . . . . . . . @ . @ . . . @ . @ . . . . . . . . . . . @ . . . 
. . . @ . @ . . . . . . @ . . . . . @ @ @ . . . . . @ @ @ @ @ . 
. . . . @ . . . . . @ . . . . . . . . . . . . . . @ . . . . . . 
@ . . . . . . . . @ . @ . . . . @ . . . @ . . . . . . . . . @ . 
80
29 15 28 30
26 1 4 19
27 9 17 7
23 3 8 6
21 5 29 22
16 5 15 30
12 28 7 5
11 4 8 16
22 5 12 17
7 29 29 27
14 12 26 10
11 20 29 7
16 24 5 17
3 4 13 29
21 23 31 10
2 15 5 8
16 25 16 27
0 12 26 23
17 24 11 13
27 7 6 12
12 27 28 4
17 15 0 16
29 0 31 6
16 29 27 24
24 12 2 7
5 30 7 17
16 7 14 24
6 23 23 24
3 10 23 25
19 24 13 11
31 3 6 15
3 31 0 18
19 13 3 3
20 0 30 25
18 31 27 0
22 8 3 8
23 21 22 10
28 27 25 0
22 20 16 25
5 5 2 26
31 20 12 31
8 20 4 4
19 12 18 6
30 11 31 18
7 4 2 4
2 0 27 26
22 4 27 13
3 16 8 22
16 26 22 1
15 12 20 28
10 12 25 26
6 17 21 11
0 17 13 1
5 14 27 4
26 13 23 7
9 12 24 5
11 22 24 31
12 1 24 4
16 15 12 22
25 12 11 12
7 21 14 2
9 16 19 10
14 27 14 30
7 5 9 14
26 0 20 30
2 6 0 21
23 23 1 11
15 25 13 27
11 9 30 20
6 28 10 16
22 14 17 13
25 14 26 7
14 17 5 20
24 6 11 25
20 21 6 22
12 17 14 1
24 11 19 27
28 15 25 19
14 31 8 0
22 10 4 29
