32 32
. . @ . . . @ . . . . . . . . . . . @ . @ @ . @ . . @ @ . . . @ 
. . . . . . . . . . @ @ . . . . @ . . . . . . . . . . . . . . . 
. . @ . . @ . @ . . . @ . . . @ . . . @ . . . . . . . . @ . @ . 
. . . . . @ . . . . @ . . . . . . . . . . . . . . . @ . . @ . @ 
@ . . . . . . . . @ . . . . . . . . . @ @ . @ . . @ . . . @ . . 
. @ @ . . . . . . @ . . . . @ @ @ . . . . . @ . . . . . . . . . 
@ . . @ . . . . @ . . @ . . . @ . @ . . . . . . . . . . . @ @ . 
. . . . @ . . . . . . . @ . . . . . @ . . . . . . . . . . . @ . 
. . . . . . . . . . @ . . . . @ . . . . @ . . . . . . . . . . @ 
. . . . . . @ . @ . . . . . . . @ . . . . . . @ . . . . . . . . 
. . @ . . . . . . @ @ @ . . . . @ . . @ . . . . . . . . . . . . 
@ . . . . @ . . . . @ . . . . @ . @ . @ @ . . . . . . . . . @ . 
. . . . . . . @ . @ . . . . . . . @ . . . . . . . . . . . . @ @ 
. . @ . . . . . . . . @ . . . . . . . . . . . . . . @ @ @ . . . 
. @ @ . . . . @ . . . . @ @ . . . . . . @ . . . . . . . . . . . 
. @ . . . . . . . . . . . . . @ . . . @ . @ . @ . . . . . . . . 
@ . @ @ @ . . . . . @ . . @ . . @ . . . . . . . . . . . @ @ . . 
. . . . @ . . . . . . . . @ . . . . @ . . . . @ . @ . . . . . . 
. . . . @ . . . @ . . . . . . . . @ . . . . . . . . . . @ . . @ 
. . . . . . . . @ . . . . . . . . . . @ . . . . . . @ . . . . . 
. . @ . . . . . . . . @ @ . . @ . . @ @ . @ . . @ . . . . . @ . 
@ . . . @ . . . . . . . . @ . . . . . . @ @ @ . . . . . . . . . 
. @ . . . . . . . . . . @ @ @ @ . . . . @ @ . . . @ . @ . . . . 
. . . . @ . . . . . . @ . . . . @ . . . @ . . @ . . . . . . @ . 
. @ . . . . . . @ . . . . @ . . . . . . . . . @ @ . . . . . @ . 
. . . . . . . . @ @ . @ . @ . . . . @ . @ . . . . @ . . . . . @ 
@ . . . . . . . @ . . . @ @ . . @ . . . . . . . . . . . . . . . 
@ . . . . . . . @ @ @ . . @ . . . . . . @ . . @ @ . . . @ . . . 
. @ . @ . . . @ @ . . @ . @ . . . @ . . . . . . . . . . . . . . 
. @ . @ @ . @ . . @ . . . . . . @ . . . . . . @ . . . @ . . . . 
. . . @ . @ . . . . . . . . . @ . @ . @ @ . @ . . . . @ . . . . 
. . . . . . . . . @ @ . @ . . . . . . . . @ . . @ @ . . . @ . . 
50
12 9 4 10
16 18 1 7
15 14 24 3
31 13 25 12
31 2 12 27
30 30 13 0
7 27 26 18
22 16 7 29
12 30 4 30
13 7 21 30
6 7 9 19
1 26 1 4
7 5 0 31
18 24 18 13
22 24 2 17
15 24 28 8
20 2 6 27
23 21 1 31
14 28 19 26
12 15 6 6
25 14 22 29
27 27 2 29
30 22 3 17
0 14 13 7
0 29 7 25
10 23 14 3
13 1 3 5
9 16 10 25
4 25 7 6
17 21 27 1
24 30 14 14
8 21 24 28
4 20 20 10
13 31 27 27
23 1 8 4
27 8 22 7
7 13 19 0
4 22 24 18
24 6 15 21
12 24 7 22
18 22 7 31
28 5 5 24
17 8 9 18
24 4 21 28
12 18 8 12
9 11 13 13
10 19 14 23
4 12 23 16
16 11 22 10
9 18 14 29
