32 32
. . . . . . . . . . . . . . @ . . . . . . @ @ . . . . . . . . . 
. . @ . . . . . . . . . @ . . . . @ . . @ . . . . . . . . . . . 
. . . @ . . @ . . . . . @ @ . . . @ . . . . @ . . . . @ @ . . . 
@ . @ . . . . . . . @ . . @ . . . @ . . @ @ . . . . @ @ . . . . 
. . . . . . . . . @ . . . . . . @ . @ . . @ . . . @ . @ . . . . 
. @ @ . . . . . . . . . . . @ . @ . . . . . . . . . . . . . @ . 
. . . @ . . @ . . . @ @ . . . . . . . . . . . . . @ . @ . . . . 
. @ . @ . @ . . @ . . . . . @ . . . @ . . . . . . . . . . . . @ 
. . @ . . @ @ . . @ @ . . . @ . . . . . . . . . . . . . . . @ . 
. . . . . . . . . . . . . . @ . . . . . . . . @ . . . . . . @ . 
. . . . . . . . . @ . . . @ . . @ @ . . . . . . @ @ @ . @ . . @ 
. . . . . . . . . @ . . . @ . . @ . @ . . . . @ . . . @ . @ . . 
. @ . . @ . . . @ . . . . . . @ @ @ . . . . . . . . . . @ . . @ 
. . . . . . . . . @ . . @ . . . . . @ . . . . . . . . . . . @ . 
. @ . . . . . . . . @ . . @ . . . . . . . . . @ . . . . . @ . @ 
. . . . . . . . . . . . . . . . @ . @ . @ @ . . . . . @ . @ . . 
@ . . . . . . . @ . . . . . @ @ . . @ @ . @ . . . . . . . . . @ 
. . . . . . @ @ . . @ . . . . . . . . . . @ . @ @ . . . . . . . 
. @ . @ . . @ . . . . . @ . . . . . . . . . . . . . . . . @ . . 
. . . . . . . @ . . . . . @ . . . . . . . . @ . @ @ . . . . @ . 
. @ . . . . . . . @ . . @ . @ . @ . . @ . . . @ @ . . @ . . . . 
. . . . . . @ . @ . . . . . . . @ . . . . . . . . @ . . . . . @ 
. @ @ . . . . . . . @ . . @ . @ . . . @ . . . . . . . . . . . . 
. . @ . . . . . . . @ . . . @ . . @ @ . . . @ @ . . @ . . @ . . 
. . . . . @ . @ . @ . @ . . . . . . @ . . @ @ . . . . . . . . . 
. . @ . @ . @ . . . . . . . . . . . . . . . . . . . @ . . . . @ 
@ . . . . . . . . . . . @ . . . . . . . . . . . . . . . . . . . 
@ @ @ . @ @ . . . . . . . . . . . @ . . . . . . . @ . . . . . . 
. . . . . @ @ @ . @ . . . @ . @ @ . . . . . @ . . @ . @ . . . @ 
. . @ . @ @ . . . @ . . . . . @ . . . . . . . . . . . . . . . . 
. @ . @ @ @ . @ . . @ . . @ . . @ . @ @ . . . . @ . . . . . @ @ 
. @ . . . . . . . . . . . . . . . . . . @ . . . . . . . . . . . 
60
24 22 31 29
3 13 18 0
8 26 21 2
19 18 21 7
16 2 10 0
27 10 18 27
12 12 16 29
18 17 20 17
3 29 8 25
20 18 6 22
13 7 15 4
0 4 20 24
1 23 20 27
25 3 7 11
0 17 2 6
1 29 3 1
27 8 25 0
4 19 12 11
19 14 7 27
12 23 24 4
7 13 14 10
14 18 19 1
5 31 31 3
26 18 15 19
30 18 15 23
6 24 13 27
5 10 30 17
0 9 17 18
1 10 6 19
20 6 21 5
21 21 5 20
15 6 7 14
27 27 13 31
21 10 10 18
27 16 27 9
20 30 9 31
15 26 25 12
13 31 20 4
1 24 6 12
17 15 11 13
9 6 19 26
17 18 5 26
5 6 23 7
13 8 27 17
11 16 21 25
7 8 30 26
21 18 15 24
23 26 0 17
16 17 3 16
0 12 24 25
19 21 15 6
21 13 27 30
28 29 10 4
6 22 18 19
20 20 17 26
21 5 20 25
10 10 18 22
4 16 20 8
26 20 13 24
19 9 0 0
