32 32
. @ . . . . . @ . . @ . . . . . @ . . @ @ . . . @ . . @ @ . . @ 
. @ . . . . @ . . . . . . . . @ . . . . . . . . @ . . . . . . @ 
. @ @ . @ . . . . @ . . . . . @ . @ . @ . . . . . . . . . . . . 
. @ . . . @ . . . . . @ . @ @ @ . @ . @ @ @ . . . . . . . . . . 
. . . @ . @ . . . . . @ @ @ . . . . . . @ . . @ . . @ . . . . . 
. . . . . . . . . . . . . . . . . . @ . . . . . . @ . . @ . . . 
. . . . . . @ @ . . . @ @ @ . . . . . . . . . . @ . . . . . . . 
. . . @ . . . . . . @ @ . @ . . @ . @ @ . . . @ . . . . . . . . 
. @ @ . . . . . . @ . . . . . . . . @ . @ . . . . . . . . . @ @ 
. . . . . @ . . . @ @ @ . . . . @ . . . . . . . . . . @ . . . . 
@ @ . . . @ . @ . @ . @ . . @ @ @ . . . . . . @ . . . . . . @ . 
. . @ . @ . . . . . . . . . . . . . . . @ . . . . @ @ . . . . . 
. . . @ . . @ . . . . . . . . . . . . . . . . . @ . . @ @ . . . 
@ . . . . . . . . . . @ . @ @ . . @ @ . . . . . . @ . . @ . . . 
. @ @ . . . . . . . . . . . . . . . @ . . . . . . . . . . . . @ 
. . . . @ . . . @ . . . . . @ . . . . . . . . @ . . @ . . @ . . 
. . . . . . . . @ . . . @ @ @ . . . @ . . @ . @ . . . . . . . . 
. . . . . . . @ . . @ @ @ . @ . . . . . . . . . . . . . . . . . 
. . . . @ @ . @ @ . . . . . . . . . . @ . . . . . . . @ . @ . . 
. . @ . @ . . . . @ . . . . . . . @ @ . @ . . . . @ . @ . . . @ 
. @ . . . . . . @ @ @ . . . @ . . . . @ . . . . . . . . . . . . 
. . . . . . @ . @ . . . . . . . . . . . . . . . . . . @ . . . . 
. . . . @ @ . . @ . @ . . . . . . . . . . . @ . . . . . . . @ . 
. . . . . @ . . . @ . . . . . . . @ . . . @ @ . . . @ @ . @ . . 
. . . . @ . . . @ @ @ . . . . . . . . . . . @ . . . @ @ . . . . 
@ @ . . . . . . . . . . . . . . . . . . . . . . . . . @ . . . . 
@ . . @ . . . . . . . . . . @ . @ @ . @ . . @ . . @ . . . @ . . 
. . . . . @ . . . @ @ . . . . . . . . @ . . . . @ @ . . . . . . 
. . . . . . . @ . @ . . . @ . . . . . . . . . @ . . . . @ @ . @ 
. . . . . . . . . . @ @ . . . . . . . . . . . . . . . . . . @ . 
. . . . . . . . . . . . . . . . . @ @ . . . . . @ . . . . . . . 
. . . . . . . . . . . . . . . . . . @ . @ . . . @ @ . . @ @ . . 
70
25 18 22 14
19 25 18 18
14 1 4 28
22 9 23 24
16 16 8 7
17 25 2 31
24 29 4 7
21 7 11 18
10 23 0 14
19 1 13 2
9 3 5 30
27 20 30 0
0 2 10 3
23 14 1 19
6 22 2 10
15 25 16 22
9 5 23 21
20 18 6 28
23 6 24 19
8 4 23 8
8 1 14 9
16 22 28 4
8 28 8 2
21 2 31 16
30 15 11 12
17 7 12 21
10 13 17 6
10 18 28 14
21 18 11 31
27 26 7 16
23 13 21 7
13 18 10 1
31 20 14 2
9 6 14 19
19 8 7 4
29 30 14 1
9 15 1 18
21 30 12 28
7 5 24 7
17 11 22 31
21 9 9 29
23 5 24 26
17 16 21 6
25 9 15 20
2 29 16 3
12 25 3 0
30 19 27 26
31 17 15 29
6 5 7 30
17 24 4 0
17 22 8 13
26 10 5 31
7 2 30 15
31 22 28 2
17 14 26 1
13 25 10 25
21 31 8 25
4 20 2 29
21 1 8 29
6 10 13 18
4 10 1 7
23 9 2 17
22 6 29 3
22 12 29 9
30 14 21 20
25 2 3 11
3 23 19 24
24 22 26 6
25 25 27 3
9 22 27 8
