32 32
. . . @ @ @ . . . . . . . . . . . . . . . . . . . . . . . @ . @ 
. . . @ . . . . . . . . . . . . @ . . @ . . . . . . . . . . . @ 
. . . . . . . @ @ . . . . . @ . . . . . . . . . . @ . . @ . . . 
@ . . . @ @ @ @ . . . . @ . . . . . . . . . . . . @ . . . . @ . 
. . . . @ . . . . . . . . . . . . @ . @ @ . . . . . . . . @ . . 
. @ . . . . . . . @ . @ . . . . @ . . @ . @ . . . . . . . . . . 
. . . . . . . . . . . . . . . . . . @ . @ . @ . . @ . . . . . . 
. . @ . . . . . . . @ . . . @ . . @ . . @ . @ . @ . @ . . . . . 
. . . . . . @ . . . . . . @ @ . @ . . . . @ @ @ @ . . @ . . @ . 
. . . . @ . . . . . . @ . @ . . @ . . . . . @ . . @ @ . . . @ . 
. . . . @ . @ . . . @ . . . . . . @ @ @ . . @ . . . . . @ . . . 
. . @ . @ . . . . . . . . . . @ . . . . . . . @ . . . . . . . . 
. . . . @ . @ . . @ . . . . . . . . . @ . . . . @ @ . . . . . . 
. . . . . @ . . @ . . . @ . . @ . @ . . . . . . . . . . . . . . 
. . . . . @ . . . . . . . . . . @ . . . . @ . . . @ . . . . . . 
. . . @ . . @ @ . . . . @ @ . @ @ . @ . . . . @ . @ . . @ . . . 
. @ . . . . . . . @ . . @ @ . . . . . @ @ . @ . . . . @ . . . . 
. . . . . . . . . . . @ . . @ . @ @ . . . . . @ @ . . . . . . . 
@ @ . . . . . . . . @ . @ . . . . . . . . . . . . . . . . . @ . 
. . . . . . . . @ @ . @ . . . . . . . . . . . @ . . . . . . . . 
. @ . @ . . . . @ . . . . . @ @ . . . . . . . . . . @ . . . @ . 
. @ @ . . @ . @ . . . . . . @ . . . . . . . . . . . . . . @ . @ 
@ @ . . . . @ @ . . . . . . . . @ @ . . . . @ . . . . @ . . . . 
. . . . . . . . . . . . . . . @ . @ . . . . . @ . @ . . @ . . . 
@ . @ . . . . . . . . . . . . . . . . . . @ . . . . . . . . . @ 
. @ . . @ . . @ . . @ . @ . . . . . @ . . . . . . . . . . . . . 
. . @ @ @ . @ @ . @ . @ @ . @ . . . . . . @ @ . @ . . . @ . . . 
. . . . @ . . . . . . . . . . @ @ . . . . . . . . . . . @ . . . 
. . . . . . . . . . . . . . @ @ @ . . @ . . . . . @ @ . @ @ . . 
. . . . . . . . . . @ . . . @ . . . . . . . . . . . . . . . @ @ 
. @ . . @ . @ @ . . . . . @ . . @ . @ @ . @ . . . . . . . . @ . 
@ . . . . @ . . . . . . . @ . . . . . . . . . . . . @ . . . . . 
40
31 12 14 25
23 29 3 22
15 4 11 23
10 9 19 14
3 30 11 1
9 0 20 28
6 16 5 25
11 16 6 31
16 13 8 8
9 18 26 29
16 11 27 15
3 28 18 14
27 4 0 9
9 9 24 9
18 1 21 25
8 26 15 3
15 29 4 13
14 22 7 28
21 17 24 13
29 5 19 8
30 21 25 25
17 3 7 1
13 4 4 21
20 17 0 8
30 10 0 27
1 27 5 9
2 25 16 16
0 28 24 15
14 9 28 16
9 29 28 6
25 17 2 19
5 2 14 1
23 24 15 24
1 24 23 7
20 19 21 3
26 18 30 27
25 1 11 8
24 10 20 24
24 9 13 3
14 10 7 9
