32 32
. . . . . . . . . . . . . . . . . @ . . . . @ . . . . . . . @ @ 
. . . . . . . . . . . @ . . . @ . . . . . @ @ . . . @ . . . @ . 
. @ . . . . . . . . . . . . . . . @ . @ . . . @ . . . . . . . . 
. . . . @ . . . . . . . . @ . . . . . . . . . . . . . . . @ . . 
. . . . . . . . @ . . . . . . . . . . . @ . . @ @ . @ . @ . . . 
@ . . . . . . . . . @ . . @ . . . . @ . @ . . . . . . . @ @ . . 
. @ . . . . @ . . . @ . . . . . . . . . . . . . . . . . . . . . 
. . . . . . @ . . . @ . @ . @ @ . . . . @ . @ . . @ . . . . @ @ 
. @ . . @ @ . . . @ . @ . . . @ . . . . @ @ . @ . . @ . . . . . 
. . . . . . . @ . . . . . . . @ . . . . @ . . . @ . . . . @ . . 
. . . . @ . . . . @ . . @ . . . . . . . . . . . . . @ @ . @ . . 
. . . . @ . . . . . . . @ . . . . . . . . . @ . . . . . . . . . 
@ . . . . . . . @ . @ . @ . . . . . . . . . . @ @ . . . . . . . 
. . . . . . . . . @ . . @ . . . . . @ . @ @ . . @ . . . . . . @ 
. . . . . . . . . . . . . . . . . . . @ . . . . . . . . . . . @ 
. @ . . . . . . . . . . . . @ @ . . . . . . . @ . . . . . . . . 
. @ . . . . . . . . . . . . . . . . . @ . . . . . . . @ . . . . 
@ . @ . . . @ . @ @ @ . . . . . . . . @ . @ @ . . . . . . . @ . 
. . . . @ . . . . . . . . . @ . . . . . . . . . . . @ @ . . . . 
@ . . . . . . . . . . . @ @ . . . . . . . . . . . . . . . . . . 
. . . . . . . @ . . @ . . . . . @ @ . . . . . . . @ @ @ . @ . . 
. . @ . . @ . . . . . . @ @ . @ . . @ . . . . . . . @ . @ . . @ 
. . . @ @ @ . . . . . . . . . . @ . . . . . @ . . @ . . @ . . . 
@ @ . . . . @ @ . @ . . . @ . . . . @ @ . . @ @ @ @ @ . . . . . 
@ . @ . . . . . @ @ @ . . . . . . . . . . . @ @ . . @ . @ . . . 
. . . . . @ . . . . . . . @ . . @ @ . @ . . . @ . . . @ . @ . . 
. . . @ . . . . @ . . @ . @ . @ . . . . . . . . @ @ . . @ . . . 
@ @ . @ . . . . . @ . . . . @ . . . . . . . @ . @ . @ . . . . @ 
. . @ . . . . . . . . . . . . . @ . . . @ @ . @ . . . @ . . . . 
. . @ . . . @ . . . . @ . @ . . . . @ @ . . . . . . . . . . . @ 
@ . . @ . @ @ . . @ @ . . . . . . . . . @ . . . . . . . @ . . . 
@ . . . . . @ . . . . @ . . . . . . . . @ . . @ . @ . . . . . . 
40
29 27 8 10
12 5 7 26
21 2 22 10
31 11 7 29
26 3 19 20
18 15 21 24
22 12 24 29
26 25 3 21
12 28 29 29
18 17 13 8
4 20 31 17
4 4 29 28
9 22 26 9
1 25 22 20
9 1 15 0
23 16 13 31
18 24 15 4
5 18 19 21
27 31 21 22
11 6 21 30
25 10 30 22
22 28 13 11
22 26 19 1
14 22 1 30
10 27 13 15
1 7 27 7
9 28 5 5
23 1 28 18
3 11 7 19
17 28 30 4
1 24 8 15
19 1 7 22
16 13 12 20
17 22 14 29
0 2 3 25
4 5 10 19
19 28 13 1
29 1 2 19
4 27 6 12
29 14 13 28
