32 32
. . @ . . . . . . . @ . . . @ . . . . . . . @ @ . . . . . @ @ . 
. . . . @ . . . . @ @ . @ . . . @ @ . @ . . . . . . . . . . . . 
. @ @ @ . . . @ . . . . @ @ . . . . . . . @ . . . . . . . . . . 
@ . @ @ . . . . . . @ @ @ . . . @ . . . . . . . @ @ . . . . @ @ 
. . . @ . . . @ . . . . . . . . . @ . . . . . . . . . @ . @ @ . 
. . @ . . . . . . . @ . . . . . . . . . . . . . . @ @ . . @ @ . 
. . @ . @ . . . . . @ . . . @ @ . . . . . @ . . . . . . . @ . . 
. . @ . . . . . . . @ . . @ . . . . . @ . . . . . . . . . . . . 
@ . @ @ . @ . . . . . @ . . . . @ . . . . . . . . . . . . . @ . 
. . . . @ . . . . . . . . . . . @ . @ . . . . . . . . . . . . . 
. . . . . . . @ . . @ . . . @ @ . @ @ . . . . . @ @ . . . . . . 
. @ . . . . . . . . . . . . @ @ . . . . @ . . . . . . . . @ . . 
. . . . . @ . . . @ . . . . . . . . . . @ . . @ . . . . @ . . . 
. . . . . . @ . . . . . . . . @ . @ . . . . . . . . . . . . . . 
. . . . @ . . . . . . @ . . . . . @ . . . . . . @ @ . . . . . . 
. . . . . . . . . . . . . @ . . . . . . @ . . . . @ @ . . . . . 
. . . . . . . . @ @ . . @ @ . . . . . . . @ . . @ . @ . . . . . 
. . . . @ . @ . . @ . . . . . @ @ . @ . . . . . . . . . . @ . @ 
. . . . @ . . . . . . . . . . . @ @ . . . . @ . @ . . . . . @ @ 
@ . . . . . . . . . . . @ . @ . . . . . @ . . . . . . @ . . . . 
. . . . . @ . . . . . @ . . . . @ . @ . @ . . . . . . . . . . . 
. . @ . . . . . . . . . . . . . . @ @ @ . . . . @ . . . . . . . 
. @ . . . . . . @ . . . . . . . . . @ . . @ . @ . . @ . . . . @ 
. . @ . . . @ . . . . . . . @ . . @ . . . . . . . . . . . . . . 
. @ . . @ . . . . @ . . . . @ . . . @ . . . . . . . @ . @ . . . 
. . . . @ . . @ @ . . . @ . . @ . . . @ . @ . . . @ . @ . . . . 
@ . . . . @ . . . . . . @ . . . . . . @ @ . @ . . . . . . . . . 
. . @ . @ . . . . . . . @ @ . . . @ . . . . . . @ . . . @ @ . . 
@ . . . . . . . . . @ . . . @ @ . . . . @ . . . @ . . . . @ @ . 
. . . . . . . . . . . . . . . @ @ . . @ . . . @ . @ . . @ . . . 
. @ . . . . @ . . . . . . . . @ . . . . . . . . @ . . @ . @ . @ 
. @ . . . . @ . . @ @ . . @ @ . . . . @ @ . @ . @ . . . . . . . 
40
31 1 3 0
16 22 4 29
10 4 7 30
26 31 2 28
12 31 1 6
7 16 28 3
19 12 18 4
27 12 25 11
10 8 14 12
10 16 3 1
4 0 22 25
31 23 9 5
25 1 5 11
18 13 10 20
1 26 22 20
15 27 6 3
11 17 21 17
4 20 26 17
27 7 28 22
30 7 4 31
25 4 23 14
12 11 4 28
15 5 27 13
8 12 13 21
1 29 0 4
10 30 3 11
6 4 23 31
4 13 25 23
6 26 12 22
27 17 4 7
6 11 11 18
31 15 5 24
11 16 23 23
26 9 13 10
31 21 8 14
18 4 10 19
6 15 6 20
24 9 2 4
18 29 5 29
30 21 15 1
