32 32
. . . . . . . @ @ . . @ . . . . . . @ . . . . . . . . . . . @ . 
. . @ . @ . . . . . @ . . . @ . . @ . . . . . . . . . . . . @ @ 
. . @ . @ @ . @ . . . . . . . . . . . . . . . . . . . . . . . . 
. . . . @ . . @ . . . . . . . . . @ @ . . . . @ . . . . . . . . 
@ . . . @ @ . @ . . . . . . . . . . . . . @ . . . @ @ . . @ . . 
. @ . . . @ . @ . . . . @ . @ . . . . . . . . . @ . . . . . . . 
@ . . . . . . . @ @ @ . . . @ . . . . . @ . . . . . . . . @ . . 
. . . . . . . . @ @ . . @ @ . . @ . . @ . @ @ . . . . . . . . . 
. @ . . . . . . . . . . . . . . @ . @ . . . . @ . . @ @ . . . . 
@ . @ . . . . . . . . @ . . . . . . @ . . . . . . . . . . . . . 
@ @ . @ . @ @ @ . . . . . . . . @ . @ . . . . . . @ . . @ @ @ . 
. . . . . . . . . . @ . . . . . . . . . . . @ . . @ . . . . . . 
. @ @ . . . . . . . @ . . . . @ . . . . . . . . . . @ . . . . . 
. @ . . @ . . . . . . . @ . . . @ . @ . . . . . . . . . @ . . . 
. . . @ . @ . . . . . . . . . . @ . . @ @ . @ . . . . . . . . . 
. . . @ . . . . . . . . @ . . . . @ . @ . . . . @ . . @ . . . . 
. . @ @ @ . . . . . @ . . @ @ . . . . . . . . . . @ . . . . . . 
. . . @ @ @ . . . . @ @ . @ . @ @ . @ . . . @ . . . @ . . . . . 
. . . . @ . . @ . . . . . . . . . . @ . . . . . . . . @ . . @ . 
@ @ . . . . . . @ . . . . . . @ . . @ @ . . @ . . @ @ . . . . . 
. . . . @ . @ @ @ @ . . @ @ . . . . . . . @ . . . . @ @ . . . @ 
. . @ . . . . . . . . . . . . . . . . . @ . . . . @ . . . @ @ . 
. . . . . . . . . . . . . @ . . . . @ . . . . . . . @ . @ . . . 
. @ @ @ . . . @ @ . . . . . . . . . . . . @ @ . . . . . @ . . . 
. @ @ . @ . . . . . . . . . . . . . . . . . . . . . . . . . . . 
. . . . @ @ . . . . @ @ . . . . @ . @ . . @ . . . @ @ . @ @ . . 
. . @ . . . . . . . . . . @ . . . . @ . . . . @ . @ . . . . . . 
. . . . . @ . . . . @ . . . . . . . @ . @ . . . . . . . . . . . 
. . . . . . . . . . . @ . . @ . . @ . . . . . . . . @ . . . . . 
@ . . . . . @ . . . . . . @ . @ . . . . . . @ . . . . . . @ . . 
. . . . . @ @ . . . . . . . @ @ . . . . . @ . . . . . . . . . . 
. @ . . . . . . . . . @ . @ @ . . . . . . . . . . . . . @ @ @ @ 
40
21 13 5 11
26 30 17 24
17 26 0 7
2 28 16 4
22 24 20 22
22 4 27 13
13 27 19 3
23 0 29 14
1 29 1 2
22 9 30 23
26 27 30 24
8 16 1 3
14 10 4 12
29 24 31 26
16 21 2 8
8 31 26 6
25 7 12 29
6 17 29 1
13 9 15 24
24 9 4 7
17 31 8 27
26 2 15 13
15 6 31 22
9 1 22 30
0 31 27 1
27 13 10 28
7 30 3 24
20 25 6 25
10 2 9 12
31 5 12 31
27 27 12 8
0 2 15 11
22 26 24 31
24 18 24 10
19 3 13 4
25 2 23 18
19 11 9 1
9 27 10 14
7 29 15 2
2 0 22 4
