32 32
. . @ . . @ @ . . @ . . . . . @ . . @ . . . . . . . . . @ . . @ 
. . . . . . . . . . . @ . . . . . . . @ . . . @ . . . . . . . . 
. . . . . @ . . . . . @ . . . @ @ . @ . . @ @ . . . . . . . . . 
. . . . . @ . . . . . @ . @ . @ . @ . . . . . . . . . . . . . . 
. . . . . . . . . . . . . . . . . . . . . . . . @ @ . . . @ . . 
. @ . @ . . . . . . @ @ . . @ . . . . @ @ . . . @ . . . . . . . 
. @ @ . . . . @ . . . . @ . . . . . . . . . . . @ . @ @ . @ . @ 
@ . . . @ . @ . @ . @ . . . . . . . . . . . . . . . . @ . . . . 
. . . . . . . . . . . @ . . . . . . . . @ . . . @ . . . . @ . . 
. @ . . . . . . . . . . @ . . . . . . . . @ . @ @ . . . . . . . 
. @ @ @ . . @ . . . . . @ . . . . . . . . . . . . . . . . . @ . 
. . . . . . . @ . . . . @ . . . . . . . . @ . @ . . . @ . . . . 
@ . . . @ . . . . . @ . . . . . @ @ @ . @ . . . . . . . . . . . 
. . . . . . @ . . @ . . . . . . . . . @ . . . . . . . . . . . . 
. . . @ . . @ . . . . . . . . . @ . @ . . @ . . . @ . . . @ . . 
. . . . . . @ . . . . @ . . . . . @ . . @ @ . . . @ . @ . . . @ 
. . . . . . @ . . @ @ . . @ . . @ . . @ @ . . . @ . . @ @ . . . 
. @ . . @ . . . . . . . @ . @ . . . . . @ . . @ . . . . . . . @ 
@ . . . . . @ . . @ @ @ . . @ @ @ . @ . . @ . @ @ . . . @ . . . 
@ . @ . . . . @ . . . . . . . @ . . . @ @ . @ . . . @ @ . . . . 
. . . . . . @ . . @ . . @ @ . . @ . @ . . @ . . . . . . @ @ . . 
@ . @ . . @ . @ . . . . . . . . . . @ @ . . . . . @ . . . . . . 
. . . . . . . . . . . . . . . . . . . @ @ . . . . . . . . . . . 
@ . . . . @ @ . . . . . . . . . . . . . . . . . . @ @ @ . . . . 
. . @ . . @ . . . . . @ . @ @ @ . . . @ . . . @ @ . . . . . . . 
. . @ . @ . . . . . . . . . @ . . . . . . . . @ @ . . . . . . . 
. @ @ . @ . . . @ . . . . . @ . @ . . @ . . . . . . @ . . . . . 
. . . . @ . . @ @ . @ . . . . . . @ . . @ @ . . . . . . @ @ . . 
. . . @ . @ . . . . . . . @ . . . . . @ . . . . . . . . . @ . . 
. . . @ . . . . . . . . . . . . . . . . . @ . . . . . . . . . . 
@ . . . . . . . . . . @ . . . . . . . . @ @ . . . . . @ . . . . 
. . . . . . . . . @ . . . . . @ . . . . . @ . . . . . . . . . @ 
10
24 26 27 14
18 28 1 14
14 6 26 20
6 31 22 20
23 20 24 2
25 22 7 3
6 6 22 22
26 16 24 0
21 3 18 30
26 7 29 31
