32 32
. . . . @ . . . @ . . . . . . . @ . . . . . . . . . @ . . . @ . 
@ . . @ . . . . @ . . . . . . @ . . . . . . . . . . @ . . . . . 
. . . . . . . . . . . . . . . . . . @ . @ . . @ . . @ . . . . . 
. . @ . . . . . . @ . @ . . . . . . . @ . . @ . @ . @ @ @ @ @ . 
. . @ . . @ @ . . . . @ . . . . . @ . . . . . . . . . @ . . @ . 
@ . @ . . . @ . . . . . . . . . . . @ @ . . . . . . . . . . @ . 
. . . @ . . . . . . . . @ . . . @ @ @ @ . . . . . @ . . . . @ . 
. . . @ . . . . . . . @ . . . . . . . . . . . . @ . . . @ @ . . 
. . . @ . . . @ @ . . . . . . . . . . @ . . . . @ @ . . . . . . 
. . . . @ . . . @ . . . . @ . . . . . . . . . . . . . @ . . . . 
. . . . . . @ . . . @ . . . . . @ . . @ @ . . @ . @ . . . . . . 
. . . . . . @ . . @ . . . . . . . @ . @ @ . @ . @ @ . . . @ @ @ 
. . . . . . . . . . . . . . @ @ . . . @ . @ . . . . . . . . . . 
@ . . . . . . @ . . . . . @ . . . . . . . . . . . . . . . . . . 
@ @ . . @ . . . @ @ . @ . . @ . . @ . . . @ @ . . . . . . . @ . 
. . @ . . . @ . . . . . . . @ . . @ . . . . @ . . . . . . . . @ 
. @ . . @ . . . . @ . . . . . . . . @ . . @ . . @ . . . @ . . . 
. . . @ . . . . . . . . . @ @ . . @ . . . . . . @ @ . . . . . @ 
. . @ . . . @ . . . . . . @ . . @ . . . . @ @ . . @ . . . @ . . 
. . . . . . . . . . . . . . . . . . . . . . . . . . @ . . . @ . 
. . . . . . . . @ . . @ . . . . @ @ . @ . . . . . . . . . . . @ 
. . . @ . . . . . . @ . . . . . . . . . @ . . @ . . . . . @ @ . 
. @ . @ @ @ . . . . @ . @ . @ . . . @ . . . . . . . @ . . @ @ . 
. . @ . . . . . @ . . . . @ . . . . @ . . . . . . . . . . . @ . 
. . . @ @ . @ . @ @ @ @ . @ . @ . . . . @ . . . . . . . @ @ . @ 
. . . . . . . . . . . . . . . . . . . . . . . . . @ . . . . . . 
. . @ . @ . . . @ . . @ . . . . . . . . . @ . . @ . . . . . . . 
. . . . . . . . . @ . . . @ . . @ . . . . . . . . . . . . @ . . 
. . . @ . @ @ . . . . . . @ . . @ . @ . . . . . . @ @ . . . . @ 
. . . . . . . . @ . . @ . . . . . . . . . . . . . @ . . . . . . 
. @ . . . . . . @ . @ @ . . . . . . . . . . . @ . . . . @ @ . . 
. . . . @ . . @ @ . . . . @ . . . . . . . . . . . . . @ . . . @ 
60
28 9 9 18
0 28 0 8
0 25 10 8
31 5 7 21
19 30 1 19
1 25 19 28
9 18 16 5
13 15 31 12
9 9 21 30
1 5 14 26
19 28 26 14
23 4 15 6
11 23 0 10
21 21 5 8
17 18 15 19
12 31 20 3
4 2 20 22
26 15 8 16
19 27 25 26
5 29 30 28
21 25 11 13
10 9 29 4
6 6 22 1
0 6 22 22
20 15 25 12
24 1 22 7
14 26 6 30
13 10 7 26
3 29 18 27
19 1 23 4
28 0 6 25
18 10 24 15
7 20 15 8
26 7 20 19
29 12 21 19
30 31 2 10
24 14 12 31
15 13 4 2
2 24 31 30
14 13 21 28
30 27 29 14
12 18 14 5
12 26 26 6
27 28 21 31
23 9 30 2
18 4 27 20
16 15 17 26
22 5 1 4
28 10 13 10
29 14 0 19
8 18 24 1
7 10 28 4
24 12 0 28
10 7 18 9
20 12 14 29
24 18 31 13
3 30 28 31
26 23 1 7
19 2 1 8
17 0 29 23
