32 32
. . . @ . . . . . . . . . . . . . . . . . . . . . . . . . . . . 
@ . . @ @ . @ . . @ . @ . . . . . . @ . . . . . . . @ . . . . . 
@ . @ @ . . . . @ @ @ . . . . . @ . . . . . @ . . . . . @ . . . 
. . . . @ . . . . . . . . . . . . . . @ . . @ . . . . @ @ . . . 
@ . . . . . . . . . @ . . @ . @ @ . . . . . . . . . . . . @ . . 
@ . @ . . . . @ . . . . . . . . @ . . @ . . . . . . @ . . . . . 
. @ . . . . . . @ . @ . . . . . . . @ . @ @ @ . @ @ . . . @ @ . 
. . . . . . . . @ . . . . . . . . . . . . . @ . . @ . @ . @ . . 
. @ . . . @ . . @ . . . . . . . . . . . . . @ . . @ . . @ . . . 
@ . @ . . . . @ . @ . . . . @ . . @ . @ @ @ . . . . . . . @ . . 
. . . @ . . @ . . @ . . . . . . @ . . . . . @ . . . . @ . . . . 
@ . . . . @ . . . . . . . . @ . @ . . . . @ . . . . . @ @ . . . 
. @ . . . . . . @ . . . @ . . . . @ . . . . . . . . . . . @ . . 
. @ . . . . . . @ . @ . . . @ @ . @ @ @ . . . . . . @ . . . . . 
. . . @ @ . @ @ . . . . . . . . . . @ . . . @ . . . . . . . . . 
. . . @ @ @ . . . . . . . . @ @ @ . . . . @ . . . . . . . @ . . 
@ . @ . . . . . . . . . . @ . . . . . . @ . . . . . . . @ . . . 
. . . . . . . . . . . . @ . . @ . . @ @ @ . @ @ . . @ @ . @ . @ 
. . . . . @ . . . . . @ . . . . . @ . . . . . . . . . . . @ . . 
. . . @ . @ . . . @ . . . @ @ . @ . . . . . . . . . . @ . . @ . 
@ . . @ . @ . . . . . . @ . . . @ @ . . . . . . . @ . . . . . . 
. . . . . . . @ . . . . . . . . . . . . . . . . . . . . . . . . 
. . . . @ . . . . . @ . . . . . . . @ . . . . . . . . . . . . . 
. . . @ . . . . . . . @ . @ @ . . . @ . . . . @ . . . @ . @ . . 
. . . . . . . . @ . . . @ . . . . . . . . . . @ . . . . @ . . . 
. . . . . . . . @ . . @ @ @ . . . . . . @ . . . @ . @ @ . @ . . 
. . . . @ . . . . . @ . . . . @ . @ . . @ . . . @ . @ . . . @ . 
. @ . . @ . . . . . . . . . . . @ . . . . @ . . . . . . . . . . 
@ . . . . . . . . . @ . @ . . @ . . . . @ @ . . . . . . . . . . 
@ . . . . @ . . @ @ . . @ . . . . @ . . @ . . . . . . . . . . @ 
. . . . @ . @ . . . . @ . . . . . . . . . . . . . @ . . . . @ @ 
. @ . . . @ . . . . . @ . . . . . . . . . . . . . . @ . . . . . 
50
9 4 9 12
20 18 9 21
9 31 20 21
30 11 0 21
9 18 3 17
10 25 8 16
23 16 17 28
7 26 7 10
6 23 17 21
10 7 5 0
4 5 27 20
5 9 21 0
2 23 25 17
11 3 16 22
28 31 15 2
24 21 31 25
17 10 31 28
6 26 28 10
9 14 4 25
28 17 16 14
13 29 3 13
24 19 5 7
6 17 5 14
13 12 25 18
16 24 23 14
27 21 0 23
6 3 2 23
26 27 11 6
30 12 19 26
18 27 30 18
18 28 3 29
8 18 20 18
28 15 28 1
25 12 20 2
17 17 30 14
11 9 28 6
27 22 24 13
25 23 2 28
29 26 19 30
14 10 9 4
20 7 6 25
4 20 27 1
25 16 6 6
30 28 26 6
12 5 9 0
5 2 4 18
21 19 4 12
14 27 31 10
19 15 24 10
3 9 24 18
