32 32
. . @ . . . . . . . @ . . . . . . @ . . . . . . . . . . . . . . 
. . . . . . . @ . . @ . . . . . . . . . . @ . . . . . . . . . . 
@ . . @ . . . @ . . . . @ @ . . . . . . . . . . . . . . . @ . . 
. @ . . . @ . . . @ . @ . . . . . . . . . @ . . . . . @ . . . @ 
@ @ . . . . . @ . . @ . . . . @ . . . . . . . . @ . @ . . @ . . 
. . . . . @ @ . . . . . . . . . @ . . . . . . . . @ . @ @ @ @ . 
. . . . . @ @ . . . @ . . @ . . . . . @ . . . @ @ . . @ . . @ . 
. @ . . . . . . @ . . . . . . . . @ . . . @ . . . . . @ . . . @ 
@ . . . . . . . @ . . . @ . . @ . . . . . . . . @ . . . @ . . . 
. . . . . . . . . . . . . . . . . @ . . . . . . . . . . @ @ @ @ 
. . . @ @ . @ . . @ . . . . . @ . . @ . @ . . . @ . . . . @ . . 
. . . @ . . . @ @ . . . @ . . . @ . @ . . . . . . . . . . . . . 
. . . . . . . . . . . . . . . . @ . . . . . . . . . . @ . . . . 
. . . . . . . . . . @ . . @ . . . . . . . @ . @ . . . . . . . . 
. . . . . . @ . . . @ @ . . . . @ . @ @ . . @ . . . @ @ . . . . 
. . . @ . . . @ . . . @ . . . . . . . . . @ . . . @ . . @ . @ . 
. . . . . . . . . . . . @ . . @ @ . . . . . . . @ . @ . . . . @ 
@ . . @ @ . . . . @ . . . . . . @ . . . . . . . . . . . @ . . . 
@ . . @ . . @ . . @ . . . @ @ . . . @ . . . @ . . . . . . . . . 
. . . . . . . . . . . . . . . . . . @ . . . . . . . . . . . . @ 
. @ @ . . . . . . . @ . . . @ . . @ . . . . . . . . @ . . . . . 
@ @ @ . . . . . . @ . @ @ @ . . @ . . . . . @ @ . . . . @ @ . . 
. . . . . @ . . . . . . . . @ . . . . . . . . . . @ . @ . . . @ 
. @ . . . . . @ . . . . . . @ . . . . @ @ @ . @ @ . . . . . . . 
. . . . . . . . . . . . . . . . . @ . . . @ . @ . @ . . . @ . @ 
. @ @ . . . @ . . @ . . @ . . . @ . . . . @ . . . . . . . @ @ . 
. . . @ . . . . . . . . . . . . . @ . @ @ . . . @ . . . @ @ . . 
@ . @ . @ . . . . . . . . . . . . . . . . . . . . . . @ . . . @ 
. . . @ . . . . @ . @ . @ . @ . @ . @ . . @ . @ . . @ . . . . @ 
. . . @ . @ @ . . . . . @ . . . @ . . . . . @ . . . . . . . . . 
. . . . . . . @ . . . . . @ . . @ . . . . . @ . . . . . . . . . 
@ @ . . . . . . . @ . . . @ . . . . . . . . . @ . . . . . . . . 
30
8 5 20 25
27 17 2 9
24 31 12 22
23 1 30 23
24 27 19 11
23 17 4 24
21 18 22 12
9 23 21 0
19 17 29 12
6 13 8 2
12 10 11 1
9 16 17 19
10 19 22 1
2 10 22 11
1 0 17 22
28 18 19 20
2 31 18 5
12 19 23 12
13 23 27 4
12 15 6 13
26 2 10 24
9 6 6 21
26 23 6 17
25 10 20 18
22 27 4 1
8 15 2 8
6 19 18 17
19 4 14 12
5 14 9 4
20 28 20 22
