32 32
. . @ . . . . . @ . . . . @ @ . @ . . . . @ . @ @ . . . . . . . 
. . . . . . . . . . @ @ . . . . . . . . @ . . . . . . @ . @ . @ 
@ . . . . . . . . . . . . . @ @ . @ @ . . . . . . . @ . . . . . 
. @ @ . . @ . . . . . . @ @ . . @ . . . . . . . . . . . . . . . 
. . . @ . . @ . @ . @ . . . . . . . . @ . . . . . . . . . . . @ 
. @ . . . . . . . @ . . . @ . . . @ @ . . . . . . @ @ . @ @ @ . 
@ . . . . . . . . . . . . . . @ . . @ @ @ @ . . . . . . . . . . 
. . @ @ . . . @ . . . . . @ . . . . . . @ . . . . . . . . . . @ 
@ @ @ . . @ . . . @ . . . . @ @ . . @ . . . . . . . . . . . . . 
@ . . . . . . . . . @ . @ . @ . . . @ . . . . . @ . . . . . @ @ 
. . . @ . . . . . . . . . @ . . @ . . . . @ . @ . . . @ . . . . 
. . . . . . . . . . . . . . @ @ . . . @ @ @ . . . . . . @ . @ . 
. . . . . . @ . . . . . . @ @ . @ @ @ . . . . . . . . . . @ . . 
. . . . . . . @ . . . . @ . . @ . . . . . . @ . . . @ . . @ . . 
. . . . @ . @ . . . . . . . . . . . . @ . . . . . . . @ . . . . 
@ . . . . @ @ . . @ @ . . @ . . . . @ @ . . @ . . . @ . @ . . . 
. . . . . @ . . @ . . . . . @ @ . . . . . . @ @ . . . . . . . . 
. @ . . . . . . . . . @ @ . . @ . . . . @ . . . @ . . . @ . . . 
. . . . . . . . . . . . . . . . @ . . . . . . . . . @ . @ . . . 
@ . . . . . . @ @ . . . . . . @ . . . . . @ . . @ . @ @ @ . . . 
. . . . . . . @ @ @ . @ . @ . . @ . . . . . . . @ . . @ . . . . 
. . . . . . . . . @ . . . . . @ . @ . . . . . . . . @ . . . . @ 
. @ . . . . . . . . . @ . . . . . . . . . . @ @ . . . . . . . . 
. . . @ . . @ @ . @ . . @ . . . . . . @ . . . . . . . . @ . . . 
@ . . @ @ @ . . . . . . @ . @ . . . . . . . . . . . @ . @ . . . 
. . @ . . @ . @ . . . . . . . . . . . @ . . . . @ . . . . . . . 
. . . . @ . . . . . . . @ . . . . . . . @ . . . . . . . @ @ . . 
. . . . . . . . . . @ . . . @ . . . . . . . . . . . . . . . . . 
. . . @ . . @ . @ @ . . . . . . . . . . . . . . @ . . . . . . . 
. @ . . . . . @ . . . . . . . . . . @ . . @ @ . . @ @ . . . @ . 
. . . . . . . @ . @ . @ . . . . @ . . . . . . . @ @ . . . . . . 
. @ @ @ . @ . . . . . . . . . . . . . . . . . . . . . . . @ . . 
20
31 28 9 0
29 20 22 2
5 10 6 24
18 28 12 31
4 19 14 3
31 2 8 25
11 23 12 6
23 20 8 10
0 25 25 25
24 31 25 2
26 26 28 31
13 26 19 13
13 21 6 22
12 6 27 11
24 14 20 21
11 26 27 13
1 0 29 24
31 27 10 20
20 20 10 24
12 8 6 8
