32 32
. . . . . . . . . @ . @ . @ @ . . . @ . . . @ . . . . . . . . . 
. . @ . . . . . . . . . . . . . . . . @ . . . @ @ . . . . @ . . 
. . @ . . . . . . . . . . . . . . . . . . . . . . . . . . . @ . 
@ . @ . . . . . . . . . . . . . . . . @ . . . . . . @ . . . @ @ 
. . . . . . @ . . . . . @ . . . . . . . @ . . . . . . . . . @ . 
. @ . . . . . . . . . . . @ @ . . . . . . @ @ . . . . . . @ . . 
@ @ . . . . . . . . @ @ . . . . . . @ . . @ . . @ . . . . . . . 
. . . . . . . @ . @ @ . . . . . . . . @ . . @ . @ . . . . @ . @ 
@ . . . @ . . . . . . . . . . . . @ @ . @ . @ . @ . . @ . . . . 
@ . . . . @ . . @ @ . @ . . @ . . . . . . . . @ . . . . @ . . . 
@ @ . . @ . @ . . . . . @ . . @ . . . . . . . . @ . @ . . . . . 
. . . . . @ . . . . . . . . . . . . @ . @ . . @ . . . . . @ @ . 
. @ . @ @ @ . . . . . . @ . . @ @ . @ @ . . . . . . . . . . . . 
. . . . . . . @ . . . . . . . . . . @ . . @ . . . . . . . . . @ 
@ . . . @ . . . . . . . @ . . . . . @ . . . . . . @ . . . . . . 
. . @ . . . . . . . @ @ . . . . . . . . . . . . . @ . . . @ . . 
. . . @ @ . . @ . . . @ @ . @ @ . . . . . @ @ @ . . . @ . . . @ 
@ . . . . . . . . . . . @ . . . . . . @ . . . . @ . . @ . @ . . 
@ . . . . . . @ . . . . . . . @ . . @ . . . . . . . . . . . @ . 
. @ . @ . . . . . . . . . . . . . @ . @ . . . . @ . . . . . . @ 
. . @ . . @ . . . . . . . . . . . . . @ @ . . . . . . . . . @ . 
. . @ . . . . @ . . . . @ . . . . . @ . . . . . . . . . @ . @ . 
. . . . . . . @ . @ . . . . . . . . . . @ . . . @ . @ . @ . . @ 
. . . . . @ . . . . . @ @ . . . . . @ . . . . . . . . . . . @ . 
. @ . . . @ . . . @ . . . . . . @ . @ . @ . . . @ . @ . . @ . . 
. . . . . . . @ . . . @ . . . . . . . . . . . . . . . . @ @ . @ 
. . . . @ . . . @ . . . . @ . . . @ @ @ . . @ . . . . . . . . @ 
. . . . . . . . . . . @ . . . . @ . . . . . @ . . @ @ . @ . . @ 
@ . . . . . . . . . . @ @ @ . . . . . . . @ . @ @ . . . . @ . . 
@ . . . . . . . . . @ . . . . . @ . . . . . . . . . @ . . . . . 
. . . @ . . @ . . @ . . . @ . . . @ @ @ @ . . . . @ . . . . . . 
. . . . . . . . . . @ . . @ . . . . . . . . . . @ . @ . . . @ . 
90
16 16 11 24
12 29 9 2
16 2 27 31
8 22 2 14
31 12 26 5
2 0 23 15
16 8 17 6
5 5 3 13
11 4 25 25
18 29 27 14
17 12 4 25
21 25 22 10
9 28 6 15
25 26 26 28
22 20 0 23
11 3 25 2
14 8 27 7
26 8 19 16
1 16 14 1
0 7 7 9
6 6 19 13
30 25 19 14
21 22 20 28
21 10 22 20
3 18 13 21
7 1 11 10
8 16 1 4
21 29 11 26
0 1 5 18
9 23 6 14
19 4 30 12
2 16 7 19
2 31 23 12
8 18 17 31
28 18 27 21
3 7 11 3
23 17 17 18
5 1 23 5
10 1 3 2
8 25 26 25
8 3 16 9
30 6 24 14
6 2 15 28
12 31 12 0
16 22 14 15
0 12 1 25
27 5 1 8
25 6 21 10
15 31 27 1
18 2 21 7
27 9 28 10
24 26 12 25
6 9 5 28
5 19 16 21
4 18 1 0
1 25 22 24
12 26 2 31
23 24 9 13
27 11 28 16
21 17 8 27
28 24 8 29
30 12 1 2
28 0 8 12
10 17 29 21
17 18 15 25
28 17 28 11
23 25 20 31
10 5 11 17
17 15 23 4
14 1 17 12
28 28 22 4
17 9 9 27
6 3 22 25
28 11 1 23
3 9 27 19
7 23 29 3
3 17 9 16
5 14 0 5
14 25 15 0
13 8 25 20
6 7 15 3
8 0 1 3
8 1 12 27
4 17 25 1
8 12 9 25
10 23 30 19
19 6 14 11
19 14 6 27
11 17 15 27
17 10 22 12
