32 32
. . . . . . @ @ . . . . @ . . . . @ . . . . . @ . . @ . . . @ . 
. . . . . . . @ @ . . . . . . . . . . . . . . . . . . . . @ . . 
. . @ . . @ . . . . . @ . @ . @ @ . . . . . . @ @ @ . . . . @ @ 
. . . @ . . @ . . @ . @ . . . . . . . . . . . . . . . @ . @ . . 
. . . . . @ . . . . @ . . @ @ . . . . . . . . . . . . . . . . . 
. . . . . @ @ . . @ @ . @ . . @ . . . . . @ @ . . . . . . . . . 
. . . . . . . . . . . . . . @ . . . . @ . @ . . . . . . . . @ @ 
. . . . . @ . . . . . . . . . . . . . . . . . . . . @ . . . . @ 
@ . . . . . . . . . @ @ . . . . . . @ . . @ . . . . . @ . @ @ . 
. . @ . . . . . . @ . . . . . . . . . . . . . . . . . . . @ . . 
@ @ . . . . . . . . . . . . @ . @ . . . @ . @ . . . @ . . . . . 
. @ @ @ . . . . @ . . . . @ . @ . . @ @ . . . . . . . . . . . . 
. . . . . . . @ . . . . . . . . @ . @ . . . . @ @ @ . . @ @ @ @ 
. . . . @ . . . . . . . . . @ . . . . @ . . . @ . . . . . @ @ @ 
. . . @ . . @ . @ . . . . . . . @ @ @ @ . . . . @ . . . . . @ . 
. . . . . . . . . @ . . . . . . . . . . @ @ . . . @ . @ @ . @ . 
. . . @ . . @ . . . . . @ . . . @ @ @ . . @ . . . . @ . . @ . @ 
. . . . . . . . . . @ @ . @ . . . . @ . . . . . . . . . . . . @ 
. . . . @ . . @ . . . @ . . . . . @ . @ . . . . . @ . . . @ . . 
. . . . . . . . . . @ . . . . . . . @ . . @ @ . . . . . . . . . 
. @ . . . . . . . . . . @ @ . @ . . . . @ . . . @ @ . @ @ . . . 
. . . . . . . . . . . . . . . . . @ . . . @ . . . . . . . . . . 
@ . . . . . . . @ . . . @ . . . . @ . . . . . @ . . @ @ . @ . @ 
. . . . @ . . @ . . . . . . . . . . . . @ . . . . . . @ . . . @ 
. . . . . . . . . . . . . @ . . . . . @ @ . . . . . . . @ . . . 
. . . . . . . . . . . @ . . . . . . . . . . @ . @ . . . . . . . 
. . . . . . . . . @ . . . @ . @ . @ . @ . . . . . . . . . . . @ 
. . . @ . @ . @ . . . . . . . . . . @ . @ . . . . @ . . @ . . @ 
. . @ @ . @ . @ . . . . . @ @ . . . . . @ . . . . . . . . . . . 
. . . . . . @ . . . @ @ @ . . @ . . @ . . . . . . . @ . @ . . . 
. . . @ . . . @ . . @ . @ . @ . . . . @ . . . . . . . . @ @ . . 
. . . . . . . . . @ . . . . @ . . . . . . . . . . . . . . @ . . 
50
10 15 25 10
24 4 30 19
18 22 7 25
1 28 5 9
9 12 6 8
17 5 27 27
2 22 27 16
18 26 21 2
10 7 17 13
26 14 0 13
3 18 16 27
23 4 16 5
28 8 7 31
11 15 24 7
23 8 3 31
16 23 10 28
29 17 16 13
8 10 1 23
7 2 2 24
25 29 24 9
27 16 4 31
12 28 8 0
24 8 23 27
23 18 12 17
9 25 10 12
16 15 26 19
22 14 28 2
4 17 6 17
2 7 16 25
7 16 8 7
9 28 23 7
1 16 27 30
20 3 4 6
17 4 11 9
6 15 21 23
11 28 16 8
13 8 18 6
31 3 11 19
9 23 30 5
26 17 29 26
28 17 0 7
3 10 3 22
23 27 18 21
15 17 14 16
21 31 29 24
22 24 28 17
10 21 1 6
3 5 5 22
7 7 12 7
16 5 30 16
