32 32
@ . . . . . @ . . . . . . . . . . @ . @ . @ . . . . . . @ . . . 
. . . . . . . . . . . @ . @ . @ . . . . @ @ @ @ . @ . . . . . @ 
. . @ . . . . . . . . . . @ . . . . . @ . . . . @ @ . @ . . . @ 
. . . . . . . . @ . . . @ . . @ . . . . . . . . @ . . . . . . . 
. . . . @ . . . . . . @ . . . . . . . . @ . . . . . @ . @ @ @ @ 
. . . . . . @ . . . . . . . @ . . . . . . . . @ . . . @ . @ . . 
@ . . . . @ . . @ . @ @ @ . . . . . . . . @ . . . @ @ . . @ . . 
. . . . @ . . @ . . . . . . @ @ . . . . @ . . . . . . . @ . @ . 
. . . @ . . . @ . . @ . @ . @ . @ . @ . . . . . . . . @ @ . . @ 
@ . @ @ . . . . . . . @ @ . . . . . @ . . @ . . @ . . @ . . . . 
. . . . . . . @ . @ @ . . . . . . . . . @ . . @ @ @ . . . . . . 
. . . . @ . . @ . . @ . . . . . @ . . @ @ . . . . . . @ . . . . 
. . . . . . . . . . @ @ . . . . . . . . @ . . . . . . @ . . . . 
. . . . . . . . . . . . . . . . @ . . . @ . @ . . . @ @ . . . . 
. . . . . . . . . . . . . @ . @ . . . . . . . . @ . . . . . . . 
. . @ . . . @ @ . . . . . . @ . . . . . . . . . . @ @ . . . . . 
. . . . @ . . @ . . . . . . . . . . . @ . . . @ . @ . . . @ . . 
. . @ . . . . . . . . . . . . . . . . . @ . . . @ . . . @ . . @ 
. @ . . @ . . . . . @ @ . . @ . @ . . . . . . . . @ @ . . @ . @ 
. @ . . . @ . . . @ . . . . . . . . @ . . . . . . @ @ . . . . @ 
. . . . . . . @ . . @ . . . . . . . . @ . . . . . . . . . . . . 
@ . . . . @ . @ . . . . . @ @ . . . @ . . . @ . . . . . . . . . 
@ @ . . . . @ . . . . . . . . . @ @ @ . . . . @ @ . . . @ . . . 
. . @ . . . @ . @ . . . . . @ @ . @ @ . . @ . . . . . . @ @ . . 
@ . . . . . . . . . . . . . @ . . @ . . . . . . . . . @ @ . . . 
. . @ . . @ . . . @ . . . . . . . . . . @ . . . @ . . . . . . . 
. . . @ @ . . . . . @ . . . . @ . . . . . . . . . . . @ . @ . @ 
. . @ . . . . . . . . . @ @ . . . . . . . . @ . . . @ . . . . . 
. . . . @ . . . . . . . . . . . . . . . @ . @ . . . . . @ . . . 
. @ . . . . . . . . . @ . . . . . . . . . . . . . . . . . @ . . 
. . . @ . . . . @ . . @ . . . . . . . . . . . . . . . . . . . . 
@ . . . . . @ . . . . @ . . . . @ . . @ . . . . . . @ . @ . @ . 
20
7 31 26 7
15 4 26 25
0 23 17 9
21 17 18 3
11 21 10 1
12 11 3 18
8 11 10 24
17 6 4 8
30 27 21 16
11 24 19 26
5 31 18 6
10 25 24 27
22 19 26 28
3 22 12 19
22 17 1 4
20 22 28 25
13 20 0 5
5 14 6 30
6 4 27 18
2 3 29 19
