32 32
. . @ @ . . @ . . . . @ . . . . @ . . . @ . . @ . @ . . @ @ . . 
@ @ . . @ . . . . . . . . . . . . @ @ . . . . . . @ . . @ . @ . 
. . . . . . . . . @ . . . . . . @ . . @ . . . @ . . . . . . . . 
. . . . . . . . . @ . . . @ @ @ . . . . @ . . . @ . . . @ . . @ 
. . . . @ @ . . . . @ @ . . . . @ . . @ . . . . . . @ . . . . @ 
. . . . @ . @ . . . . . . . @ . @ . @ . . @ . . @ . @ . . @ @ . 
. . . . @ . . @ . . . . @ . . . . @ @ @ . . . . . . . . . . . . 
. . . @ . . . . @ . . . . . . @ . . . . . . @ @ @ . @ . @ @ . . 
@ . @ @ . . @ . . @ . . . . @ @ @ . @ @ . . @ . @ . @ . . @ . . 
. . . . @ . . . . . @ . @ . @ . . . . @ . . @ . . . @ . . . @ . 
. . . @ . . . . . . . . . . . . @ . . . @ @ . @ . . . . . . @ . 
. . . . . . . . . . . . . . . . . . . @ @ . . @ . @ . . @ . . . 
@ . @ . . . . . @ . . . @ . . . . @ . @ . . . @ . . . . . . . . 
. . @ @ @ . . . @ @ . . . . . . . . . @ @ . . . . . @ . . . . . 
. @ . . . @ . . . . . . . . . . . . . . . . . . . . @ @ . . . . 
. . . . . @ @ . @ . . . . . @ . . . . . . . . . . . . . . . . . 
. . . @ . . . . . @ . . . . . . . . . . . . . . . . @ @ . . . . 
@ @ . . . . @ @ . . @ . . @ . . . . . . . . . . . . . . . @ . . 
. . . . @ . @ . . . . . . @ . . . . . . @ . . . . . . . . . @ . 
. @ @ . . . . . @ . . . . . @ . . . . . . . . . . @ . . . . . . 
. . @ . . @ @ . . . @ . . @ @ . . . . . . . . . . . . . . . . . 
. . . @ . . . . . . . . . . . @ . . . . . . . . . . . . . . . . 
. . . . . . . . . . . @ . . . . . . @ @ @ . . . . . . . . . . @ 
. . . . . . @ . . . . . . . . . . . . . . @ @ . . . @ . . . . . 
. . @ . . . @ @ . . @ . @ . . . . . . . @ . . . . . . . . . . . 
. . . . . . . . . @ . . . . . . . . @ . . . . . . . . . . @ . @ 
. @ . . . @ . . . . . @ . . . . . @ @ . . . . . . . @ . . . . . 
. . . . @ @ . . @ @ @ . . . . . . . . . . . . . . @ . . . @ . . 
@ . . . . . . @ . . . . . . . . . . @ . . . . @ . . . @ . @ . . 
. . . @ . @ . . . . . @ @ . . . @ . . @ . . . . . . . . . @ . . 
. . . . . . . . . . . . @ . . . @ . . . . @ . . . @ @ . . . . . 
. @ @ . . . @ . . . . @ @ . . @ . . . . . . . . . . . . . . . . 
60
30 20 29 21
19 23 4 28
7 18 20 31
14 29 22 12
6 10 7 0
2 23 23 23
11 17 2 29
21 29 29 13
21 31 4 24
3 4 28 23
27 19 3 3
5 30 29 23
31 6 2 7
3 31 10 11
30 22 17 0
29 18 22 2
2 26 1 10
31 11 19 15
18 14 30 14
11 7 19 18
24 23 7 7
17 27 0 7
31 0 15 13
4 23 24 1
30 25 25 28
21 15 19 31
21 21 21 8
9 7 24 10
27 2 7 29
4 17 22 22
28 8 2 15
22 1 8 21
25 5 10 23
25 13 29 26
20 20 8 24
5 7 26 25
15 16 31 12
5 23 8 28
3 11 10 0
13 2 14 11
27 21 3 14
4 26 3 15
23 31 12 28
28 31 18 12
26 2 30 7
11 21 13 21
12 1 28 6
21 13 25 7
8 25 1 24
26 10 21 0
17 17 10 29
13 24 3 5
2 29 8 14
9 24 24 29
24 10 29 15
17 13 25 14
3 17 25 23
9 26 2 17
26 0 28 24
8 20 31 17
