32 32
. . . @ @ . . . . @ @ . . . . . . . . . @ @ . . . @ @ @ . . . . 
. @ . @ . . . . . @ . @ . . . . . . @ . . . . . . . . . . . . @ 
. . . . . . . . . . . . @ . . . . . @ @ @ . . @ . . . . . . @ . 
. . . @ . @ . . @ @ @ . . . @ . . @ @ @ @ . @ @ . @ . . . . . . 
@ @ . . . . . . @ . . . @ . @ @ . @ @ . . . . . . . @ . . . . . 
. . @ . . . . @ . . . @ . . . . . . @ . . . . @ . . @ @ @ . . . 
. . . . . . . . . . . @ . . . . . . . . @ @ . . . @ . . . . . . 
. @ . . . . . . . @ . . @ . . . . . @ . @ . @ @ . . . . . . . . 
@ . @ . . . . . . . . . . . @ @ . . . . . . . . . . @ @ . @ . @ 
. . . . . . . @ @ @ @ . . . . . . . . . . . . . . . . . @ @ . . 
@ @ . . . . . . . . . . . . . . . . . @ . . @ . . . . . @ . . . 
. . . . . . . . . . . . . . . @ . . . . . . . . . . @ . @ @ . . 
. . . . . @ @ @ . . . . . . @ . . @ . @ . . @ . @ . @ . @ . . @ 
. . . . . . . . . . . . . . . @ . . . . . . . . . . . . @ . . . 
. . . . . . . . . . . . @ . . @ @ . . . . . . . . . . @ . . . . 
. . . . . . . . @ . . . . . . . . @ . . . @ . . . . @ . @ . . . 
. . . . . . @ . @ @ @ @ . @ @ . . @ . . . . . . . . @ @ . . . . 
. @ . @ . . . @ . . @ . . . . . . . . . . . . @ . @ . @ . . . . 
. . . . . . . . @ . @ . . . @ . . . . . . . . . . . . . . . . . 
. @ @ . . . . @ . @ . @ . . . @ @ . . . . @ . . . . . . . . . @ 
. . . @ . . . @ . . . . . @ . . . . . . . @ . . . . . @ . . . . 
. . . . . . . @ . . @ . . . @ . . . . . . . . . . . . . @ . . . 
. . . . . . . @ @ . . @ . . . . . . @ . . . . . @ . . . . @ . . 
@ . @ . . . . . . . . . . . @ @ . . . . . @ . . @ @ @ @ . . . @ 
@ . @ . . . . . . . . . . @ @ @ . . . . . @ . . . . . @ . . . . 
. . . . . . . @ . . @ . . . . . . . . . @ @ . . @ . . @ . . . . 
. . . . . . . . @ . . . . . . . . . . . . . @ . . . . . . . @ @ 
. . . . . . . . . . . . @ . @ . . . . . . . . . . . . . . @ . . 
. . . . @ . . . . . . @ . . . . . . . @ @ . . . . . @ . . @ . @ 
. . . . . . . . . . . . @ . . . . . . . . . @ . . . . . . @ @ . 
. . . @ . . . . . @ @ @ . . . @ . . . @ . . . . . . . . . @ . . 
. . . . @ . . . . . @ . @ @ . . . . . . @ . . . . . . . . . . . 
70
2 13 15 28
6 25 28 1
27 2 23 1
4 1 9 5
6 22 25 1
4 9 29 6
11 7 27 11
1 11 13 4
5 24 4 27
8 21 4 1
24 4 3 23
4 17 14 26
2 18 31 30
21 29 28 6
19 27 5 25
13 27 31 10
15 9 8 27
26 10 13 26
11 3 14 20
8 5 26 18
21 17 25 19
10 13 27 12
28 20 23 30
8 24 11 15
30 8 29 0
22 22 11 8
22 15 3 21
3 15 24 24
0 25 31 5
1 29 24 7
9 26 8 6
10 1 17 29
8 10 23 8
4 13 15 0
18 15 6 21
29 14 12 0
28 2 15 3
11 10 11 20
4 10 12 28
17 28 16 23
26 26 15 29
31 5 17 28
13 8 2 9
13 15 1 31
9 11 6 18
29 16 6 19
13 1 2 4
25 30 3 16
5 7 31 25
1 28 10 4
12 18 25 16
3 8 25 21
15 6 26 9
2 15 23 28
14 22 10 22
20 9 17 31
7 30 18 31
1 27 16 5
2 12 15 16
14 25 21 18
22 31 7 16
25 26 22 30
1 8 2 13
4 29 13 8
26 17 5 9
14 26 14 5
13 14 1 21
4 5 25 13
1 15 19 20
10 24 8 8
