32 32
@ . . . . . . . . . . . . . @ @ @ . @ . . . . . . . . . . . . . 
. . . . @ . . @ @ . . . . @ . . . . @ . @ . . . . . @ @ . . . . 
. . @ . . . @ @ . @ . . . . . @ . . . @ . . . . . . @ @ . . . . 
. @ @ . . . . . . @ @ . . . . . . . . . . @ @ . @ . . @ @ . . . 
. . . . . . . . . . . @ . . . . @ . . . . @ . . . . . @ . . @ . 
. @ . . @ . . . @ . @ . . . . . . . . . @ . . . @ . . . . . . . 
. . . . . . . . @ . . . . . @ @ . . . . . . . . . . . . . . . . 
. . . . @ @ . . . @ . . . . . . . . . . . . . @ . . . . . . @ . 
. . @ . @ @ . . @ . . . . . . . @ @ . . . @ . . @ . . . . @ . . 
. . . . @ . @ . @ . . . @ . . . . . . . . . . . @ . . . . . . . 
. @ . . . @ . @ . . . . . @ . . . . . . @ @ @ @ . . @ @ . . . @ 
. . . . . . . @ . . . . . @ . . . . . . . . @ . . . . . . . . . 
. @ . . . @ . . . . . . @ . . . . . . . @ @ . . . . . @ . . @ . 
. . @ . . . . @ . @ @ . . @ . . . @ . . . . @ . . . . . . . . . 
. . . . . . @ . . . . . @ @ . . . . @ . . @ . . . . . @ . @ @ . 
. . @ . @ . @ . . . . . . . . . . . @ . . @ . . . . . . . . . . 
. . . . . . . . . . . @ . . . . . . . . . @ . . @ . . @ . . @ . 
. @ @ @ . . . . . @ . . . . . . @ . @ . . . . @ . @ . . @ . . @ 
. . . . . . @ @ @ . . @ . . . . . . . @ @ . . . . . . . . @ . . 
. @ . . . . . . . . . . @ . @ . @ . . . @ . . . . . . . . . . . 
@ . . @ . . . . . . . . . . @ @ . . . . . @ . . @ . . . . . . . 
@ . @ . . . . . . . . . . . . @ . . . . . . @ @ . . . . . . . . 
. . @ . . . . . . . . . @ . . . . @ . . . . . . . . . . . . . . 
. . . . @ . . @ . . . . . . @ . . . . . . . . @ @ . . . . . @ @ 
@ . . @ . . . . @ . . . . @ . . . . . . @ . . . @ . . . . . . @ 
@ . . . . . . @ @ @ . . . . . . . @ @ . . . . . . . . . . . . @ 
. . . . . @ @ . . . . . @ . . . @ . . . @ . @ @ . @ . @ . . . . 
. . . . . @ . . . . . . @ . . . . . . . . . . . . . @ . . @ . . 
@ . . . . @ . . . . @ . @ . . . . . . . @ . @ . . . . . @ . . . 
. . . . . . @ . . . @ . . . . . . . . . . . @ . @ . . @ . . . . 
. . . . . . . . . . @ @ . . . . . . . . . @ . . . . . . @ @ . . 
. . . . . @ . . @ . . @ . . . @ @ . . @ . @ . . . . . . @ . . . 
50
21 1 29 2
19 15 11 21
30 19 12 24
18 5 24 17
5 30 27 8
12 4 30 28
17 9 22 17
17 1 18 8
9 30 24 14
23 9 25 15
9 0 5 24
0 26 22 23
31 9 4 18
10 21 16 21
0 1 28 22
3 22 19 17
30 24 23 11
8 12 4 3
7 30 14 4
2 30 20 4
12 6 29 22
6 5 1 20
4 29 7 24
18 8 0 6
9 23 16 7
3 8 18 4
26 21 26 8
1 0 14 25
28 2 10 7
21 11 5 23
3 4 23 25
14 24 9 14
23 20 9 6
1 11 17 26
23 30 25 18
1 28 20 6
17 14 30 27
17 21 27 15
8 15 19 12
8 28 24 31
13 26 4 4
13 5 15 18
7 19 2 5
30 5 13 23
22 20 26 0
10 9 28 24
1 8 16 5
3 27 7 17
16 21 20 20
4 28 18 27
