32 32
. @ . . . . @ . . . . . . . . . . . . . . . . . . @ . . @ . . . 
. . @ @ . . @ . . . . . . . . . . @ . . . . . . . . . . . . . . 
. . . . @ . @ @ . . . . . . . . . . @ @ . . . . . . . . . . . @ 
. . . . . . . . . . . . . @ . . . . . @ . . @ . @ . @ . . . . . 
@ @ @ . . @ . @ @ . . . . . @ @ . @ . . . @ . . . . . . @ . . @ 
. @ . . @ . . . . . . @ @ . . . . . @ @ . . . @ . @ @ . . . @ . 
. . . . . . . . . . . . . . . . . . . @ . . . . . . @ . . . @ . 
@ . . . @ @ . . . . . . . . . . . . . . . . . . . . . . . . . . 
@ . @ . . . . . @ . . @ . . . . . . . . @ . . . . @ . . @ . . . 
. . . . . @ . . . . . @ . . . . . . . . . @ . @ . . . . . . . @ 
@ @ . @ . . . . . . . . . . @ . . . . . . . . . . @ . . @ @ . @ 
. . @ . . . . . @ @ . @ @ . . . @ . . . . . . . @ . . . @ . . @ 
. . . @ . . . . . @ . . . @ . . . . . . . . . @ @ . . @ . . . @ 
. . . . @ . . . . . . . . @ . . @ . . . @ @ . @ . . . . . @ . . 
. . . . @ @ @ . . . . . . . . . . . . . . . . @ . . @ . . . . . 
. . . . . . . . @ . . @ . @ . . . @ . . @ . . . . . . . . @ . . 
. . . . . . @ @ . . . . . . . . . . @ . @ . . . . . . . @ . . . 
. . . . . @ . . . . @ @ . . . . . . . . . . . . @ . . . . . . . 
. . . . . . . . @ . . . . . . @ . . . . . . . @ @ . . . . . . @ 
. . . . @ . . . . . . . @ . . @ . . . . @ . . . . . . . @ . @ . 
. @ . . . . . @ . @ @ @ . . . @ . . . . . . . . @ . . @ . . . @ 
@ @ @ . . . @ . . . . . . . . . @ . . @ . @ . . . . . . . . . . 
@ . . . @ . @ . . . . @ @ @ @ . . . . . . . @ . . . . . . . @ @ 
. . . . . . . . . . @ . . . @ . . . . . . . . . @ . . . . . . . 
. . @ . . . . . . . . . . . . . . . . . @ @ . @ . . . . . @ . . 
@ . . . . @ @ @ @ . . . . . . . @ . . . @ . @ . . @ @ . . @ . @ 
. . . . @ @ . . . . @ . . . . . . . . . . . . . . . . . . . . . 
@ @ . . . . . . . . . . . . . . @ . . . . . . . . @ @ . @ . . . 
. . @ . . . . @ @ @ . . . . . . . . @ @ . @ . . @ @ . . . . . . 
. . . . . @ . . @ . @ @ @ . @ . . . . . . . @ . . @ . . . . @ . 
. @ @ . . . @ . . . . @ . . . . . . . . . . . . . . . . . . . . 
@ . . . . @ . . @ . . . . . . . . . @ . . . . . @ . @ . . . . . 
20
11 10 19 31
11 2 27 4
0 28 12 6
16 20 15 22
22 6 18 23
31 16 18 3
13 14 17 0
29 12 30 20
28 30 20 28
15 3 25 7
7 13 8 17
6 11 26 18
3 28 27 27
8 1 23 2
18 9 14 17
17 29 5 21
27 21 29 27
7 12 11 3
12 31 26 1
8 7 31 7
