32 32
@ @ . @ . @ . @ . . . . . . . . . . . . . . . . . . . . . @ . . 
. . @ @ . . @ @ . . @ . . @ . @ . . . . . . @ . . . . . . . @ . 
. . . . . @ @ @ . . . @ . . @ @ . . . . . . . . . . . @ . . . . 
. . . . . . . @ . . @ . . . . . @ @ . . . @ . . @ . . . . . @ . 
. . . . . @ . . . . . . . @ . @ . @ . @ . @ . . . @ . . . . . @ 
. . @ . . . . . . . . @ @ @ . . . . . @ . . . . @ @ . . @ . . . 
. . . . . . . . @ @ . . . . . . . @ @ . . . . . @ . . @ @ . . . 
. . . . . . . . . . @ . . . @ @ @ . @ . . . . . . . . @ . @ . @ 
. . . . . . . . . . . . . . @ . @ . . . . . . @ . . . . . @ . . 
. @ @ @ . . . . . @ . . . . . @ . @ . . . . . . @ . . @ . . @ . 
@ @ . . . . . @ @ @ . . @ . . . . . . . . @ . . @ . . . . . . . 
. . . @ . . @ @ . . . @ . . . . . . . . @ @ . . . . . . . . . . 
. . . . . . . . . . . @ . . . @ . . . . . @ @ . . . . . . . . . 
. . . . . . . . . @ . . . . @ . . . . @ . . . . . . . . @ . . . 
. . . . . . . . @ . . . . . . @ . . . @ . @ @ @ . . . . . . . . 
@ . @ @ . . . . . . @ . @ . . . . @ . @ . . . . . . @ . . . . . 
. . . . . . . . @ . @ @ . @ . @ . . . . . . @ . . . . @ . . . . 
. . . . . . . . @ @ @ @ . . . . . . . . . . . . . @ . . @ . . . 
@ . . . . @ . . . . . . . @ . @ . @ . . . . . . @ . @ . . . . . 
. . . . . . . @ @ . . . . . . @ @ . @ . . . . . . @ @ . @ . . . 
. . . @ @ @ . . . . @ . @ . . . . @ . @ . . . . . @ . . @ @ . @ 
. . @ . . . @ . . . @ . . @ . . . @ . . . . . . . . . . . . . . 
@ @ . . . . . . . . . . . @ . . . . . . . @ . . . . . @ . @ . . 
@ @ . . . . . . . . . . @ . . @ . . @ @ . @ . . . @ . . . . . . 
. . . . . . . . @ . . . . . . @ . . . . . . . . . . @ . . . . . 
. . . . @ . . . . . . @ . . . . . . . . . . . . . . . @ . . . . 
. . . . . . . . . . . @ . . . . . @ . . . . @ . . . . @ @ . . . 
. . . . . @ . . . . . . . . . @ @ . @ . @ . . . . . . . . . . . 
. . . . . . . . . . . . . . @ . . . . @ @ . @ . . . . . . . . . 
. . . . . . . . . . . . . . . . . . . . . . @ @ . . . . . @ . @ 
@ . . . . . @ . @ . . @ @ . . . . . @ . . . . @ . . . . . . . . 
@ . . . . . . . . . . . @ . . . . . @ . . . . . . @ . . @ @ . . 
20
8 28 17 0
9 11 16 11
10 5 19 21
16 13 27 20
26 1 30 0
28 14 3 22
31 19 22 13
17 12 31 25
12 19 28 23
13 10 16 10
13 12 16 15
11 20 4 29
26 3 2 6
0 26 8 18
23 7 26 8
9 8 2 18
23 16 12 27
7 7 2 10
29 11 14 5
0 2 18 22
