32 32
. @ . . . . . @ . . . . . @ . @ . . . . . @ . @ . . @ @ . @ @ . 
. . @ . . @ . . @ . @ . @ @ @ . @ @ . . . @ . . . . . . . . . . 
. . . . . . . . @ . . . . @ @ . . . . . . . . . @ . . . . . . . 
. . . . . . . . . . . . @ . . . . @ @ . . . . . . . . . . . . @ 
. . . . . . . . @ @ . . . . @ . . . . @ . . . @ . . . . @ . @ . 
. . . . . . . @ @ . . @ . . . . . . . @ . . . . . @ . @ . . @ @ 
. . . . . @ . . . . . . @ @ . @ . . . . . @ . . @ @ . . @ . . . 
. @ . @ . . @ . . . . . . . . . . @ . . . . . . . . . . . . . . 
. . @ . @ . @ . . @ . . . . . . @ . . . @ . . . @ . . @ . . @ @ 
. . . . @ . . . @ . @ . @ . . . . . . . . . . . . . @ @ . @ . . 
. . . . @ . . @ @ . . @ . . . . . . . . @ . @ @ @ . . . @ @ . . 
@ . . @ . . . . . . . . @ @ . . . . . . . . . . . @ . . . @ . @ 
. . . . . @ . . . . . . . @ . @ . . . . . . . @ . . @ . . . . . 
. . . . . . . . . . . . @ . . @ . @ . @ . . . . . . . . @ . @ . 
. . . . . @ @ . @ @ . . . . . . . . . . . . . . . . . . . . . . 
. . . . . . . . @ . . . @ @ . @ . . @ . . @ . . . . . @ . . . . 
. @ . . . . . . . . . @ @ . . . . @ . @ . . . . . . . . . . @ . 
. . . . @ . @ . . @ . @ . . . . . . @ . . . . . . . . . . . . @ 
. . @ . . . . . . . . @ . . @ . . . @ @ . . . @ . . . . . . @ . 
. . . . . . . . . . . . . . . . . . . @ . @ . . . . . . . . @ @ 
. . . . . @ . . @ . @ . @ . . . . . . . . @ . . . . . @ . . . . 
. . . . . . @ . . . . @ . . . . . @ . . . . . . . . . . . @ . . 
@ . . . . . @ . . . . . . @ . . . . @ @ @ . @ . . . . @ . @ . . 
@ . . @ . . . . . . @ . . . @ . . @ @ @ . . . . . . . @ . . . . 
. . @ . . @ . . . . . . @ . . . . . . . @ @ . @ . . . . . . @ . 
. @ . . . . . @ . . . . @ @ @ @ . . . . . . . . . . . . . . . . 
@ . . . . . @ . . . . . . . @ @ @ . @ . . . . . . . . . . . . . 
. . . . . . . . . @ . . . . . . . . . . . . . . . . . . @ . . . 
. @ . . . . . . @ . @ . . . . . . . . . . . . . . @ . . . . . . 
. . . . . @ . . . @ @ @ . . . . . @ @ . . . . . . . @ . . . . @ 
. . . . . . . . . . . . . . . . . . . . . . . . @ @ . . . . @ . 
. . . . . . @ @ . . . @ . . . @ . . . . . . . . @ . . @ @ . . . 
50
3 9 2 0
23 7 9 10
0 19 19 28
29 31 13 17
2 21 26 6
22 20 28 1
23 30 16 31
24 20 3 2
14 10 6 12
7 15 17 19
27 27 19 7
23 28 22 8
19 0 25 19
16 22 29 27
2 11 0 31
4 0 16 25
30 20 9 24
20 0 1 4
4 15 5 28
2 5 20 30
20 1 18 21
15 9 2 4
11 9 31 30
15 23 21 29
15 21 2 11
24 19 30 3
12 7 8 21
29 29 11 22
5 16 3 30
22 31 28 23
31 7 11 12
12 2 22 16
4 4 11 27
8 16 22 28
19 15 0 8
26 5 5 5
7 3 11 23
29 2 16 12
8 30 28 3
13 7 24 1
5 11 5 8
18 4 25 9
29 30 11 2
6 28 16 11
3 1 2 17
13 5 20 2
25 23 12 7
21 7 29 19
23 15 18 7
9 12 21 25
