32 32
@ . . . @ . . . . @ @ . @ . . @ . . . . . . . . . . . . . . @ @ 
. . . . . . . . . . . . . @ . . . . @ @ . . . @ . . . . . . @ . 
. @ . . @ . . . . . . . . @ . . @ . . @ . . . . . . @ . . . @ . 
@ . . @ . . . . . . @ . . . @ . . . . . @ @ . . @ . . . . . . . 
. . . @ @ . . @ @ . . . . . . . . . . @ . . @ @ . . . @ . . . . 
. . . @ . @ . . . . . . . . . . . . . . @ @ . @ . @ . . . . . . 
. @ @ . . . . @ . . . @ . . @ . . . . @ . . . . . . . . . . . @ 
. . . . . . . . @ . . . . @ @ . . . . . . . . . . @ . . . @ . @ 
. @ . . . . . @ . @ @ . . . . . . . . . . @ . . . . . @ . . @ . 
. . . . . . . @ . . . @ . @ @ . . @ @ . . . . . . . . . . . . @ 
. . . . @ @ . . . @ . @ . . . . . . . @ . . . . . . . @ . . @ . 
@ . . . . . @ . . . . . . . . . . . . . @ . . . . . . . . . . @ 
. . . . . . @ . . . . . @ . @ . @ . . . . . . . . . @ . @ @ . . 
. @ . . . . . . . @ . @ . . . . @ . . . . . . @ @ . . . . . . . 
. . . . @ . . . . . . . . . . . @ @ . . @ . . . . . . . . . @ @ 
. . @ . . . . @ . . . . . . @ . . . . . . . . . @ . @ . @ @ . . 
. @ . . . @ . . . . . . . @ @ . @ @ . . . . . @ . . . @ . . . . 
@ . @ . . . . . @ . @ @ . . @ . . @ . . . . @ . @ . . . . . @ . 
. . . . @ . . @ . . . . . . . . . . . @ @ . @ . @ . @ . . @ . . 
. . . . . . . . . @ . . . . . . @ . . . . . . @ . . . @ . @ . . 
. . . . . . . @ . . . . @ . . . . . . . . @ . . . . . . . . . @ 
. @ . . . . . . . . . . @ . . . . . @ . . . . . . . . . @ . . . 
. @ . . . . . . . . @ . @ . @ . . . . . . . @ . . . . . @ . . . 
. . . . . . . . . . @ . . . . . . . . . . @ . . . @ . . . . . . 
@ @ . @ . . . . . . . . . . . . . @ . . . . . . . . @ @ . . . . 
. @ . . . . @ @ . . . . . . . @ @ @ . . . . . . . . . . . . . . 
. . @ . @ @ . . . @ . . @ . . . . . . . @ . . . . @ @ . @ . . . 
. . . . . . . . . . . . @ . . . . @ @ . . . . @ . . @ @ . @ . @ 
@ . . . . . @ . @ . . . . . . . . . . @ . @ . . . . . . . . . . 
. . . . . . . . . . . . . . . . . @ . . @ . . . . . . @ . @ . . 
. . . . @ . . @ @ . . . . . . . . . . @ . . . @ . . . @ . . . . 
. . . @ . . . . . . @ . . @ . @ @ . . . . . . . . . @ @ . . . . 
60
13 6 3 28
13 19 12 13
22 15 26 14
11 0 10 30
17 26 16 5
29 3 22 1
25 15 10 15
11 14 28 17
20 27 22 24
30 12 4 15
5 31 21 16
20 15 5 27
30 6 9 2
7 28 26 3
13 12 30 20
16 23 21 2
3 11 13 28
30 31 16 15
13 5 20 23
15 22 25 3
10 9 1 20
1 20 30 15
26 17 7 11
12 28 28 7
3 12 29 24
11 18 23 24
9 25 21 21
1 3 17 7
26 19 11 8
13 20 29 9
4 23 5 2
5 12 9 15
27 13 14 13
28 0 1 27
27 12 13 27
9 24 26 4
7 7 10 1
23 29 6 31
28 10 22 14
20 13 22 19
27 26 0 29
1 28 28 29
19 8 16 18
23 24 21 6
8 0 20 20
26 3 2 21
2 29 4 28
27 18 2 3
9 12 22 9
18 29 12 31
31 21 18 31
0 25 19 14
24 31 29 1
15 9 9 18
1 12 28 9
7 16 31 30
8 25 4 21
28 25 11 20
28 24 3 16
19 0 30 21
