32 32
. @ . . @ . @ . . . . . @ @ . . @ @ @ . . . . . @ . . . . @ @ . 
. . . . . . . @ . . . . . . . . . @ . . . . . . . . . . . . . . 
. . . @ . . @ @ . . @ @ . @ . . . . @ . @ . . . . . @ . . . . @ 
. . . . . . . . @ . . @ . . . @ @ . . @ . . . . . . @ . . . . . 
. . . . @ . . . . . . @ . . . . @ @ @ . . . . . . . . . . . @ . 
. . . . . . . @ @ . . @ . . . @ . . . . . @ @ @ . . . . @ . . @ 
. . @ @ . . @ @ . @ @ . . @ . . @ . . . . . . @ . @ . . @ . @ . 
. . . . . . . . . @ . . @ . . . . . . . @ . . @ . . . @ @ @ . @ 
@ . @ . . . . . . . . . . . . . . . . @ . . . . . . . . @ . @ . 
. . @ . . . @ . . . . . . . . . . . . . . . . . . . . @ . . . . 
. @ . @ . . @ . @ . . @ . . @ . @ . . . . . . . . . . . . . . . 
. . . . . . . @ @ . . . . . . . @ . . @ . . . . @ . . . . @ @ . 
@ . . . . . @ . @ . . . @ . @ @ . @ . . . . . @ . . @ . @ . . . 
. @ . . . . . . . . . . . . . . . . . . . . . . . . . . . . . . 
@ @ . . . . @ @ . . @ @ . . @ . . . . . . . . . . @ . . @ . . @ 
. @ . @ @ @ . . . @ . . . . . . . . . . . . . . . . . . . . @ . 
@ . . . @ . . . . . . . . . . . . . . . . @ @ . . . . . . . . . 
@ . @ @ @ . . . . . . . . . @ . . @ . . . . . . . @ @ . . . @ . 
. . @ . . @ . . . . . . . . @ @ . . . . . . . . . . . . . . . . 
. . . . . . . . . . @ . @ . . . . @ . . . . . . . . . @ @ . . . 
. . . . . . . @ . . . . . . . . . @ . @ . . @ . . . @ . . . . . 
. . . @ . @ . . . . @ . . . . . . @ @ @ . . . . . . . . . . . . 
@ . . @ . . . @ . . . . . . . . . . . . . . . . . @ . . . @ . @ 
. @ . . . . . . . . . . @ @ . . . . . . . . . . . @ . . @ . . @ 
. @ . @ . . . . . . . . . @ . . . . . . . . . . @ . . . . . @ . 
. . . . @ . @ . @ . @ @ . . . . . @ . . . @ . . . . . . . . . @ 
. . @ . . . . @ @ . . . . . @ . . . . . . . . . . . . . . @ . . 
@ . . . . . . . . . . . @ . @ . . . . . . @ . . . . . @ . . . . 
. . . . . . @ . . . . . . . . . . . . . @ . . . @ . @ . . . . . 
. . @ @ @ . . . . . . . . . . @ . . . . . . . @ @ . @ . . . . . 
@ . . . . . . . . @ . . . . . @ . . @ . . . . @ @ . . . . . @ . 
@ . . . @ . @ . . . . . @ . . @ . . . . . . . . . . . . . . . . 
60
13 11 5 1
0 19 1 7
18 5 27 10
2 12 15 8
17 31 14 8
22 8 16 28
27 14 9 27
15 9 28 17
12 13 21 10
8 28 23 21
17 6 29 4
27 31 15 0
8 19 19 7
24 16 29 10
3 9 19 19
1 31 16 12
8 17 31 21
22 28 4 12
9 31 9 20
7 15 4 13
16 20 2 2
8 20 20 9
11 0 13 10
5 8 5 27
14 8 26 16
20 25 2 14
20 13 3 11
24 13 12 6
16 13 10 22
26 31 26 5
23 18 13 16
17 16 24 15
3 30 23 2
24 17 21 22
14 3 20 5
16 21 11 22
23 14 14 30
13 28 25 15
15 26 22 25
5 12 27 14
18 28 9 5
5 24 7 23
7 3 1 8
28 16 10 5
10 30 21 6
25 18 8 13
16 7 25 1
11 7 28 3
11 24 20 8
21 26 10 7
15 28 8 0
18 8 7 13
23 19 18 16
22 23 13 31
22 18 20 29
24 3 15 27
17 8 21 0
27 17 16 8
12 18 25 8
17 22 25 9
