32 32
. . . @ @ . @ . @ . . . . @ @ . . . . . @ . . @ . . . . . @ . . 
. . . @ . . . . . @ . . . . @ . . . @ . . . . . @ . . . @ . @ . 
. . . . @ . . . . . . . . . . . . . . . . . . @ . . . @ . . . . 
. . . . . . . . @ . . . . . . . @ @ . . . . . . . . . . . . . . 
. . . . @ @ . . . . . . . . . . . . . @ . @ @ . . . . . . @ . . 
. . . @ . . @ @ . . @ . . @ . . . . . . . . . . . . @ . @ @ . . 
. . @ @ . . @ . . @ . @ . . . . . . . . . . . . . @ @ . . @ . . 
. . . @ . . . . . @ . . . @ . . . . . . @ . . . . . @ @ . . . . 
. . . . . . . . . . . . . @ . . . . . . . . @ . . . . . . . . @ 
. . @ . @ . . . . . . . . . . . . . @ . . . . . . . . . . @ . . 
. . . . . . . . . @ . . @ . . . . . @ . @ . . . . . . . . . . . 
@ . . . . . . @ . . . @ . @ . @ @ . . . . . . @ . . . . . . . @ 
. . @ @ @ @ . . . @ . . @ . . @ . . . . . @ . @ . . . . . @ . . 
@ . . @ @ . . . . @ . @ . . @ . . . . . . . . . . . . . . . . . 
. . . . . . . . @ . . . . . . . . @ . . . . . . . . . . . . . . 
. . @ . . @ . . . @ . @ @ . . @ @ @ . . @ . . @ @ . . . . @ @ . 
. . . . . @ . @ . . . . . . . @ . . . . . . . . . . . . . . . . 
. . . . . . . . . @ . . . . . . . . . @ . . . . . . . . . . . . 
@ . . . @ . . . . . . . . @ . @ @ . . @ @ . . . . @ . @ @ . . . 
@ . . . . . . . . @ . . @ . . . . . . @ @ . @ . . . . . . . . @ 
. . . @ . . @ . . . . @ . . . . . @ . . . . . . . . . . . . . . 
. . . . . . @ . @ . . . . . . . . . . @ . . @ . @ . . @ @ @ . . 
. @ . . . . . . . . . @ @ . . @ . . @ @ @ . . . . . . . . . . . 
@ . . @ . . . @ . @ @ @ @ . . . . . . . . . @ . . . . . @ . . . 
. . . . . . . . . . . . . . . . . . . . @ @ . . . . . . @ . . @ 
. @ . . . . . . . . . . . . . . . . . . . . . . . . . . . . . @ 
. . . @ . @ . . . . . . . . . . . @ . . . @ . . . . . . . . . @ 
. . @ @ @ . . . . . @ . . . . . @ . @ . . @ . . . @ . @ . @ . . 
. . @ . . @ @ . . . . . . . . . . . . . . @ . @ @ . . . . . @ . 
. @ . . . . . . @ . . . @ . . . @ @ . @ . @ . . @ @ . . @ . . @ 
. . . . . . @ @ . . . . @ . . . . . . . . . @ . . . . . . . @ . 
. . @ @ @ . . @ . . . . . @ . . @ . . . . . . @ . @ . @ . @ . . 
50
25 2 12 16
21 25 15 14
14 14 26 10
3 14 4 30
7 12 19 15
16 20 13 24
6 2 20 28
11 2 8 10
3 24 29 19
12 17 27 17
9 22 17 12
29 19 19 3
1 30 18 21
18 20 2 16
26 2 6 25
24 16 24 26
19 13 11 17
13 28 25 5
28 10 16 2
22 9 5 20
9 30 16 16
11 8 7 3
3 11 9 2
15 21 13 26
24 6 18 8
2 10 4 23
1 24 18 2
22 2 11 21
11 28 22 28
29 25 28 16
16 17 18 25
0 22 23 17
1 8 27 23
31 10 31 23
31 18 2 23
2 29 5 19
18 13 10 22
24 18 6 26
0 30 6 24
30 3 14 21
21 14 13 22
23 26 22 13
23 20 11 26
20 20 11 14
12 7 8 19
28 28 15 24
26 8 9 25
11 18 21 11
4 11 18 30
27 22 10 4
