32 32
. . . . . . . . . . . @ . . @ . . . @ . . @ . . . . @ . . . . @ 
. . @ . @ @ . . . @ . . . @ . @ @ @ . . . . @ . . . . . . . . . 
. . . @ . . . . . . . . . . . . . @ . . . @ . . @ . @ . . . @ . 
. . . . . . @ @ . . @ . . @ . . . . . . . . . . . . . . @ . . . 
. @ . . . . @ @ @ . . @ . @ . @ @ @ . . . @ @ . @ . . . @ . . . 
. @ . . @ . @ . @ @ . . @ . . . . . @ . . @ . @ . . @ @ @ . . @ 
. . . . . @ . . . @ . . . . . . @ . . . . . @ . . . . . . . . . 
. . . . . . . . . . . . . @ . . . . @ . . @ . . . . . . @ . . . 
. . . . . @ . . . @ . . . . . . . . . @ @ . . . . . @ . @ . . . 
@ . . . . . . . @ . @ . @ . . . @ . . @ . . @ . @ @ . @ . . . . 
@ . . . @ . . @ @ . . @ . @ . . . . @ . . . . . . . . . . . . . 
@ @ . . . . . . . . . . . . . . . . . . @ . . . . . . . @ . . . 
. . . . @ . @ . . . . . . . . . . . . . . . @ . . @ . . . . . @ 
. . . @ . . . . @ @ . . . . . . . @ . @ . . . . . . . . . @ . . 
. . . . . . . . . . . @ @ . @ . . . . . . . . . . @ . . . . . @ 
. . . @ . . @ . . @ . @ . . . . . . @ @ . . . . . . . . . . . . 
. . . @ . . . . @ . . . . . . . . . @ @ . @ . . . . . . @ @ @ . 
. . . . . . . . @ . @ @ . . . . @ . @ . . . . . . . . @ . . . . 
@ . @ . . . . . . . . . . @ @ . . @ . . . @ . @ . . @ . @ @ . . 
. . . . . . . . . . . . . . . . . . @ . . @ . . . . . . . . . . 
. @ . . . . . . . . @ @ . . . . @ @ . @ . @ . @ . . . . . . . . 
. . . . . . . . . @ . @ . . . . . @ @ . . . . . . . . @ @ . . . 
. . . . . @ . . . . . . . . @ . @ . . . @ . . . . @ . . . . . . 
@ @ . . @ . . . . @ @ . . . . . @ . . . . . . . @ @ . . . . . . 
@ . @ @ @ . . . . . . @ . . . . . . . . . . . @ . @ . . . . @ . 
. . . . . . . . . . . . . . . . . . . . . . . . . . . @ . . . . 
. . . . . . . . @ . . . . . @ . . . @ . . . . . @ . . . . . . . 
. . . . . . . @ . . . . . . . . . . . . . @ . . @ . . . . . . . 
. . @ @ @ . . . . @ . . @ @ . . . . . . . . . . . . . . . . @ . 
@ . . . . . . . . . . @ . . . . . . @ . . . . . . @ . . . . . @ 
@ @ @ . . . @ . . . . . . . . . . . . . . . . . @ . . @ . . @ . 
@ . . . . . @ . . . . . . @ . . . . @ . @ . . @ . . @ . . . . . 
80
0 15 0 8
6 17 29 20
13 11 27 18
30 15 16 11
2 2 17 17
17 29 7 14
0 22 0 12
30 22 12 20
11 11 31 18
1 22 17 26
8 30 13 16
27 22 12 6
16 18 26 4
20 6 1 12
0 16 13 9
27 18 16 27
7 11 13 2
30 0 28 26
27 2 29 9
17 11 3 12
31 24 7 30
4 0 5 23
0 8 5 27
3 22 29 24
17 9 23 28
2 26 12 12
3 26 2 13
5 4 28 28
16 15 7 9
2 13 5 16
25 0 18 14
7 21 19 1
31 23 10 15
3 21 16 2
18 9 31 8
8 25 28 12
27 4 4 29
13 26 25 0
17 24 23 19
4 13 19 0
25 10 22 24
4 8 10 13
29 6 7 18
27 11 24 21
11 3 5 25
27 27 11 25
14 31 22 11
27 13 17 10
12 30 24 12
3 30 14 28
5 17 23 10
13 12 20 26
25 7 4 9
31 27 20 16
24 31 31 22
20 13 15 14
10 10 13 22
18 27 3 8
14 7 17 30
18 24 29 29
16 28 19 24
0 28 4 26
22 17 20 1
16 27 18 3
24 20 20 7
21 13 3 26
17 27 12 4
22 2 22 28
1 27 21 24
4 2 19 5
2 4 25 15
30 9 16 3
10 11 28 31
8 27 26 21
1 10 22 25
24 7 5 5
24 14 10 22
27 29 25 27
12 7 21 28
12 6 29 31
