32 32
@ . . . . . . . @ . @ . . . . @ . . . . . . . . @ . @ . . . . . 
@ . . . @ . . . . . . . . . . . . . . @ . . . @ . . . . . . . @ 
. . . @ . . . . . . . . . . @ . . . . . . . . . . . . . . @ . . 
. . . . @ . . . @ @ . @ . . @ @ . . . @ . . . . . . . . . @ . . 
. . . @ . . . . . . . . . . . . . . . . . . . . . . @ @ . @ . @ 
. . @ @ . . . . . . @ . . . . @ . @ . . . . . . . . . @ . . . . 
@ . . . . . @ . . . @ @ . . . . @ . . . . . . . . @ . @ . @ . @ 
. . . . . . . . . . @ . . . . @ . . . . @ . @ . . . . . . @ . . 
. @ @ . . . @ @ . . . . . . . . . . . . . . . . . . . . . . . @ 
@ @ . @ . . . . . . . . . . . . @ . . @ . . . . . @ . . @ . @ . 
. . . . . . . . . . . . . @ . . . @ . . @ . . . . . @ . . . . . 
. . . . . . . . . . . @ . . . . . . . . . . @ . . . @ . . . . . 
. . . . . . . . @ . . . . . . . . . @ . @ . . . . . . . . . . . 
@ @ . . . . . @ . . . @ . . . @ @ . . . . . . . . @ . . . . . . 
. . . . . . @ . . @ . . . . . . . . . . . . . . . . . . . . . . 
. . . . @ . . @ @ @ . . @ . . . @ . . . . . . @ . . @ @ . . . . 
. @ @ . . . . . . @ . . . . . @ @ @ . . . . . . . . . . . . . . 
. @ @ . . @ . @ @ @ . . @ . @ . . . . @ @ . . @ @ @ . @ @ . @ . 
. @ . . . @ . . . . . . . . . . . . @ . . . @ . . @ @ . . . . . 
. . . . . . . @ . . . . @ @ @ . @ @ . . . . . @ . . . . . @ . . 
. . . @ . . . . . . @ . @ . . @ . . . @ @ . . . . . . . . . . @ 
@ @ . . . . . @ . . . @ . . . . . . . @ . @ . . @ . . . . @ . @ 
@ . @ . . . . . . . . @ . . . . . . @ . @ . . . . @ . . . . @ . 
. . . @ . . . . . . . @ . . . . . . @ @ @ . . @ . . @ . . . @ @ 
. . . @ @ @ . @ . . . @ . . . . . @ . . . . . . . . . . . . . . 
. . @ . . . @ . . . . . . . @ . . @ . @ . . . . . . . @ @ . . . 
. . @ . . . @ . . . . . . . . @ . . . . . . . . . . . . . . . . 
@ @ . . @ . . . . . . . @ . @ . . . . . . . . . . @ . . . . . . 
. @ . . . @ . . @ . . . @ . . . . . . . . @ @ @ @ @ . . . . . . 
. . . @ . . @ . . . . . @ . . . @ . . . . . @ . @ . . . . . @ @ 
. . . @ . . . . . . . @ . @ . @ . . . . @ . . . . . . . . . . . 
. . . . . . . . @ . @ . @ . . . . . . . . . . . . . . . . . @ . 
10
0 30 20 25
12 8 9 23
26 12 7 29
15 22 5 15
23 0 20 5
2 20 10 1
30 25 11 7
4 14 31 14
13 22 4 16
16 18 5 14
