32 32
@ . . . @ . . . . . . @ @ . . . . . . . . . . . . . . . . @ @ . 
@ . . . . . @ @ @ . @ . . . @ @ . @ . . . . . @ . . . . @ . . . 
. . . . . . . . . . @ . @ @ . . . . . . . . . . . . . @ @ . . . 
. @ @ . . @ . . . . . . . @ . . . . . . @ . . . . . . . . @ . . 
. . . . . @ . @ . . . @ . . . @ @ . . . . . . . . . . . . . @ . 
. @ . . . . . @ . . . . . . . . . . @ . . . . . . . . . . . . . 
@ . . . . @ . . . . . . . . . @ . . . . . . . . . . . . . . . . 
. . . . . . @ . @ . . . . . . . . . @ . . . . . . . @ . . . . . 
. . . . . . . . . . . . . . @ @ @ . . . . . . @ . . @ . . . . . 
. . . . . . . . . @ . . . . @ . . . @ . @ @ . @ . . . . . . @ . 
. . . . @ . . @ . . . . @ . . . @ @ . . . . . . . @ . . . . @ @ 
@ @ . . @ . @ . . . . . . . . @ . . @ @ . @ . . . . . . . . @ . 
. . @ @ . @ . . . . . . . . . . . . . @ . . . . . . . . . . . . 
@ . . . . . . . . . . @ . . . @ . . . @ @ . . . . @ . . @ . . . 
@ . @ . . . . . . . . @ . . . . . . @ . . . . . . . . . . . @ . 
. . . @ . . @ @ . . . . . . . . . . . . . . . . . . @ @ . . . @ 
. . . . . . . . . . . . . @ . @ . . . . . . . . . . . . . . . . 
. . . . . . . . . . . . . . . . @ . . @ . @ @ . . . . @ . . . . 
@ @ @ @ . @ . . . . . . @ . @ . . . . . . . . . @ . @ . . . . . 
. . . . @ . . . @ . . @ . . @ . . . . @ . @ . . @ @ . . . @ @ . 
. . @ @ . @ . . @ . @ . @ . . . . . . . . @ . @ . . . . @ . . . 
. . . . . @ . @ . . @ . . @ . @ @ . . . @ . . . . . . . . @ . . 
@ . @ . @ @ . . . . @ @ . . . @ . . @ . . . . . . @ . . . . . . 
. . . . . @ . . . . . . @ . . . . . . . @ . . @ . . . . . . . @ 
. . . . @ . @ . . . . . . . @ . . . . . . . @ . . . @ . . . . . 
. . . @ . @ . . @ @ . . . . . @ . @ . . . @ . . . . . . . . . . 
. . . . . @ . . . . . . . @ @ @ . . @ . @ . . . @ . @ . . . . @ 
. . . @ . . . . . . . . @ @ . . . . . . . @ @ . . . . . @ @ @ . 
. . . . . . . . . . @ . . . . . . . . . . . . . . . . @ . . . . 
. . @ . . . . . . . @ . . . . @ @ . . . . . . . . @ . . @ . . . 
. . . . . . . @ . @ . . @ . . @ . . . . . . . @ @ . @ . . . . . 
. . . . @ . . . @ @ . @ . . . @ . . . . @ @ . . . . @ . . . @ . 
30
29 29 12 1
9 26 4 4
15 23 15 28
6 23 12 25
5 30 1 4
19 9 0 27
28 26 4 1
19 18 6 29
3 11 25 17
11 10 24 3
13 12 12 29
17 31 1 23
22 20 7 14
8 8 27 31
3 29 14 2
20 7 25 30
30 26 25 21
6 0 30 28
21 2 27 4
3 3 7 20
7 19 14 31
2 23 5 13
30 16 16 24
29 11 29 26
4 30 26 4
22 15 8 5
29 28 12 26
29 24 20 10
31 25 21 14
9 10 23 7
