32 32
. . . . @ @ . . . . . . @ . . . . . . . . . . . . . . . . . . . 
. . . . . . . . . . . . . . . . . . . . . . . . . . @ . @ . . . 
. @ . . . . . . . @ . . . @ . . . . . . . @ . . . . . . . @ . . 
@ . . . . @ . . @ . . . . . . . . @ . . . . . . @ . @ @ . . . . 
. . @ . . . @ . @ . . @ . . . . . . . . . . . @ . . . . . . . . 
. @ . . . @ . . . . . . . . . . . . @ . @ @ . . @ . . @ . . . . 
. . . . . . . . . . . . . . . @ . . . . . @ . . @ @ . . @ . @ . 
@ . . . . . . . @ . . . @ . @ . . @ . . @ @ . . . . . . . . . @ 
. . . @ . @ @ . . . @ . . . . . . . . . @ . . . . . . . . @ . @ 
. . . . . @ @ @ . . . . . . . @ . . . @ @ @ . . @ @ @ . . . . . 
. . . . . . . . . @ . . . . . . . . . . . @ . . @ . . . . . . @ 
. . . . . . . . @ . . . @ . . . . . @ . . . @ . . @ . . @ . . . 
. . . . . . . @ . . @ @ . @ @ . . . . @ . @ @ . . . . . . . . . 
. . @ . . . . . @ . . . . . . . @ . @ . . . . . . . . . . . . . 
. . . @ . . @ @ @ @ . @ . . . . . . . . . @ . . . @ @ . . . @ . 
. @ . . . . @ . . . . . . . . . . . . . . . . . . @ . . . . . . 
@ . . . @ . . . . . . @ @ . . @ . . . . . . . . . . . . . . @ . 
. . . . . . . . . . . . . . . . . . . . @ . . . . . . . . . @ . 
. @ @ @ @ @ . @ . . @ @ . . . . . . . . . @ . . . . . . . . @ . 
. . @ . . . . . @ . . . @ @ @ . . . @ . . . @ . . . . @ . . . . 
. . @ . . @ @ . . . . . . . . . . . . . @ . . @ . . @ . . . @ . 
. . . . . . . . . @ @ @ . @ . @ . . . . . . . . . . @ . . . . @ 
. . . . . . . @ @ . . . . @ @ @ . . . . . @ . . . . . @ . . @ . 
. . . @ @ . . . . @ . . . . . . . . . . . . @ . . . . . . . @ . 
. . . . . @ . . @ . @ . . @ . . @ . . @ @ . . . . . . . @ . . @ 
. . . . . . . @ @ . . . @ . . . . . . . @ @ . @ . . . . . . . . 
@ . . . . . . . . . . . . @ . . . @ . @ . . . @ . . . . @ . @ @ 
. @ . . . @ . @ . . . . . @ . . . @ . . . @ . . . . . . . . . . 
. . . @ . . . . . . . . . @ . . . . . @ . @ . . . . @ @ @ @ @ @ 
. . . . @ . @ . @ @ . . . . . . . . . . . . . @ @ . . . . . . @ 
. . . . . . @ . . . . . . . @ . . . . . . . . . . . . @ . . . . 
@ . . . . @ . . @ . . . @ @ . . . . . . @ . . @ . . . . . . . . 
50
29 6 9 16
1 20 30 4
18 4 12 3
5 15 4 20
2 0 28 0
14 11 2 29
19 27 19 0
0 24 17 12
24 12 29 26
31 17 11 22
0 23 1 1
2 23 14 25
29 9 24 1
19 13 7 31
20 10 19 5
19 10 29 30
15 15 18 28
22 0 23 15
23 30 1 19
18 6 8 8
0 15 28 27
17 29 28 21
11 15 21 13
5 28 9 11
20 13 6 25
12 9 9 20
28 30 1 11
23 16 22 22
31 18 1 26
3 3 6 12
30 11 17 19
7 17 25 16
17 17 16 20
25 8 15 17
26 29 17 22
28 9 13 0
6 7 29 13
7 24 10 4
0 28 26 17
6 28 8 18
6 6 2 3
7 20 14 10
21 23 3 16
27 11 0 8
23 27 1 4
7 26 5 11
12 4 18 22
26 27 4 10
22 6 12 12
30 24 2 25
