32 32
. . . @ . . . . @ . . . . . . . . . . . . . @ . . . @ . . . . . 
@ . @ . @ . @ @ . . . @ . . . . . . . . . @ . . . . . . . . . . 
. . @ . . @ @ . . . . . . . @ . . . . @ . . . . . . . . . @ . . 
. @ . . @ . . . . @ . . . . . . . . . . . @ . . . . @ . . . . . 
. . @ . . . . . . . . @ . @ . . @ . . . @ . . @ . . . . . @ . . 
. . . . @ . . . . . . . . . @ . . . @ @ @ . . . . . . . . . . . 
. @ . . . . . . . . @ . . @ . @ . . . . . . . . @ . . . . @ . . 
. . . @ . @ . @ . @ . @ . . . . @ . . @ . . . @ . . . . . . . . 
. @ . . . . . . . . . @ . @ . . . @ . @ . . @ . . . . . . . . @ 
. @ @ . . . . . @ . . . @ . . . . . . @ . . . . . @ . . . . . . 
. @ . . . . . . @ @ . . @ . @ . @ . @ . @ . . . . . . . . . . . 
. . @ . . . . . . . @ . @ . . . . . . . @ . @ . . . . @ . . . @ 
@ . . . . . @ . . . . . . . . . . . . . . . . . . . . . . . . . 
. . . . . . . . . @ . @ . . . . . @ . . . . . . @ . . . . . @ @ 
. . @ . . . @ . . . @ . . . @ . . . . . . . . @ @ @ . . @ . . . 
. @ . . . . . @ . @ . . @ . . . . . @ . @ . . . . . . . . . @ @ 
. @ @ . . . . . . . . @ . . . . . . . . . . . @ . . . . @ . . . 
@ @ . . . . @ . . . @ . . . . . . @ . @ . . @ . . . . @ . . . . 
. . @ . . @ @ @ . . . . @ . . . . @ @ . @ . . . . . @ @ . . . . 
. . . @ . . . . . . . . . . . . . @ @ . . . . @ . . . . . . . . 
. . @ . . . . . @ . . . . . . . . @ . . @ . . . . . . . . . @ @ 
. . . . . . . @ . . . . . . @ . . . . . @ . . @ . . . . @ . . @ 
. . . @ . . . . @ . . . . . @ . @ . . . . . @ . . . @ . . . . . 
. @ @ . . . . . . . . . . . . . . . . . @ @ @ . . @ @ . @ @ . . 
. . . . . @ . . . . . . . . . . . . . . . . . . @ . @ . . . . . 
. . @ . . @ @ @ . . . . . . @ . @ . . @ . . . @ . . . . . . . . 
. . . . . . @ . . . . . @ . . . . @ . . . @ . @ . . . . . . . . 
. . . . . . @ . . @ . . @ . . . @ . . @ . . . . . . . . . . @ . 
. . @ . . . . @ . . . . . . . . . . . . . . @ @ @ @ . @ . . . . 
. . . @ . . . . . . . . . . @ . . @ . . . @ . . . @ . . . . . . 
. . @ . @ . @ . . . . . @ . . . . . . . . @ . . . . @ . @ . . . 
. . . . . @ . . @ . . . @ . @ . . @ @ . . . . @ . . . . . @ @ . 
50
6 11 11 27
28 15 9 20
3 1 14 17
29 11 10 23
5 21 8 26
18 29 7 24
17 28 12 22
21 19 23 22
17 1 11 26
23 11 22 29
17 23 14 12
18 11 28 26
24 0 5 9
23 24 24 27
17 12 6 13
30 23 8 14
14 6 15 20
11 25 3 9
12 17 23 3
8 30 8 11
11 29 29 20
0 22 20 3
25 17 11 11
10 8 18 30
14 7 1 20
0 31 14 11
24 31 27 0
4 31 11 0
24 21 3 25
3 12 29 11
30 10 26 19
13 0 7 19
2 13 9 22
29 27 15 13
11 14 31 9
30 4 11 20
15 20 6 7
28 29 18 28
1 14 4 13
12 0 2 17
26 7 5 15
11 2 18 9
15 13 3 15
23 30 15 17
18 13 31 24
23 9 25 22
10 22 26 1
9 0 6 4
24 20 16 18
30 16 6 21
