32 32
. . . . . . . . . . @ . @ . @ . . @ . . . . . . . . . @ . @ . . 
. @ . . . . . . . . . . . @ . . . . . . . . . @ . . . @ . . . . 
@ . . @ . . . . . . @ . @ . . @ . . . . . . . . . @ . . . . . . 
. . . . . . . . . @ . . . . @ . . . . . @ . . . . @ . @ . . . . 
. . . . @ . . @ . . @ @ . @ . . @ . . . . . . . . . . . . . . . 
@ . . . . . . . . . . . @ . @ . . @ @ . . . . . . . . @ . . . . 
. . . @ . . . . . @ . . . . . . @ @ . . . . . . . . . . @ . . . 
. . . . . @ . . . . . . . . . @ @ . . . . . . . . . . . @ @ . @ 
. . . @ . @ . . . . . . . @ . @ . . . . . . . . . . . . . @ . @ 
. . @ . . @ . . @ . . . @ . . . @ @ . . @ @ . . . . . . . . @ . 
. . . . . . @ . @ . . . . . . . . . @ . . . . @ . . . . . @ @ @ 
. . . . @ . @ . . . . . @ @ . . @ @ . @ . . . @ . . @ @ @ . . . 
. . . . . @ . . . . . . . . . . @ . . . . @ . . . . . @ @ @ . . 
. @ . . @ . . @ @ . . @ . . . . . @ . . . @ . @ . @ . . . @ @ . 
@ . . . . . . . . . . . . . . . . . . . . . @ . . @ . . @ . . . 
@ . . @ . . . . . @ . . . . . . . . . . . . @ . . . . . . . . @ 
. . . . @ . . . . . . . . @ @ . . . . . . . . @ . . . @ . . . . 
. . . . @ . . @ . . . . . . . . . . @ . . . @ . . . . . @ . @ . 
. . . . @ . . . . . @ @ . . . . . . . . @ . @ . @ . . . . . . . 
. @ . . . . . . . . . . . @ . @ . @ @ . . . . . . . . @ . . . . 
. . . . . . @ . . . . . . . . . @ . . @ . . . @ @ . . . . . . . 
. . . . . . @ . . . . . @ @ . . . . . . @ . . @ . . . . . . . @ 
. @ @ . . . @ @ . @ . . @ @ . . @ @ @ . . . . @ . @ . . . . . @ 
. @ . . . . . . . . . . . @ @ . . . . . . @ . . . . . . . . . . 
@ . @ @ @ . . . . . . . @ . . . . . . . . . . . . . . . . . . . 
@ . . . @ . @ @ . . @ . . . . . @ @ . . . . . . . @ @ . . . . . 
. @ . . . . . . . . . . @ @ . @ . . . . . . . . . . . @ . @ . . 
. . @ @ . @ . . . . . . . . . @ . . . . . . . . . @ . @ . @ . . 
. . . . . @ . . . . @ @ . . . . . @ . . . @ @ @ . . . . @ . . . 
. . . . . . @ . . . . . . . . . . . . . @ . . . . @ . . . . . @ 
. . . . . . . . . @ . . . . . . . . @ @ . . . . @ . . . . . @ . 
. . . . . . . . . . . . . . @ @ . @ . @ . . @ . . . . @ . . . . 
70
15 20 15 12
19 21 7 27
31 28 14 30
25 16 27 18
25 20 5 11
9 1 1 3
18 27 25 15
0 0 3 9
11 14 30 2
19 29 14 6
13 2 7 28
17 20 31 19
7 2 2 5
19 2 23 14
21 14 16 16
25 5 13 14
12 3 23 2
20 7 7 3
30 11 24 3
10 17 11 1
29 16 5 29
9 25 1 14
26 18 7 20
13 10 7 23
14 15 26 8
15 16 14 27
5 11 19 26
23 12 9 1
1 7 3 25
18 23 5 14
7 15 13 5
17 27 26 24
20 16 2 20
31 30 30 18
26 1 22 16
1 31 23 5
28 16 12 3
31 5 5 31
16 30 27 28
22 1 28 3
28 20 13 9
31 17 21 7
16 17 23 23
26 2 12 4
5 1 0 22
3 10 1 31
4 26 15 3
20 22 9 27
4 12 24 7
21 10 2 14
29 9 0 17
9 2 22 3
11 20 8 14
6 27 3 22
30 6 2 13
29 5 9 2
0 20 5 23
30 29 12 31
28 9 15 23
20 8 20 22
5 24 30 8
20 13 16 15
22 11 10 23
7 23 20 13
23 30 15 9
13 14 9 9
24 27 26 4
28 15 10 6
3 4 23 0
29 29 0 4
