32 32
. . . . . @ . . @ . . . @ @ . . @ . . @ . . . . . . . @ . . . . 
@ . . . @ . @ @ @ . @ . . . . . . . . . . . . . . . . . . . . @ 
@ . . . . . . . . . @ . . . . . @ . . . . . . . . . @ . . @ . @ 
. . . @ . . . . . . . . . . . . . . . . . . . . . . @ . . . . . 
@ . @ . . . . . . @ @ . @ . . @ @ . . @ . . . . . . . . . . . @ 
. . . @ @ . . . . . . . . . . . . . @ . . @ . . . @ . . @ . . . 
. . . @ . @ . . . . . . . @ . . . . . . . . . . . . . . . . . . 
. . . . @ @ . . @ . . @ . @ . . . . @ . . . . . . @ . . . @ . . 
. @ @ . . . . . . . . . . . @ . . . . . . . . . . @ . . . . . . 
. . . @ . . . . . . @ . @ . . . . . . @ . . . @ @ @ . @ . . . @ 
. . . @ . . . @ . . . . . . . . . . . . . . . . @ @ . . . . . . 
@ . . . . @ . . . . @ @ @ . . . . . . . . @ . . @ . . . . . @ . 
. @ . . . . . . . . . . . . . . . @ . @ . . . @ . . @ . . @ @ . 
. . . . . . @ . . . . . . . @ . . . . @ . . . @ @ . . . . @ @ . 
@ . . . . . . . @ . . . . . @ . @ @ . @ . . . . . @ @ . . @ . . 
@ @ . . . . . . . . . . . . . . @ . @ . @ . @ . @ . . . . . . @ 
. @ . . . . . . . . . . . . . . . @ . . @ . . @ . . . . . . . . 
. . @ . . . . . . @ . @ . . @ . @ . @ . @ . @ @ @ . . . . . . . 
. . . . . . . . @ . . . . . @ @ . . . . . . . @ . @ . @ . @ . . 
. @ . . . . . @ . . @ . . . . . . . . . . . . . @ . . . . . . . 
. . . . . . . @ . . . . . . . @ . . . . . . . . . . . . . . . . 
. . . @ . . . . @ . @ . . . . . . @ . . . . . . @ . @ . . . @ . 
. . . . . . . . @ . . @ . . @ @ . . . . . . . @ @ . . . . . . . 
. @ . . . . . . . . . . @ . . @ . @ . @ . . @ @ @ . . . . @ . . 
@ . . @ . . @ @ . . . . . @ . . . . . . . @ . . @ @ . . . . . . 
. . . . . . . . . . . . . . @ @ . . . . . . . . . . . . . @ . . 
@ . . . @ . . . . . . . . . . . @ . . @ . . @ . . @ . . . @ . . 
@ . @ . @ . . . . @ . . . . . . @ . . . . . . @ . . @ . . . . . 
. . . . @ . . @ . . . @ . . . . @ @ . . . @ . @ . . @ . . . . . 
@ . . . @ . . @ . . . . . . . . . . . . . . @ @ . . . . . . . . 
@ @ . . . . . @ . @ . . . . . . . . . . . . . . @ . . . . @ . . 
. . @ . . . . . . . . @ . . . . . . @ @ . . . @ . @ . . . . @ . 
40
30 24 27 27
6 27 6 29
10 26 15 10
27 15 5 16
10 7 18 19
9 6 31 7
12 7 12 30
9 28 29 10
8 6 19 3
9 2 12 10
13 14 15 16
30 23 18 12
6 12 23 5
19 6 30 5
14 16 18 16
8 31 11 21
3 4 31 0
29 8 28 7
17 13 27 14
28 25 4 11
11 29 26 22
22 2 23 10
7 25 6 17
0 17 25 16
25 29 15 1
20 27 28 11
23 26 22 7
12 26 26 17
18 25 28 15
13 1 0 5
9 16 23 7
1 2 28 29
20 12 28 4
23 1 14 10
28 11 3 8
0 16 28 26
27 6 8 9
15 5 31 23
18 2 6 4
20 30 22 21
