32 32
. . . . . @ . . @ . . . @ . @ . . . @ . . @ . . . . . @ . @ . @ 
. @ . @ @ . . . . . . . . @ . . . . @ . . . . . @ . . @ . . . @ 
. . . . @ . . . . . . @ . . . @ . . . . . . . . . . @ @ . . . @ 
. . . @ . . . @ . . . . @ @ . @ @ @ . . . . @ . @ . . . . . . @ 
. . @ . . . . . . . . . . . @ . . . . . . . . . . . . . @ . . . 
@ . . . . . . . . @ . . . . . . . . @ @ . . . . . . . @ @ @ . @ 
. @ . . @ . . . . . . @ . . . . @ @ @ . . @ @ . . . . . . . . . 
. . @ . . . . . . @ . @ . . @ . . . . . . . @ . . . @ . . . . . 
@ . . . . . . . . . . . . . . @ . . @ . . . . @ . . . . . @ . . 
. . . . . . . . . @ . . @ . . . @ . . @ . . . . . @ @ @ . . . . 
. . . @ . . @ . . . . . . . . . . . . . . . @ . . @ . . . @ . . 
@ . @ . . . . . . . . . . . . . . . . . . . . . . @ . . @ @ . . 
. . . . . . . . . . . . . . . . . . . . . . @ @ . . . . . . . . 
. . . . . . @ . . . @ . . @ . . . . . @ . . . . . . . . . . . . 
. . @ . @ @ . . @ . . . . @ . @ @ . . . . . @ @ . . . . . @ . . 
. @ . . . . @ @ . . . . . . . . . . . @ . . . . . . . . . . . . 
. . @ @ . . . . @ . . . . @ . . . . . . . . @ . @ @ . . . . . . 
. @ . . . . @ . . . . . . . . @ . . . @ . . . . . . . . . @ . . 
. . . @ . . . . . . . . . . . @ . . @ @ . . . . . @ @ . . . @ . 
. . @ . . . . . @ . . @ . @ . . . . . @ . . . . . . @ . @ . . . 
@ . . . . . . @ . . . . . . . . . @ @ . . . . . @ . . . . @ . . 
. . . . . . @ . . . . . @ @ . . @ . @ . @ . . . . . @ . . . . . 
. . @ . . . . @ . . . @ . . . . . @ . . @ @ . . @ . . . . . . . 
. . @ . @ . . . . . . . . . . @ @ . . @ . . . . . . . @ . . . . 
. @ . . . . @ . . @ @ . . . . @ . . . . @ @ . . . . . . . . . @ 
. . . . . . . . . . . . . @ . . . . . . . . . . . @ . . @ . @ . 
. . . . . @ . . @ . @ @ . . . . . @ . . . . . . @ . . . . @ @ . 
@ . . . . . @ @ . . @ . . . . . . . . . . @ . . . . . . . @ . . 
@ . @ . . . . . @ @ . . . @ . . . @ . @ . . . . . . . . @ @ . . 
. . . . . . @ . @ . . . @ . . . . . . . . . . . . @ . . . . . . 
@ . . . @ . . . . . . . . . @ . . @ @ . . @ . . @ . . . . . . . 
. @ . @ . . . . . . . @ . . . . . @ . . . . . . . @ . . . . . @ 
30
0 22 6 6
4 4 15 22
29 18 30 9
28 18 20 30
5 8 14 3
30 1 11 29
31 10 27 7
3 25 10 16
23 24 14 20
7 29 1 16
3 17 29 12
15 21 13 20
11 15 9 30
3 19 16 10
18 7 14 17
7 6 23 6
16 17 12 28
3 30 31 29
21 13 5 31
15 5 29 24
14 18 26 17
0 15 4 25
25 21 18 7
20 16 21 9
30 8 26 23
19 10 17 18
25 4 20 25
21 12 23 19
14 12 1 23
23 11 24 11
