32 32
. . . . @ . . . @ @ . . . @ . . . . . . . . . . . . . . . . . . 
. . @ @ @ . . . @ @ . . @ . . . . . . . . . @ @ . . . @ . . . . 
. . . @ . . . . . . @ . . @ . . . . . . @ @ . . . . . . . . . . 
. . . . . @ . . @ . @ @ . . @ . . . . @ . . . . . . . @ . . . . 
. . . . @ . . . @ . . . . . . . . . . . . . . . . . @ . @ . @ . 
. . . . . . . . @ . . . . . . . . . . . . @ . . . @ . . . @ . . 
. . . @ . . . . . @ @ . @ . . . . @ . . . . . . . . . . . . . @ 
. . . . . . . . . @ @ . . @ . @ . . @ . . . . . . . @ . . . . @ 
. . @ . . @ @ @ @ @ . @ . . . . @ . . . . . . . . . . . @ . . . 
@ . . . . @ . . . . . . . . . . . . @ @ . . . @ @ @ . . . . @ . 
. @ . . @ . . . . @ . . . @ @ . . @ . @ . @ @ . @ . . @ @ . . . 
. . @ . @ @ . . @ @ . . . . . . . . . @ . . . . . . . . . . . . 
. . . . . . @ . @ @ . . . @ . . . . . . . . . . @ @ @ . . . @ . 
. . . . @ @ . . . . . @ . . . . . @ . @ . . . . . . . @ . . . . 
. . . . . . . @ . . @ . @ . . . . @ @ . . . . . @ @ . . . . @ . 
. . . . @ . . . @ @ . . . . @ . @ . @ @ . . . . . . . @ . . . . 
@ @ . . . . . . . . . . @ . . . . . . . . . . . @ . . . . . . . 
. . . . . . . . . @ . . . . . . . . . . . @ . . . . @ @ . . @ @ 
. @ . . . . . . @ @ . @ . . . . . . @ . . . . . . @ . . . . . . 
. @ . . @ . . . . . . . . . . @ . @ . . . . @ . . @ . . . . @ . 
@ . . . . . . . . . . . @ . . . . @ . . . @ . . . . . . . . @ . 
@ . . . . . . . . . . . @ . . . . . . . @ . . . . . . . . . . . 
. . . . . . . @ . . . . . . @ . . . . . . . . . . . @ @ . . . . 
@ . . . . . @ . . . . . . . . . . . @ . . @ . . . @ . . . . . . 
. @ . . . . @ . @ . . @ @ . . . . . . . . . @ . . @ @ . . . . @ 
. . . . @ @ . . . . . . . . . . . . @ @ . . @ . @ . . . @ . . @ 
. . @ . . @ . @ @ . . . . @ . @ . . @ . . . . @ . . . . . . . @ 
. . @ . . @ @ @ @ . . . @ . . . . . @ . . . . . @ . . . . . . @ 
. . . . . . . . . . . . . . . . @ . . . . . . . . . . @ . . . @ 
. . . . . . . . @ @ . @ . . @ . . . . . . @ . . . . . . . @ . . 
@ . . . @ @ . . . . . . . . . . . . . . . . . . @ . . . . . . . 
. @ . @ . . . . . . . . . . . . . . . . . . . . @ . . . . . . @ 
60
4 27 7 5
10 18 14 23
30 31 19 0
3 18 26 29
12 12 22 9
19 20 16 24
30 5 19 20
12 13 14 5
20 28 0 13
15 6 9 31
20 10 29 25
12 4 24 23
24 6 6 25
30 6 4 6
17 22 19 23
15 17 13 6
16 25 29 15
24 23 3 3
15 18 14 20
3 25 28 29
23 17 7 30
22 16 8 21
0 17 25 29
23 25 28 12
14 7 2 28
18 2 14 31
13 3 19 30
12 2 21 28
4 26 29 2
30 28 22 6
29 10 24 26
25 1 24 11
6 31 3 23
27 30 7 16
20 11 15 21
9 16 7 24
3 24 19 7
12 28 17 7
26 16 16 11
23 19 16 19
27 2 23 12
31 8 27 29
12 23 10 31
20 7 11 0
3 9 0 6
28 29 24 13
26 13 21 22
28 30 29 24
16 19 14 4
5 0 0 7
2 9 22 28
20 31 21 27
1 4 0 12
7 15 8 2
29 13 23 7
23 12 20 9
12 22 27 21
28 27 5 1
4 12 31 21
24 29 8 19
