32 32
. . . . @ . . . . @ . @ . . . . @ . . . . . . . . . . . . . . . 
. @ @ . . . . . . . . . . . . . . . . . . . . . @ . . . . . . . 
. . . . . . . . . . . . @ . . . @ . . . . @ . . . @ . @ . . @ . 
@ . . . . . . . . . @ . . . . . . . @ . . @ . . . . . . . . . . 
. @ . . . @ @ . . . . . . . . . . . . . @ . . . . . @ @ . . @ . 
@ . . . . . . . @ @ . . . . . . . . . . @ @ @ . . @ @ . . . . . 
. . . @ . . . @ . . @ . . . . . . @ . . @ . . . . . . . @ . . . 
. . . . . . . . @ . @ . . . @ . . . . . . @ . . . . . . . . . . 
. . . . @ . . @ @ @ @ . @ @ @ . . . . . @ @ @ @ . . . . . . . . 
. . . . . . . . . . . @ . . . . . . . . . . . . . . . . . . . @ 
@ . @ . . . . . . . @ . . . . . . . . . . @ . . @ . . . . . . . 
. . . . . . . . @ . . . @ . . . . @ . . . . @ . . @ . . . . . . 
. . @ . . . . @ @ . . . @ . . @ . @ @ . @ . . . . @ @ @ . . . @ 
. . . . . . . . @ . . . @ . . . @ . @ . . . . . . . @ . @ . . . 
. . . . . . . . . . . . . . . . . @ . @ . . . @ . . . . . . . . 
. . . . . . . . . . @ . . @ . . . . . . . . . . . . . . . . . . 
. . . . . @ @ . . . . . . . . . . @ @ . . @ . @ @ . . . . . @ @ 
. . . . . . . . @ . . @ . . . . . . @ @ . . . . . . . @ @ . . . 
. . . . . . . . @ . . . @ . . . . . . . . . . @ . . . @ @ . @ @ 
. . . @ . . . . . . . . . @ . @ . . @ . . . . @ . @ @ . . . . @ 
@ @ . . . . . . . @ @ . . . @ . . . . . . . . . @ . . @ @ . . . 
. . . . . . . . . . . @ . @ . . . . @ . . . . . @ . . @ @ @ . . 
. . . . . . . . . . @ @ . . . . @ @ . @ . . . . . . . . . . @ . 
. . . . . @ . . . . . @ . @ . . . . . . @ . . . . . . . . . . . 
@ . @ @ @ . @ . @ . . . . . . . @ . . . @ . . . . . . . @ . . . 
@ . . @ @ . . . . . . . . @ . . . @ . . @ . . @ @ . . . @ . @ @ 
. @ . . . . . . . . @ . . . . . . . . . . . . @ . . @ . . . . . 
. . . @ . @ . . . @ . . . . . . . . . @ . . . . . . @ @ . . . @ 
. . . . @ . . . . @ . @ . . . . . . . @ . . @ . . . . . . . . . 
@ @ . . . @ . @ . . @ . @ @ . . . . @ . . . @ @ . . . . . . . . 
. @ . . @ . . . @ @ . . . . . . . . @ . @ . . . @ . . @ . @ . . 
. . . @ . . . . . . @ . @ . . @ . . . . . . . . . . . . @ . . . 
40
0 22 2 14
2 21 19 9
9 4 10 23
14 23 10 9
5 25 29 2
4 5 9 24
30 3 23 15
19 16 1 5
6 20 20 19
2 11 3 17
8 14 21 31
7 10 2 7
4 9 11 27
26 31 11 29
12 7 19 11
15 1 16 30
21 18 6 0
28 5 11 11
30 21 21 19
25 3 29 1
21 22 2 27
29 14 8 19
30 27 16 5
1 19 0 19
4 14 30 17
3 9 12 4
9 1 22 31
24 13 0 27
3 11 8 25
12 30 15 20
8 16 13 17
27 14 6 6
16 12 16 17
24 5 4 1
1 18 20 9
15 4 29 20
24 31 2 6
26 24 15 1
8 26 27 6
23 23 21 24
