32 32
. . . . . . . . . . . . . . . @ . @ . @ . . . . @ . . . . . . . 
. @ . @ @ . . . . . . . @ . . @ . . @ . @ @ . . . . . . . . . . 
. . . . @ . . @ . . . @ . . @ . @ . . . . . . @ . . @ @ . . . @ 
. @ @ . . . . @ . @ . . . . . . . . . @ . . . @ . . . . . . @ @ 
. @ . @ . . . . . . . . . . . . . . . . . . . . @ . . @ @ . . . 
. . . . . . . . @ . . . @ . . . . . . . . . . . . . . . . . . @ 
. . . . . . @ . . . . . @ . . . . . . . . . . @ . . @ . @ . . . 
. . . . . . @ . . . . . . . . . . . . @ . . . . . . . . . . . @ 
@ . . . . . . . . @ . . . . . . . . . . . . @ . . . . . @ . . . 
. . @ @ . . @ @ @ . . @ . . . . @ . @ . . . . . . . . . . @ . @ 
. . . . @ . . . . . . @ @ . . . . . . @ . . @ . . . . . . . . . 
@ . . . . . @ . . @ . . . @ . . . . @ . . . @ . . . @ . . . . @ 
. . . @ @ . @ . @ . @ . . . . @ . @ @ @ . . @ . . . . . . @ @ . 
. . . . . . . . . . @ . . . . . . . @ . . @ . . @ . . . . . @ . 
. . @ . @ . @ . . . . . . . . . . . . . . . . . . . . . @ . @ . 
@ . @ . . @ @ @ . . @ . . . . . . . . . . . . . @ . . . . . . . 
@ . . . @ @ @ @ . . @ . . @ . . . . . . . . . . . @ . @ . . @ @ 
. @ . . . . . . . . . . @ . . . . . @ . . . . . . . @ . . . . . 
. . . . @ . . @ . @ . . . . @ . @ . . . . @ . . . @ @ . . . . . 
. . . . . . . . . @ . . @ . . @ . . . . . @ . @ @ . @ . . @ @ . 
. . @ . . @ . @ . @ . . . . . . . . . . . @ . . . . . . @ . . . 
. . . . . @ . . . . . . . . . . . . . . @ . . . . @ . . . @ . . 
. . @ . . . . . . . @ @ . . . . @ . . . . . . . @ . @ . . . . . 
. . @ . . . . . . @ . . @ . . . . . . . @ @ . @ . . . @ . . . . 
@ . @ . . . . . . @ . . . . . . . . . . . . . . . . . . . . . . 
. . . . . . . @ @ . . @ . . . . . . . . . . . . @ . . . . . . . 
. . . . @ . . . . . @ . . @ . . . @ . . . . @ . . . @ . . . @ . 
@ . . . . @ . . . . . . . . . . . . . . @ . @ . . . . . . . . . 
. . @ @ . @ . . . . . . . . . . . . @ . @ @ . . . . . . . . . . 
. . . . . . @ . . . . . @ . . . @ . @ . . . . . . . . . . . . @ 
@ @ . . . . @ @ . . @ . . . @ . . . . @ . @ @ . . . @ . . . . . 
. @ . @ . . @ . . . @ @ . . . . . . . . . . . . @ . . @ . @ @ . 
10
23 25 8 28
21 17 22 19
19 9 23 30
8 29 20 24
20 3 23 12
22 22 28 28
7 27 24 3
5 9 21 25
27 13 1 8
27 5 27 20
