32 32
@ . . @ . . . . . . . . . . @ . . . . . . @ @ . . @ . . @ @ . . 
@ @ . . @ @ . . . . . @ @ . @ . @ . @ @ @ . . . @ @ . . . . . . 
. . . . . @ . @ . . . . . . @ . @ . . . . . . . . . . . . . . @ 
. @ . . . . . @ . . @ . . . . . . . . @ . . . . . @ . . . . . @ 
. . @ @ . . . . @ . . . . . @ . . . . . . . . . @ @ . . . . . . 
. . . . @ @ @ . . . . . . . . . . . . . . @ . @ . @ . . . . . . 
. . . . . . . . . . . . . . . . . @ @ . . . . . . @ . . . . . @ 
. @ @ . . @ . . @ . . @ . . . . . . @ . . . @ . . . . . . . . @ 
@ @ @ . . . . @ . @ . . . . @ . . . . . . . . . @ . . @ @ . . . 
. . . . @ @ . . . . @ . . . . . . @ @ . @ @ . . . @ . @ . . . . 
. . . . . . . . . . . . . . . . . . . . . . . . @ . . . . . . . 
. . . . . . . . . . . . . . @ . . @ . . @ . @ . . @ . . . . . . 
. . . . . . . . . @ @ . @ . @ @ @ . . . @ @ . @ @ . . . . @ @ . 
. . . @ . . . . . . . . . @ . . . . . . . . . . . . . . @ @ . . 
. @ @ . . @ . . . . . . . @ @ . . . . @ . . . @ . . . . . . . . 
. . . @ . @ . @ . . . @ . . . . @ @ . . . . . . . @ @ . . @ . . 
. . . . . . . . . . . . . . . . . . . . . . . . @ . . . . . . . 
. . @ @ . . . . . @ . . . . . . . . . . . . @ @ . . . . . . . @ 
. . . . . . . . . . . . . @ . @ @ . . . . . @ @ @ @ . . @ . . . 
. . . . . @ . . @ . . . . . @ . . . @ . @ . . . . . . . . . . . 
. @ . . . . . . . . @ . . . @ . . @ @ . . . @ @ @ @ @ @ @ . . . 
. . . . . @ . @ . . . . @ . . . . @ . . @ @ . . . . . @ . . . @ 
. . . . . . @ . @ . . . . . . . . . . @ . . . . . . . . . . . . 
@ . . . . . @ @ . . @ . @ . . . . @ . . . @ . . . . @ . . . . . 
. . . . . . . . . . . @ . @ . @ . @ . . . . @ @ @ . @ . . . . . 
. . . . . . . . . . . . . . . . . . . . . . . @ . . . . . . @ . 
. @ . . @ . . . @ . . @ . . . @ . . @ @ @ . . . . @ @ . . . . . 
. . . . . . . . . @ . . . . . . @ . . . . . . @ . . . . . . . @ 
. . . . . . . . . . @ . . . @ . . . @ . . . . . . . . @ . . . . 
. @ . . . @ . . . . @ @ . . . . . . . . . @ @ . . . . @ . . . . 
. . . . @ . . . . . . . . . . @ . . @ . . . . @ . . . . . . . . 
. . . . . . . . . . . . . . . . . . . . . @ . . . . . . . . . @ 
50
28 10 18 29
22 8 1 25
0 9 13 7
0 27 31 18
30 16 21 19
16 19 6 18
7 12 9 10
27 26 30 0
19 11 9 28
16 4 30 5
4 25 25 14
14 17 0 14
24 7 2 3
19 23 20 27
13 30 23 21
8 14 11 6
17 28 23 23
2 22 11 2
27 17 18 18
19 2 5 23
23 29 11 9
9 25 14 15
13 0 11 30
28 29 31 10
21 15 28 1
25 13 20 16
5 4 12 28
31 30 31 29
8 25 3 16
25 10 17 25
30 30 29 14
5 0 24 9
11 18 0 12
10 7 1 12
5 24 16 30
6 1 26 16
30 31 31 9
12 14 13 27
28 14 8 28
4 19 0 15
2 26 5 25
26 13 6 24
29 16 24 14
24 29 16 16
13 9 18 4
30 29 19 23
7 13 31 19
4 20 19 0
11 0 5 6
18 21 24 0
