32 32
. . . . @ . . @ . . . . @ @ . . . . . . . @ . @ . . . . . @ @ @ 
. . . @ @ . @ . . @ @ . . @ . @ @ . @ @ . . . . . . @ . . . . . 
. @ @ @ @ . . . . . . . . . . . . . @ . . . . . @ @ . . . . . . 
. . @ . . @ . @ . . . . . . @ . @ . . . . . . @ . . . . . . . . 
. @ . . @ . . . @ . @ . . . . . . . . . . . . . . . . @ @ . . @ 
. . . @ . . . . . . . . . @ . @ . @ . . . . . . . . @ . @ . . . 
. . @ . . . . . . . . @ . . @ . . . . . . . . . . . . . . . . @ 
. . . @ . @ . . . @ . . . . . . . . . . . . . . . @ . . . . @ . 
. . . . . . . . . . . . . @ @ . @ @ . . . . @ . . . . @ . @ . . 
. . . . . . . . . . . . . . . . . . . . . @ . . @ . . . . . . . 
. . . . . @ @ @ . . . . . . . . @ . @ . . . . @ . . @ . . . . . 
. . @ . @ . . . . . . @ . . @ . . . . . . . . @ . @ . . . . . . 
@ @ @ . @ . . @ . . . @ @ @ . . @ . . . @ @ . . @ . . . . @ @ . 
. . . @ . . . . . . @ . . . @ . . @ . . . . . . @ @ . @ . . . . 
. . . . @ . . . . @ . . . . . . . . . . @ . . . . . @ @ . . . . 
. @ @ . . @ . . . . . @ @ . . . . . . . @ . . . @ . . . . . . . 
. . . . . . . . . . . . . @ . . . . . @ . . . @ . . . . . . . . 
. . . @ . . . . . . . . . . . . @ @ @ . . . . . . @ . . . . . . 
. . . . . . . . . @ @ . . @ @ @ . . . . . . . . @ . . . . . @ @ 
@ . . . . @ . . . . @ . . @ . . . @ @ . . . . . . . . @ . . . . 
. . . . . . . @ @ . . . . @ . . . . @ . . @ . . @ @ . . . . . . 
. . . . . . . . @ . @ . . . . . . . . . . . . @ . . @ . . @ . . 
. . @ . . . . . . . . @ @ . . . . . . . . . . . @ @ . . @ . . . 
. . . . . . . . . . . @ . . . . . . . . . . . . @ . . . @ . @ . 
. . . . . . . . . . . . . @ . . . . . . . . . . . . . @ . . . . 
. . . @ . . . . . @ @ . . . . . . @ . . . . . . . . @ . @ @ . . 
. . . @ . @ @ @ . . . @ . @ . @ @ . . . @ . . . . . . . . . . . 
. . . . . . . . . . . . . . . . . @ . @ . . . @ . . . . @ . . . 
. . . . . @ . . @ @ . . . @ . . @ . . . . . . @ . . . . . @ . . 
. @ . . . . . . . . . @ . . . . . . . . . . @ @ . . . @ . . . . 
. . . . @ . . . . . . . . . . . . @ . . . . @ . @ @ . . . . @ . 
. . . . . @ @ . . @ . . . . . . . @ @ . @ . @ @ . . . @ . . . . 
50
11 16 11 4
0 2 26 22
1 25 24 17
21 19 19 26
8 23 3 15
20 30 7 31
26 12 23 8
10 5 14 22
17 12 4 16
16 31 7 8
16 25 17 16
2 25 8 12
7 4 16 22
27 30 26 3
5 2 26 6
23 5 11 30
22 2 19 11
25 26 6 7
31 30 7 14
22 20 24 4
28 9 25 19
0 0 0 27
9 27 2 14
15 29 4 7
2 0 19 9
17 24 25 28
31 1 9 2
18 0 20 6
15 7 2 21
27 18 8 6
14 26 25 18
14 2 8 22
20 3 10 26
12 8 20 19
24 1 8 0
23 2 19 22
2 24 13 31
2 9 11 20
7 11 26 2
21 23 3 20
3 29 30 17
21 14 4 21
15 14 6 9
8 14 29 3
13 7 14 21
18 3 19 12
1 5 18 21
19 13 27 1
6 0 19 8
22 10 5 6
