32 32
@ . . . . @ . . @ . . . . . @ . . . . . . . @ @ . @ . . . . . . 
. @ . . . . . @ . . . . . . . . . . . . @ @ . @ . . @ @ . @ @ @ 
. . @ @ . . . . @ @ @ . . . . . . . . . . . . . @ @ . @ @ . . . 
. . @ . @ . . . . . . . . . . @ . . . . . . . . . . . . @ . . @ 
@ . @ . . . . @ @ @ . . . . @ @ @ . . . . . . . @ @ . @ . . . . 
. @ . @ . . . . . @ . . . . @ . @ . . . . . . @ . . . . . . . . 
. . . . . @ . . . . . . @ . . @ . @ . . @ . . . . . . . . . @ . 
. . @ . . . @ @ . . . @ . @ . @ . . @ . . @ . @ . @ . . @ . . . 
. @ . . . . . . @ @ . . @ . . @ . . @ @ . @ . . . . . . . . . @ 
. . . . . . . . . @ . @ . . . . . . . . . . . . . . . . @ . . . 
. . . . . . @ . . . . . . . . . @ @ @ . @ . . . . . . . @ . . . 
. . . @ . . . @ . . . . . . . . . . . . . @ . . . . . . . . . . 
. . . . @ @ . . @ . @ . . . . @ . @ . . . . . . @ @ . @ @ . . @ 
. . . . . . @ . @ . . . . . . . @ @ . . . . . . . . . . @ @ . . 
. . . . @ . @ . . . . . . . . . . . @ . @ . . . . . . . . . . . 
. . . . . . . . . . . @ . . . . . . . . . @ . @ . . . . . . . . 
. @ . . . . @ . . . @ . . . . @ @ . . . . . . . . . . . . . . . 
@ . . . . . . . @ . . . . . . . . @ . . . . . . . . . . . . @ . 
. . . @ . . . . @ . . . . . . @ . @ . . . . @ @ @ @ . . . @ . . 
. . . @ . . . . @ . @ . . . . @ . @ @ @ . . . . . . . . @ . . . 
. . . . . . . . @ . @ . . . @ . . . . @ . @ . @ . . . . . . . . 
. . . @ . @ . . @ . . . . . . . . . . . . . . . @ . . . . . @ . 
. . . . . . @ @ . . . . . . . . . . . . @ . . @ @ . . @ @ . . . 
@ @ @ . . . . . . . . @ . . . . . @ . . @ . . . . . . . . . . . 
. . . . . . . . . . @ . @ . . . . @ @ @ . . . . . @ . @ . . . . 
. . . . . . . . @ . @ @ . . @ @ . . . . @ . @ . . . . . . . @ @ 
@ . . . . . @ . @ . . . . . . . @ . . . . . . . . . . . . . @ . 
@ . . . . . . . . . . . . . . . . . . @ . . . . . @ . . . . . . 
. . . . . . . . . . . . . . . . @ @ . . . . . . . . . . . . . @ 
. . . @ . . . . . . . . . . . @ @ . . @ . @ . . . . . @ . . @ . 
. @ . . . . . . . . . . . . . . . . . @ . . . @ . . @ . . . @ . 
@ . . . . . . . . . . @ @ . . . . . . . . . . . @ . . @ . . . . 
30
12 27 5 27
16 8 6 2
8 24 29 8
4 11 20 18
18 2 23 13
10 5 23 4
2 17 15 11
13 4 6 19
27 27 20 28
13 6 13 9
21 17 15 2
0 19 7 24
26 20 9 24
28 6 28 18
7 6 18 15
30 13 27 16
3 12 5 7
30 3 10 0
25 25 31 31
1 20 0 10
13 19 23 6
6 24 29 15
5 25 26 7
2 11 13 14
2 21 23 23
13 9 11 12
12 2 13 25
7 2 1 19
20 15 16 24
26 4 2 28
