32 32
. @ . @ . @ . . @ . @ @ . . . . @ . . . . . . . . @ . . @ . @ . 
. . . . . @ @ . . . . . . . . . @ . . . . . . . . . . @ . @ . . 
. . . @ . . . @ . . . . . . @ . @ . @ . . . @ . . . @ . . . . . 
. @ . . . . . . . @ . @ . . . @ . . @ @ . . . @ @ . . . . . . . 
. . . @ @ @ . @ . @ . . . @ . . . . . . @ @ @ . . . . . @ . . . 
. @ . . . @ . . . . . @ . . . . . . . . @ . . @ . . . @ . . . . 
@ . . . . @ . . @ . . . . . . . @ . . . @ . . . . . . . . @ . . 
. . . @ . . . @ . . @ . . . @ @ . . @ . . @ . . . . . . . . . . 
@ . @ . @ . . . . . @ . . . . . . . @ @ . . . . @ . . . . . . . 
. @ . @ . . @ . @ . @ @ . @ @ . . . . . . @ @ . @ . . . . . . . 
. . . @ . . . . . . . . . . . . @ . . . . . . @ . . @ . . . . . 
. @ . . . . . . . . @ . @ . . @ @ . @ @ . . @ . . . @ @ . . . . 
. . . . @ . . . . . . . @ . . @ . @ . @ . . . @ . @ . @ . . . . 
. . . . . . . @ @ . . . . @ . . . . . . @ . . . . . . . . @ . . 
. . . . . . . . . . . @ @ . . . . . . . . @ @ . . . . . . . @ . 
. . . . . . . . . . . . . . . @ . . . . . . . . . . . . . . . . 
. . . @ . . . . @ . . . . . . . . @ @ . . . . @ . . . . . . . . 
. . . . . . . @ . . . . @ . . . . . . . . . . . . . . @ . . . . 
. . . . . . . . . @ . . . . . @ . . . @ @ . . . . @ . . . . . . 
. @ . . @ . . . . . . . . . . . . . . . @ . . . . @ . . @ . . . 
. . . . . @ . . . . . . . @ . . . . . . . @ @ @ . . @ . . . @ @ 
. . . . @ @ @ . . . . . . . . @ . . . . . . . . . . . . . . . . 
. . . @ @ . . . . . . . . . . . @ . . . . . . . . . . . @ . @ . 
@ . . . . . @ . . . . . @ . . . . . . @ . @ . @ . . . @ . . . @ 
. . . @ . . . . . . . @ . @ @ . . @ . . . @ . . . . . @ . . @ . 
. . . . . . . . . . @ . . . . @ . . . . . . @ . . . . . . . . . 
. @ . . @ @ @ . . . . . . . . . . @ . . . . . . . @ . . . . . . 
. . . @ . . . @ . @ @ . . . . . @ . . . . . . . @ . . @ . . . @ 
@ @ . . . . . . . . . @ @ @ . . @ . . . . @ @ . @ . @ . . . . . 
. . . . . . . . . . . @ @ . @ . . . . . . . . . . . . . . @ @ @ 
. . . . . . . @ . . . @ @ . . . . . . . . . . . . . . . . @ . . 
@ . . . . . . . . @ @ . . . @ . . . . . @ . . . . @ . . . . . . 
10
26 23 21 10
27 26 19 20
1 13 14 16
23 0 2 6
16 23 10 4
28 18 25 20
1 14 11 12
27 20 5 8
7 20 16 3
0 26 0 15
