32 32
. . . . @ . @ . . . . . . . . . . . @ . . . . . . . . . . . . . 
. . . . . . @ . . . . . . . . . . . . . @ . . . . . . . @ . . . 
. . @ . @ @ . . . . . . . . . . . @ @ . @ . . . @ . . . . @ @ . 
. . . . . . . . . . . . . @ . . . . @ . . . @ . . . . . . . . . 
. . . . @ @ . . . @ . . . . @ . . . . . . . . . . @ . . . . . . 
. . . @ @ @ . @ . . . . . . . @ . . . . . . . . . . . . . @ . . 
. . . . . @ . . . . . . @ . . . . . . . . . @ @ @ . . . . . . @ 
. . . . . . @ @ @ . . . . . . . . . . @ @ . . . @ . . . . @ . . 
. . @ . . . @ . @ @ . . . . @ . @ . . . . . . . . . . . . . . . 
. . . . . @ . . . @ . . @ . . . @ . . . . . . . . . . . . . @ @ 
. . . . @ . . @ @ . . @ . @ . . @ @ . . @ . . . . . . @ . . . . 
. . @ . . . . . . . . @ . . @ @ . . . @ @ . . . . @ . . . . . . 
@ . . . . . . . . . . @ . . @ . . @ . @ . . @ . . . . . . . . . 
. . . . . . . . @ . . @ . . . . . . . . . @ @ . . . . . @ . . . 
. . . . . @ . . @ . @ . @ . @ . . . . . . . . . . . . . . . . . 
. . . . . . @ . . @ . . @ @ . . . . . . . . . . . @ . . . . @ . 
. . . . @ . . . . . . . @ . @ @ . . . @ . . . @ . . . . . @ . @ 
@ . @ . . . . . . . @ . . @ . . . . . . . . . . . @ . . @ . . . 
. . . . . @ . . . . . @ . . . . . . . . . @ . . @ @ . . @ . @ . 
. . @ . . . . . @ . . . . . . . . . . . @ . . @ @ . . . . . . . 
. . . @ . . @ @ . . @ . . . @ . @ . . . @ . . . . @ @ . . . . . 
. . . . . . . . . @ . . . . . . . . @ @ @ . . @ . . . @ @ . @ @ 
@ . . @ @ . . . . . . . @ . . . . . . . . . . . . . . . . . @ . 
. . . . @ . . . . . . . . . @ @ @ . . . @ . . . . . . . . . . . 
@ . . @ . . . . . . . . . . . . . . . . . . . . . . . . . . . @ 
. @ . . . @ @ . . . . . . . . @ . . . @ . . . . @ . . @ . . . @ 
. @ . . . . . . . . . @ . @ . @ . . . . . . . @ . . . . @ . . @ 
. . @ . . . . . . @ @ . . . @ . . . . @ @ . . . @ . @ @ @ . . . 
. . . . . . . . . . . @ @ . @ . . @ . @ . . . . . @ . @ . . @ . 
@ @ . . . @ @ . . . . . @ . . . . . . @ . . . . . . . . . . @ . 
. . . . . . @ @ . . . @ . @ @ . . . @ . @ . . @ . . . . . . . . 
. . @ @ . . . . . . . . . . . @ . . . . . @ . . . @ . @ . . @ . 
60
7 18 25 13
26 9 9 2
15 29 27 23
8 29 16 16
18 23 25 25
28 0 4 8
3 10 30 11
18 26 8 11
22 8 14 21
21 11 21 19
10 12 19 0
17 9 29 24
26 14 19 8
9 16 26 10
9 10 1 4
4 11 4 31
16 27 10 11
8 31 16 28
26 23 7 24
16 7 4 1
12 27 13 27
20 5 16 18
2 10 2 7
2 21 0 15
19 23 26 21
5 22 6 27
23 28 5 1
3 27 26 13
3 9 28 2
25 14 0 23
0 23 22 8
22 2 26 12
7 22 25 2
23 0 28 12
20 24 19 26
20 26 26 11
16 19 9 29
19 17 7 22
17 8 17 29
22 19 2 24
5 30 28 25
12 10 14 22
21 4 29 23
0 20 2 16
16 3 3 0
15 1 0 27
13 12 20 17
5 7 11 1
2 29 25 8
29 9 2 18
7 0 9 26
17 1 10 21
21 29 2 25
13 27 10 4
28 30 6 14
11 9 14 2
15 4 18 6
3 6 11 22
19 2 8 1
22 9 26 29
