32 32
. . . . . @ @ . . . . . . @ . . . . . @ @ . . . . . . . . . . . 
. . . @ @ . . . . . @ . . . . . . . . . . @ . @ . . . @ . . @ . 
@ . @ . . . . @ . . . . . @ . . @ @ . . . . . . . . . . . @ . @ 
. . . @ . . . . . . . . . . @ . . @ . . . . . . . . . . . . . . 
. . . . @ . . . . @ . . . . @ . . . . . . . . . @ @ . . . @ . . 
. . . . . . . @ @ . . . . . @ @ . @ . . . . . . . . . . . . . @ 
. . . . . . @ . . . . . . . @ . @ @ . . . . . @ . . . . . . @ . 
. . . . . . . . . @ . . @ . . . . . @ . . . . . @ . . @ . . . . 
. @ . . . . . @ . . . . . . . . @ . . . @ . . . @ . . . . . @ . 
. . @ @ . . . . . . . . @ . . . . . . @ . . . . . . . @ . . . . 
. . . @ . . . . @ . . . . . . . @ . . . @ . @ . @ . @ . . . . . 
. . . @ . . . . @ . . @ @ @ . . @ . . . @ . . . @ @ @ . . . . . 
. . . . . . . . . @ . @ . @ . . . . . @ @ . @ @ . . . . @ @ . . 
@ @ . @ . . . . . . . . . @ @ . . . . . @ . . . . . . . . . . . 
@ . . . . @ @ @ . . . . . . . . . . . . . . . . . . . . . . . . 
. . . . . @ . @ . . . . . . @ . . @ @ . . . . . . . . . . . @ . 
. . . @ . . @ . . @ . . @ . . . . . . . . @ . . . . . . . . . . 
@ . @ @ . . . . . . . @ . . . . @ . . . . . . . . @ . . . . . . 
. . . . . . . @ @ . . . . . . . . . . . . @ . . . . . @ @ @ @ @ 
@ . . . @ . . . . . . . . . . . . . . . @ . @ . . . . . . . . . 
@ . . . . . . @ @ . . . @ . . . . . . @ . . @ . . @ . . @ . . . 
. . . . . . . . . . . @ . . . . . . . . . . . . . @ @ @ @ . . . 
. . @ . . @ . . . . . . . @ . . . . @ . . . . . . @ @ . @ . . @ 
. . . . . @ . @ @ . . . . . . . . . . . @ . . . . . . @ @ . . . 
. . . @ . . . @ . . . . . @ . . . . . . . . . . . . . . . . . @ 
. . . . . @ @ @ . . . . . . . . . . . . . . . . . @ . . . @ . . 
@ @ @ . . . . . . . @ . . @ . @ . . @ @ @ @ @ @ . . . . . . @ . 
. . @ . @ . @ . . @ . . . . . . @ . @ @ . . @ . . . . . . . . . 
. . . . . @ . . . . @ @ @ . . @ . . . . . . . . @ . @ . . . . @ 
@ . @ . @ . . @ . . . . . . @ . . . . @ . . . . @ . . . . . . . 
. . . . . . @ . @ . . . . . . . . . . . . . . . @ . . . . . . . 
@ . . . . . @ . . . . . . . @ . . . . . . @ . . @ @ . . @ . . . 
10
9 23 12 1
29 16 23 16
2 7 13 17
26 31 30 5
11 6 9 20
5 16 2 0
18 0 17 29
19 7 30 14
7 27 23 13
8 24 20 16
