32 32
. . . . . . . . . . . . @ . . . . . . . @ . @ @ @ . . . . . @ . 
. @ . . . . . @ . @ . . . . @ . . . . . . . @ . . . . . @ @ @ . 
. . . . . . . . . @ . . . . . . . . . @ . @ . @ . . @ . @ . @ . 
. . . . . . . . . . . . . . . @ @ . @ . . @ . . @ @ . . . @ @ . 
. @ . . . . . . . . . . @ . . @ . . @ . . @ . . . . . . . @ @ @ 
. . . . . . @ . . . . . . . . . . . @ . . @ @ . @ . @ . . . . . 
. . . . @ . . . @ @ . . . @ . @ . @ . . @ . . . . @ . . @ . . . 
. . . @ . @ . . . @ . . @ . @ . @ . . @ . . . @ . . . . . . . . 
@ @ . . . . @ . . . . . . . . . . . . . . . . . . . @ @ @ @ . . 
. . . . @ . . @ . . @ @ . . . . . . . . . @ . @ . . . @ . . @ . 
. . . . @ . . . . . . . @ . . . @ . . . . . . . . . . @ . . . . 
@ . . @ . @ . . . . @ . . . @ . . . . . . . . . @ . . @ @ . @ . 
. . . . . . . @ . . @ . . @ . . @ . . . . . @ . . . . . . . . . 
. . . . . . . . . @ . . . . . . . . . . . . . . . . . . . . @ . 
. . . . @ . . @ . . . . @ . . @ @ . . . . @ . @ . . . @ . . @ . 
. . . . @ . . @ . . . . @ . @ . . . . . . . . . . . . . . . . . 
. . . . . @ . . @ . . . . @ . . . . . . . . . @ . @ . @ . . . . 
. . . . . . . . . . @ . . . @ . . . . . . . @ . . @ . . . . . . 
. . . . . @ . . . . . . @ . . @ . . . . . @ . . . . . . . . . . 
. . . . @ . . . . . . . . . . . . . . . . . . . @ . . . . . . @ 
@ . . . @ . . @ . . . . @ . @ @ . @ . . @ @ . @ @ . @ . . . . . 
. @ . . @ . . @ . . @ . . . @ . . . @ . . . . . . @ . . . . . . 
. . . . . . . @ @ . . @ . . . @ . . . . @ @ . . . . . . @ @ . . 
. . . . . . . . . . . . @ . . . . . . . . @ . . @ . @ . . @ . . 
. . . . . . . . . . . . . . . @ . . . . . . @ . . . . . . . . . 
@ . . . . @ . . . . . @ . . . . . . . . . . @ . . . . . . @ . . 
. . . . . . . . . . @ . @ . . . . . . . @ @ . . . @ . . . . @ . 
. . . . . . . @ . . . . @ . . . . . . @ . . . @ . @ . @ . . . . 
. . . . . . . . . @ @ . . . . . . . . @ . . . . @ . @ @ . @ @ . 
@ . . . . . . @ . . . @ . . . . . @ . . . @ . . . . . @ @ . . . 
. @ @ . . . . @ . . @ @ . @ . . . . . . . @ . . . @ @ . . . . . 
. . . . @ . . . . . @ . . . . . . @ . . . . @ . . . . . . . . . 
40
21 7 20 30
11 28 28 19
2 27 29 6
5 15 8 21
24 22 25 8
3 18 23 3
2 28 31 11
16 5 20 3
30 8 10 18
10 14 31 17
4 28 2 11
14 6 11 27
26 26 20 23
12 21 5 9
14 22 24 21
3 12 13 22
16 28 10 5
21 1 20 13
26 0 19 5
16 20 24 6
9 25 24 29
12 28 9 31
13 0 13 9
19 26 11 15
11 0 31 6
28 25 0 22
9 9 28 15
15 28 29 13
6 3 5 13
1 12 31 30
16 24 0 23
21 28 6 13
28 19 5 31
26 21 8 9
3 19 20 5
28 26 16 29
21 13 8 4
14 13 14 13
23 22 6 28
0 30 19 21
