32 32
. @ . . . @ . . . . @ . . @ . @ @ . . @ . . . . . . . . . . . . 
. . . @ . . . . . @ . . . . . . . . . . . . . . @ . @ . . . . . 
. @ . @ . . . . . . . . . @ . . . . @ . . . @ . . . . . . . . @ 
. @ . . . . . . . . . . @ . . @ . . . . . . . . . . . . . . @ . 
. . @ . . . . . @ . . . . . . . . @ . @ @ . . . . . . . . . @ . 
@ . @ . @ . . . . . . . . . . . . . . . . . . @ . . . . . . . @ 
. @ . . . . . . . . @ @ . . . . . . . . . @ @ . . . . @ . . . . 
. @ . . . . . . . @ @ . . . @ @ . @ @ @ @ . . . @ @ . . . @ . . 
. . . . . @ . @ . . @ . . @ @ . @ . @ @ @ @ . @ . . . . . . . . 
. . . . @ . . . @ @ . . . . @ . . . . . . @ . . . . @ . @ . @ . 
. . . . . @ . . @ . @ . . . . . . . . . . . . . @ . . @ . . @ . 
. . . . . . . . . . . . . . . . . . @ . @ . . . @ . . . . . . . 
. . . . . . . . . . . . . . . . @ @ @ . @ . . . . . @ . . @ . . 
. . @ . . . . . @ . @ . . . . @ @ . . . . . . @ . . @ . . . . . 
@ . . . . @ . . @ . . . . . . . . . . . . . @ . . . @ @ . @ . . 
. . . . . . @ . . . . . . . . . . . @ @ . . . . . . @ @ . @ . . 
@ . . . . . . . @ . . . . . @ . . . . . . . . . @ @ @ . . . . . 
. . . . . . . . . . . @ . . . . @ . . @ . @ . . . . . . . . . @ 
@ . . . . . . . . @ @ . @ . . . . . . . . . . . . . . . . @ @ . 
. . . . @ . . . . . . . @ . @ . @ . . . . . . . @ . @ . . @ . . 
. . . . . . @ . . . . @ @ . . . . . @ . . . @ @ . . . . . . . . 
. @ . . @ @ . . . . . . . . . . . . . . . . . . . . . . . . @ @ 
. @ . . . . . . . @ . . . . . . . . @ . . @ . . . . . . . . @ . 
. . @ @ . . . @ . . . . @ . @ . @ @ . . . . . . . . @ . . @ . . 
@ . . . @ . . . . @ @ . . . . @ . . . . @ . . . . @ @ . . . . . 
. . . . . . . @ . @ @ . . . @ @ . . @ @ . . . @ @ @ . @ . . . . 
. @ . @ . . . . . @ . . . . . @ . . . . . . . . . . . . . . @ @ 
. @ . . . . . . . @ . . . . . . . . . . . @ . @ @ . @ @ . . . . 
. . . . . . @ . . . . . . @ . . . . @ . . . . @ . @ . . . . . . 
. . . . . @ . . . . . . . . @ . . @ . . @ . . . . @ . . @ . . . 
. . . . . . . . @ . . . . . . . . @ . . . . . . . . . . @ @ . @ 
. . . . . @ @ . . . . . @ . . . . . . . . . . . . . . . . . . . 
70
9 3 23 17
18 0 15 8
18 3 11 27
26 30 20 23
18 6 0 4
14 18 10 4
31 29 22 27
3 27 10 17
24 21 0 1
28 26 6 22
12 11 2 19
17 0 5 7
2 6 15 16
5 27 28 1
13 18 19 3
2 24 12 5
22 26 29 31
15 20 0 13
8 27 4 7
3 7 20 31
28 24 26 31
29 10 10 21
19 26 12 12
14 13 26 25
0 31 11 0
3 17 7 26
26 22 19 2
19 29 0 12
4 2 19 20
29 28 18 14
19 13 0 9
6 30 5 19
21 21 13 23
0 25 13 31
10 4 9 15
31 16 15 10
13 5 11 26
3 19 9 13
0 10 16 1
29 25 2 9
1 30 24 17
3 3 13 24
7 24 27 22
27 2 20 19
23 0 5 11
30 13 13 5
4 13 15 29
20 22 24 23
16 2 24 26
22 13 29 2
16 10 9 4
4 4 6 30
26 3 7 17
6 8 5 3
5 6 21 29
5 1 26 22
1 8 9 2
7 21 23 7
30 23 2 21
9 14 11 5
31 19 12 17
16 28 4 18
22 25 13 16
16 4 19 1
28 8 21 31
20 31 2 26
17 11 12 1
6 22 7 5
24 14 1 17
29 5 5 30
