32 32
. . @ @ . . . . . . . . . @ . . . . . . . . . . . . @ . . . . . 
. @ . . . @ . @ . @ . . . . . . . . . @ . . . @ . . . . @ . . . 
. . . . . . . . @ . . . . . . . @ . @ . . . . . . . . @ . . . . 
@ . . . . . . . . . @ . . . @ . . . . @ @ . . . . @ . @ . . . @ 
. . . . . @ . . . . . . . @ . @ . . . . @ . @ . . . . . . . @ @ 
@ . . . . . @ . . . . @ . . . . . . . . . . . . @ . @ . @ . @ . 
. . . . . . . @ . . @ . . . @ . . @ . . . @ . . . . . . . . @ . 
. . . . . . . . @ . . . . . . . . . . . . . @ . . . . . . . @ . 
. . . . . @ @ . @ . . . @ . @ . . . @ @ @ . . . . . . . . . . . 
. . . . @ . . . . . . @ . . . . . . . . . . . @ . . . . . . . @ 
@ . . . . . @ . . . @ @ @ . . @ @ . . . . . . . . . @ . @ . . . 
. . @ . . . . . @ . . . @ @ . @ . @ . . . . . . . . . @ . . @ . 
. . . @ @ @ . . . . . . . . @ . . . . . . @ . . . . . . @ . . . 
. . . . . . . . . . @ . . . . . . . @ @ @ . . @ . . . . . @ @ . 
. . @ . @ . @ . . . @ . . . . . . . . . @ . . . . . @ . . . . . 
. . . . @ @ @ . . . . . . . . . . . . . @ . . . . . . . @ @ . . 
. . . @ . . . . @ . . . @ . @ . . . . . . . . . . @ @ @ . . @ . 
. . @ . . . . . . . @ . . . @ @ . . . . @ . . . . . . @ . . . . 
. @ @ . . @ . . . . . @ . . . . . . . . . . . . . . . . . . . . 
. . . . . . . . . . . . . @ . @ . . . . . . . . @ . . . . . . . 
. . @ . . . @ @ . . . . . . . @ . . . . . @ . . . @ . . . . . . 
. . . . @ . . . . . . . . . . . . . . . . @ . . . . . @ . . . @ 
@ . @ . . @ . @ . . . . @ . . . . . . . . . . . . . . @ @ . . . 
. . . . . . . @ . . . . . . . . . @ . @ . . @ @ . . @ . . . . . 
. . @ @ . . . @ . . . . @ . @ . . @ . . . @ . . . . . . . . . . 
. . . . . . . . @ . @ . . . . . . . . . @ . . . . . . @ . . . . 
. @ . . @ . . . @ . @ . . . . . @ . @ . . . . . . . . . . . @ . 
@ @ @ . . . . . . . @ . . . @ @ @ . . @ . . . . @ @ @ @ . . . . 
@ . . @ . @ @ . @ @ . . @ @ . . . . . . . . . @ . . . . . . . . 
. . . . . . . @ . . . @ . . @ . . @ @ @ @ . . . . . @ . . . . . 
. @ . . . . @ . . . . . . . . . . . @ . . @ . . . . . . . . . . 
. @ @ . . . . @ . . . . . . . . @ @ . @ . @ @ . . . . . @ . . . 
10
4 8 29 14
1 17 15 9
8 3 31 31
3 27 6 29
15 12 24 7
4 20 5 29
9 12 26 26
24 25 17 28
20 19 3 26
30 9 21 8
