32 32
@ . . . . . . . @ . . . @ . . . . . . . . @ . . . . . @ . . . . 
. . . . . . . . @ . . @ . . . . . . @ . . . . . . . . . . . @ . 
. @ @ @ . . . . @ . . @ . . . . . @ @ . . . . . . . . . . . . . 
. @ . . . . . . . @ . . . . . . @ @ @ . . . @ . . . . . . . . . 
. @ . . . . . . @ . . . . . . @ . . . . @ . . @ @ . . . @ . . @ 
. @ . . . @ . . . . . . . . . @ . . . . @ . . . . @ . . @ . . . 
@ . . . . . . . . . . . . . . . . @ @ @ . . . . @ . . @ . . . . 
. . . . @ . . . @ . . . . . . . . @ . . . . . . . . . @ . . . . 
@ . . . . . . . . . . . . . . . . . . . . . . @ . @ . . . . . . 
. . . . . . . . . . . @ @ . . . . . . @ . . . . . . @ . . @ . . 
. @ . . . . . . . . . . . @ @ . @ . . . . . . @ . @ . . . . . . 
. @ . . . . . @ . @ . @ . @ @ . . . . . . . . . . @ . . @ . . . 
. . . . . . . . . . @ @ . @ . . . @ . . . . . . . . . . . . . @ 
@ @ . @ . . . . @ . . . @ . @ @ . . . . . . @ . . . . . . . . . 
. . . . . . . . . . . . . @ . . @ . @ . . . . @ . . . . @ . . . 
. @ . @ @ . . . @ . . . . @ . . . . @ @ . @ . . . @ . . @ . . . 
. . . . @ . @ . . . @ . . . . . @ . . . @ . . . . . . . . @ . . 
. . . . . . . @ . . . . . . . . @ . . . . @ . @ . . . . @ . @ . 
. . . . . @ . . . . . . @ . @ . . . . . @ . . . @ . . . . . . . 
@ @ . . . . @ @ . . . @ @ @ . . . . . . . @ . . . . . . . . . . 
@ @ @ . . @ @ . @ . . . . . . . . . . . . . . . . . @ . . . . @ 
. . . . . @ . . . @ . . @ @ . @ . . . . . . . . . @ . . @ . . . 
. . . . . . . @ . . . @ . . . . . . . . . . . @ . . . . @ . . . 
@ . . . . . . . . . . . . . . @ . . . . . @ . . . . . . . . . . 
. . . . . . @ . @ . . . @ . . . . . . @ @ . . @ . . . @ . . . @ 
. . . . . . . . . . . . . . . . @ . . @ . . . @ . . . @ @ . . . 
@ . . . . @ @ . . . @ . @ . . . @ . . . . . @ . @ . . @ @ @ . . 
. . . @ @ @ . . @ . . . @ . @ @ . . . @ . . . . . . . @ . @ . @ 
. . . @ . . . . . . . @ . . . . . . . @ . . . @ . . @ . @ . . . 
. . . . . . . . . . . . . . @ . . @ . . . . @ . @ @ . . . . @ . 
. . . @ . . @ . . . . . . . @ . . . . . @ . . . . . . . @ @ . @ 
@ . . @ @ . . . . . . . . . . . . @ @ . @ @ . . . . . . . . . . 
80
30 21 7 2
31 11 16 15
3 12 7 30
25 20 7 26
15 25 9 16
24 22 22 12
5 9 6 31
31 8 25 28
21 30 30 6
6 18 4 10
17 21 6 15
16 19 25 23
22 18 9 17
29 3 5 4
11 23 27 12
2 15 2 28
18 22 11 16
12 30 21 25
10 7 31 16
24 1 3 0
20 3 14 5
8 28 4 0
22 23 22 31
17 14 3 1
30 15 30 3
3 24 6 27
6 5 28 8
3 19 7 23
26 5 26 18
13 3 0 18
24 31 0 28
11 15 18 10
0 22 26 29
12 2 21 28
5 19 3 17
2 26 6 18
16 24 10 23
13 29 7 5
15 31 20 21
1 1 4 20
26 11 19 2
23 21 13 8
9 17 24 2
2 28 1 22
27 1 13 27
0 4 29 0
23 27 18 27
13 26 20 1
2 3 20 7
10 1 2 18
21 10 21 16
14 20 10 22
8 17 20 10
21 2 12 17
18 26 29 25
27 19 4 2
6 1 10 13
8 14 26 31
30 8 31 6
20 11 24 7
31 13 15 18
13 4 15 24
22 30 7 29
8 22 23 15
26 26 2 4
22 25 19 8
27 9 13 6
10 3 17 28
20 22 25 6
13 0 23 9
2 8 22 21
20 14 3 7
20 29 5 6
1 26 27 29
4 10 8 28
24 15 17 19
24 28 7 31
23 11 17 30
23 26 8 19
3 16 27 4
