32 32
. @ . . @ . . @ . . @ . . . @ @ . . . @ . . @ . . . @ . . . . . 
@ . . . @ @ @ @ . . . @ . @ . . . . . . . @ . . . . . . @ . . . 
. . . . . . . . @ . . . . . . . . . . @ . @ . . @ @ @ . . . . . 
@ . . @ @ . . . @ . . . . . . . . . . . . . . . . . @ . . . . @ 
. @ . . . . . . . . . . @ . @ . . . @ . @ . . . @ . . . @ . . . 
. . . . . . @ @ @ @ . @ . . . @ @ . . . . . @ . . . . @ . . . . 
. . . . . . . . . @ . . . . . @ . . . . . . . . . . . . . @ . @ 
. @ . . . . . @ . . . . . @ @ . @ . . @ . . . . @ . . . @ . . @ 
. . . . . . . . . . . . . . . . . . . . . . . . . @ @ . . . . . 
. . . @ @ . . . . . . . . . @ @ . @ . @ . . . . . . . . . . . . 
. . . . . @ . . . . . . @ . . . @ . . . . . . . . . @ . . . . . 
. @ . . . . @ . . @ . . . @ . . @ . . @ . . . . . . . . @ . . . 
@ . . . . . . . . . . . . . . . . @ . . . . . . . @ @ @ @ . . . 
. . . . . . . @ @ @ . . . . . . @ . @ . . . . @ @ . . . @ . . . 
. . . @ . . . @ . @ @ @ . . . . . . @ . . . . . . . . . @ . . . 
@ @ @ . . @ @ . . . . . . @ . . @ . . . . . . @ . @ @ . . . . . 
. . . . . . . . . . . . @ . . . . . @ @ . . . . . . @ . . . . . 
. . @ @ . . @ . @ . . . . . . @ . @ . . . . . . @ . . @ . . . . 
. @ . . . . @ . . . . . . . @ . . . . . . . . . . . @ @ . . . @ 
. . . . . . . . . . . @ . . . . . . . . @ . . . . . @ . . . . @ 
@ . . . . . . . @ . . . . . . @ . . . . . . . . . . . . . @ . . 
@ @ . . . . @ . . . . . . . . . . . . . @ . . . . @ . . @ . @ . 
@ . @ . . . . @ . @ . . @ . . . @ . @ . . . . . . . . @ . . . . 
@ . . . . . . @ . . . . . . . . . . . . . . @ . . . . . . . . @ 
. . @ . . . . . . . @ . @ . . . . . . . @ . . . . . . @ . . @ . 
. . . . . . . . . @ . . . . . @ . . . . . @ . @ . . @ @ . . . @ 
. @ . . . . . . . . . . @ @ . . @ @ . . . . . @ . . @ . . @ . . 
. . . . @ . . . . . . . . . . . . @ . . . . . @ . . . . . . . . 
. . . . . . . . . . . . . . . . @ . @ . . . . @ . . . . . . . @ 
. . @ . @ @ . . . . . . . . . @ . . @ @ . . . . . . . . @ . . @ 
@ @ . . @ . . . . . . . . . . . @ . . . . . . . . . @ . . @ @ . 
@ @ . . . . @ . . . . . . @ @ . . . @ . . . . . . . . . @ . . . 
70
11 11 8 21
20 22 25 16
29 1 17 31
30 29 29 16
27 31 20 23
21 29 31 11
16 6 4 13
25 13 6 4
27 8 15 16
17 2 17 11
19 5 22 2
4 17 28 5
12 28 24 12
8 1 11 23
6 14 2 6
16 8 5 8
31 15 29 7
7 25 19 5
25 22 26 24
6 25 20 1
22 10 6 30
25 17 19 17
22 2 13 28
24 28 11 25
10 12 29 13
4 26 29 28
29 5 21 15
0 14 3 22
27 21 27 19
18 25 27 26
15 18 26 13
9 29 17 0
7 4 23 5
9 17 15 19
31 12 6 25
19 26 0 29
4 4 11 24
3 31 23 22
0 17 31 17
14 10 17 2
12 15 31 8
14 1 30 23
22 9 21 12
28 30 21 0
27 3 17 1
30 10 4 21
1 23 5 31
30 28 6 14
16 21 23 8
12 25 1 25
16 19 10 10
2 20 17 29
17 22 19 10
18 18 17 22
12 29 2 4
14 5 8 15
4 5 20 0
23 23 5 7
11 27 1 19
10 22 5 2
19 8 19 26
9 20 28 22
27 27 13 22
31 14 7 17
21 11 25 0
6 7 13 24
15 31 10 21
26 14 21 31
25 6 18 26
17 14 14 25
