32 32
. . . . . . . @ . . . . . . . . . . . . . . . . @ . . . . . . . 
. . . . . . . . @ . . . . @ @ . . . . . @ . . . . . . @ . . . . 
. . . . . @ . . . . . . . . @ . . . @ . @ @ @ . . . . . . @ . @ 
@ . @ @ . . . @ @ . . . . . . @ . . . . . @ @ . . @ . . . . . . 
. . . . . . . . . . @ . . . . . . . . . . . . . . . . . . . . . 
. . . . . . . . . . . . . . . . . . . . . . . . . @ . . @ . . . 
. . . . . . @ @ @ @ . . . . @ . . . . . . . . @ . . . . @ . . . 
@ . . . . . . . . . . . . . . . . . @ . @ . . @ @ @ . @ @ . . . 
. @ . . @ @ . . . . . . . . . @ . . @ . . . @ . @ . . . . . . @ 
. . . . . . @ . @ . . . . . @ . . . . . . . . . @ . . @ . . . . 
. @ . . . . . . . . . @ . @ . . . . . . . . . . . . . . . . . @ 
@ . . . @ . . . @ . . @ . . . @ . @ @ . @ . @ @ . . . . . . @ @ 
. . @ @ . . . . . . . . . @ . . @ @ . . . . . . . . . . . . . . 
. . . @ . . @ . @ @ @ . . @ . @ . . . @ . . . . . . . . . . . . 
. . @ . . @ . . . @ . . . . @ . . . @ . @ @ . @ . . @ @ . . @ . 
. . . . @ . @ . @ . . . @ @ . . . . . . . . . @ . . @ . @ . . @ 
. . @ . . . @ . . . . @ . . . . . . . . . . . @ . . . . . . @ @ 
@ . . . . . . . . . . . . . @ . . @ @ . . @ . . . . . . . . . . 
@ . @ . @ . . . . @ @ . . @ @ @ @ . . . . . . . . . @ . . @ . . 
. . . . @ @ . . . @ . . . . . . . . . . @ @ . . . . . . . . . . 
. . . @ . . . . . @ @ . . . . . . . . . . . @ @ . . . @ . . @ @ 
. . . . . . . . . . . . . . . . @ . . . . . . . @ . . . . . @ . 
@ . . . @ . . . . . . . . . . . . @ @ . . . . @ . @ . @ . . . @ 
. . . . . . . . . . . . . . . @ @ @ . . @ . . . . . @ . . . . . 
. @ . . . @ . . . . . . . . . . . @ . . . . @ @ . . . . . . . @ 
. @ . . . . . . . . . . @ . . . @ . . @ . . . . . @ . . . . . . 
. . @ . @ . @ . . . . . . . . @ . . . @ @ . . . @ . @ . @ . . . 
@ . @ . . . . @ @ . @ @ . . . . . . . . . . . . . . @ @ @ . . . 
. . . . . . . . . . . . @ . . @ . . . . . . . . . . . . . @ . . 
. . . . . . . @ . @ . @ . @ . @ . . . @ . . . . @ . . . . @ . . 
. . . @ @ . . . . @ . . . . . . . . . . . . . @ . . . . . . . @ 
. . . @ @ @ . . . . . . @ . . . . . . . . . . . . . . . . . . . 
20
20 22 1 18
29 4 0 25
1 22 1 13
17 6 5 4
31 12 4 3
3 11 27 30
21 6 11 18
13 2 29 0
24 1 14 31
10 30 10 23
24 25 20 9
19 8 21 22
7 16 10 9
16 11 16 11
19 14 29 14
30 23 18 0
6 22 22 7
11 2 23 26
27 8 22 14
6 24 10 22
