32 32
@ . . . @ @ . @ . . . @ . . . . . @ @ . . . . . . @ . . . @ . . 
@ @ . . . . . . @ . . @ @ . . . @ . . . . . . . . @ . . . . . . 
@ . @ . @ . . . . . @ . . . @ . . . @ . @ . @ . . . . . . @ . . 
. @ . . @ . . . . . . . . . . . @ @ . . . . . . . @ . . . @ . . 
. . . . . . @ . @ . . . . @ . . @ . . . . . . . . . . . . . . . 
. @ . . . @ . . . @ @ . . . . @ . . . . . . . . @ . . . . . . . 
. . @ . . . . . . . . . . . . . @ . . . . . @ . . . . . . . @ . 
. . . . . . . . . . . @ . . . @ . . . . . . . . . . @ . . . . . 
. . . . @ . . . . . . . . . . . . . . . . . @ @ . . @ . . . . @ 
. . @ . . . . . @ . . . . . . @ . . . . . . . . . . . . . . . . 
. . . . . . . . . . @ . . . @ . . . . @ @ . @ . @ @ . . @ . . @ 
. @ . . . . @ . . . . . . . . . . . . . . @ @ . . . . . . @ . @ 
. . . . . . . . . . . . @ . @ @ . . . @ . . . . . . . @ . . . . 
@ @ . . . . . . . . @ . . . @ . . . . . . . . . @ . @ . @ . . . 
. . . . @ . @ @ . . . @ . . . . @ . . . . . . . @ @ . . @ @ . . 
. . . . . . . . . . . . . . . @ . @ . . . @ . . . . . @ . . . . 
. . . . @ . . . @ @ . . . . . . . @ . @ . . . . . @ @ . . . @ . 
. . . . . . . . . . . @ . @ . . . @ . . . . . . @ . @ . . . . . 
. . . . @ . . . . . . . . . . . . @ @ @ . . . @ @ @ . . . . . . 
. . . . . . @ . . . . . . . . @ . . . . @ @ . . . @ @ . @ @ @ . 
. . . . @ . . . @ . . . @ @ @ . . . . @ . . . . . . . . @ @ . @ 
@ . . . . . . . . . . . . . @ . . . . . . . @ @ . @ @ . @ . . . 
@ . . . . . . . . . . . @ . . . @ . . @ . . . . @ @ @ . . . . . 
. . . . . . . @ . . . . @ . . . . . . . . . . @ . . . @ . @ . . 
. . . . . . . . . @ . @ . . . . . . . . @ . . . . . . @ @ . . . 
. . @ . . @ . . @ @ @ . . . . . @ . @ . . . . . @ @ . . . . . . 
. . . @ @ . @ . . . @ @ @ . @ . . . . . . . . . @ . . . @ . . . 
. . . . . . . . . . . . . . . . . . . . . . . . . . . . . . . @ 
. . . . . . . . . . . . . @ @ . . @ @ . @ . @ . . . . . . . . . 
. . . . . . . . @ @ . . @ @ . . . . @ . . @ . @ . . . @ . @ @ . 
. @ . @ . . . @ . @ @ . . @ @ . . . . . . @ . . . . . @ . . . . 
. @ . . . . @ . . . . . . . . . . . . . . . . . . . . . . . . . 
50
12 10 18 26
25 7 16 24
21 2 12 0
23 2 17 1
25 24 6 21
27 28 13 2
11 16 18 3
15 20 2 3
4 12 18 1
4 5 21 27
0 25 13 11
9 23 16 18
24 1 25 4
26 6 9 13
28 6 14 0
18 15 16 11
25 6 19 9
27 3 31 1
24 29 27 5
16 30 23 9
28 27 8 2
14 16 30 23
13 7 24 0
28 28 5 8
15 14 24 23
28 0 10 24
7 5 8 27
26 28 11 31
6 20 19 4
7 26 27 1
3 23 7 20
30 23 21 13
17 10 16 28
12 9 22 17
27 2 21 5
30 14 12 24
20 30 9 21
2 11 0 12
28 3 3 20
17 12 21 0
23 27 24 30
21 18 2 15
24 20 20 1
12 28 31 12
28 15 26 9
9 12 21 14
13 12 4 13
1 17 4 4
18 9 2 18
26 3 20 13
