32 32
. . . . @ . @ . @ . . . . . . . . . . . @ . @ . . . @ @ . . . . 
@ . @ . . . . . . . . . . . @ . @ . . . @ @ . . . . @ @ . . @ . 
@ . . @ . . . . @ . . . . . . . @ . . . . . . @ . @ . . . @ @ . 
. . . . . @ . @ . . @ . @ . . . . @ . . . . . . . . . . . . . . 
. . @ . . . . . . . . . . . @ @ @ @ @ . . . . . . . . . . . . . 
@ . . . . . . . . . . . . . . . . @ . . . . . . . . . @ . . @ . 
. . . . . . . . . . . . @ . . . . @ . . . . . . . . . . . . . . 
. @ . . . @ . . . . . . @ @ . . . . @ . . . . . . @ . . . . . @ 
@ . . @ . . . . . . . . @ . . . . @ . . @ . @ . . . . . . . . @ 
@ . . . . . @ @ @ . . @ . . @ . . . . @ @ @ . @ . . . . @ . @ . 
. . . . . . @ @ . @ @ @ . . . @ @ . . . @ . . . @ . . @ @ . . @ 
@ . @ . . @ . . . . . . . . . @ @ . . . . @ @ . . . . . . . . . 
. . . . . . . . . . @ . @ . . . . . . . . . @ . . . @ . @ . @ . 
@ . . . . . @ @ . . . . . . . . . . . . . . @ . . . . . @ . . . 
. . . . @ . . . @ . . . @ . . . . . @ . . . . . . . . . . . @ . 
. . . . @ . . . . @ . . . . . . . . . . . @ . . . . . . . . . . 
. @ . @ . . . . . . . . @ . . . . . . . . . @ . @ . . . . . . . 
. . . . . . . . . @ . . . . . . @ . . . @ . . . @ . . . @ . . . 
. . @ . . . @ @ . . . . . @ @ . . @ @ . . . @ . . @ @ @ . @ @ @ 
. . @ . @ . . . . @ . . . . . . @ @ . . . . . . @ @ @ @ @ . . @ 
. . . @ . . . . . . . . . . . . @ @ . . . . . @ . . @ . @ . @ . 
. . . . . . . . . . . . . . . . . . . @ @ . . @ . . @ . . . @ . 
. . . . . . . . . @ . . . . @ . @ . @ . . @ . . @ @ . @ @ . . . 
. . @ . . . . . . @ . @ . . . @ . . @ . . @ . . . . . @ . . . . 
. . . . . . . . . . . . . . @ . . . . . . . @ . . . . @ @ . . . 
. . @ . @ . . @ @ . . @ . . . . . . . . . @ . . . . . . . @ . . 
. @ . . . . . . @ . . . . . . . . . . . @ . . @ @ @ . . . . @ . 
. . . . . . . . . . . . . . . @ . . . @ @ . . . . . . . . . . . 
. . @ . . . . . . @ . . @ . . . . . . . @ . . . . . . . . . . . 
. . . . . @ . @ . @ @ . . @ . . . . . . . . . . . . . . . . . . 
. @ . @ . . . . @ . . . . . . . . . . . . . @ . . @ . . . . . . 
. . . . . . . . . . . . . . . . . . . @ . . . . . . . . . . . . 
20
13 6 11 12
13 15 21 28
4 16 2 0
8 3 22 27
13 0 25 8
19 2 18 17
15 21 24 0
11 29 2 21
27 16 11 7
5 8 28 2
14 15 12 18
24 9 18 11
7 31 19 6
22 20 29 3
0 14 29 27
10 2 24 13
4 29 27 2
29 10 6 26
17 23 6 3
9 16 17 21
