32 32
. @ . . . @ . . @ . . . . . . . . . . @ @ @ . . . @ . . . @ . . 
. . . . . @ . . . @ @ . . . @ @ @ @ . . . @ . @ @ . . . . . . @ 
. . . . . . . . . @ . . @ . @ . . . . . . @ . @ @ . @ . . . . . 
. . . . . . . . . . . @ . . . . . . . @ . . . . . . . . . . @ . 
. @ . . . . @ . . . . . . . . . . . . . . . . . . . . . . . . @ 
. . . . . @ . @ . . . . @ @ . . . . . . @ . . . @ . @ . . . @ . 
. @ @ . . . . . @ . . . . . . . @ @ . . @ . . . . . . . . . . . 
. . . . . . . . . . . @ @ . . . . . . . . . . . . . . @ . . . . 
. @ @ @ . . . . @ @ . . . . @ . . . . @ . . . . @ . @ . . @ . @ 
. @ @ . @ . . . . . . @ @ . . . @ . . . . . @ . @ . . . @ @ . . 
. . . . . . @ . . . . . . @ . @ . . . . @ . . @ . . . @ @ . . . 
. . . @ . @ . . . . @ . . @ . . @ . . . . . . . . . . . @ . . @ 
. . . @ . . @ . . . @ . . . . . . . . . . . @ @ @ . . . . . . . 
. . . . @ . . @ . . @ . . @ . . . . . @ . . . . . . . @ . . . . 
. . . . @ . . . . @ . . . @ . . . . . @ @ . . . . . . @ @ . . . 
. @ . . . . . . . . @ @ . . . @ . . . . . . . . . . . . . . @ . 
. @ @ . . . . . . . . . . . . . . . . . @ @ @ . @ . . . . . . . 
. . . @ . . . . . . . . @ . @ . . . @ . . . . . @ . . . @ . . . 
@ . . . . . . . . . @ @ . . @ . . @ . . . . . . . . . . . @ @ @ 
@ . . . . . . . . . . . . . . @ . . . . . . @ @ . . . . @ . . . 
@ . . @ . @ . . . . . . @ @ . . . . . . @ . . . . . . @ . . . @ 
@ . @ . @ @ . . . . . . . . . . @ . . . . . . . . . . . . . . . 
. . . @ . . @ . . . . . . . . . @ . . . . . . . . . . @ . . . @ 
. . . @ . . . . . . . . . . . @ . . . . . . . . . . . . . . @ . 
. @ . @ . . . @ . . . @ . . @ . . . . . . . @ @ . . . . @ . . . 
. . . . . . @ . . . . . . . . @ . . . . . . . . . . . . . . . . 
. . . @ @ . . . . . . . @ . . . . . @ . @ . . . . @ . . . . . . 
. . . . . . . . . . . . . . . . . . . . . . @ . . . . . . @ . . 
. @ @ . @ . @ @ . . @ . . . . . @ . . . . . . @ . @ . . @ . . . 
. . . . . . . . . . @ . . . . . . @ . . . @ . . . . @ . @ @ . . 
. . . . . . . . . @ . . . . . @ . . . . . . . @ @ @ . . . . @ . 
. . @ @ . @ @ @ . . . . @ @ . . . . . . @ . @ . @ . . . . . . . 
20
4 6 29 12
23 21 30 6
23 22 0 30
7 9 31 12
2 23 0 28
6 8 24 7
1 20 22 11
25 16 13 12
17 24 26 19
19 17 4 0
10 26 20 9
7 30 26 27
24 15 0 15
16 29 6 13
25 24 0 4
20 23 9 21
2 12 24 20
16 16 15 8
4 10 21 11
30 0 19 15
