32 32
. @ . . . . . . . . . . @ @ . . . . . . . . . . . . . . . . . . 
. . . @ . . . . . . . @ . . @ @ . . . . @ . . . @ . . . . . @ . 
. . . . . @ @ . . . . @ . @ . . . . . . . . . . . . . . . . . . 
. . @ . . . . . @ . . . @ . . @ . . . . @ . . . . . . . . . . . 
. @ @ . . . . . . . . . . . . @ . . . . @ . . . . . . . . @ . @ 
. . . . . . . . . @ . . . . . . . @ . . . . . . . . @ . @ . . . 
. . . . . . . @ . . @ . . . . . . @ @ . . . . . . . . . . . . . 
. . . . . . . . . . . @ . . . . . @ . @ @ @ . . @ . . . . . . . 
. . @ @ @ . . @ . . @ . . @ . . . . @ . . . . . . @ . . . . . . 
. . @ @ @ . . . . . @ @ . . @ . @ . . . . . . . @ . . @ . @ . . 
. @ . . . . . . . @ @ . . @ . . @ . . . . . @ @ . @ . . . . . . 
@ @ . . . . . . . . . . . . . . @ @ @ @ . @ . . @ . . . . . . . 
. . . @ . . . . . @ . @ . . . . . . . . @ . . . . . . . . @ . . 
. . . . . . @ @ . . . . . . . . @ . . . . @ . . . @ . @ . . . @ 
. . . . @ . @ . @ . @ . . @ @ . . . . . . . . . . @ @ @ . @ . . 
. . . @ . . . . @ . . . . . @ @ @ @ . . . . . @ . . . . @ . . . 
@ @ . . @ . . @ @ @ . @ . . . . @ . . . . . . . . . . @ . . @ @ 
. @ . @ . . @ . . . . . . . . . . . . . . . . . . . . . . . @ . 
. . . @ . @ . . . . . @ . . @ . . @ @ . . . @ . . . . . @ . . . 
@ . . . . . @ @ . . . . @ @ . . . . . . . . . . . . @ . . . . . 
. . . . . @ . . . . . . @ . @ . . . . . . . . . . . . . @ . . . 
. . . . @ . . . . . . . @ . . . . . @ . . . . . . . . . @ . . . 
. . . . . @ . @ . . . . @ . . . . @ . . . . . . . . . . . . . . 
. @ . . . . @ . . @ . . . . @ @ @ . @ . . . . . . . . @ . . @ @ 
. . . @ . . . . . . @ . . @ @ . . . . . . . . . . @ . . . . . . 
@ . . . . . . @ . . . . . . . . . . . . . . @ . @ @ . . . . @ . 
. . @ @ . . . . . . . @ . @ @ . . . . @ . . . . . @ . . . @ . . 
. @ . @ . . . . . . . @ . . @ . @ @ . . . . . . . . . . . . @ . 
. @ . . @ . . . . . . @ . @ . . . @ @ . . . @ . @ . . . @ . @ . 
. . . . . . . . . @ . . . . . . . . @ . . . . . . . . . . . . . 
. . . @ . @ . . . . . . @ . . . . . . . . @ . . @ . @ . . . . . 
. @ . . . @ . . . @ . . . . . . . @ . . . . . . . @ . @ . . . . 
10
31 24 6 5
28 19 19 22
13 5 17 20
2 30 25 16
6 6 4 19
30 4 2 21
23 28 9 0
18 31 2 7
29 24 7 30
17 23 31 12
