32 32
@ . . . . . @ . @ @ @ . . . . . . . . @ . . @ . @ @ . . . . . . 
. . . @ . . . . . @ . @ . . @ . . @ . . . . . . . . . @ . . . @ 
@ . . @ @ . . . . @ . . @ . @ . @ . . . @ . . @ @ . . . . . @ . 
. . . @ . . . . . . . . . . . . . . . . @ . . . . @ . . @ @ . . 
. . @ . . . . @ . @ . . . . @ . . . . . . . @ . @ . @ . . . . @ 
. . @ . . . . . @ . . . . . . @ . . . . . . . @ . @ . . . @ . . 
. . . . @ . @ . . . . . . . . . . . . . . . . . . . . . . . . . 
. . . . . . . . . . . . . @ . @ . . . . @ @ . . . . . . . @ . . 
. . . . . . @ . . @ . . . @ . . @ . . . @ . . @ @ . . . . . . . 
@ . . . . . . . . . . . . . @ . . . . . @ . . . . . . . . . . @ 
. . @ . . . . . @ . . @ . . . . . @ . @ . . . . @ . . . . @ . . 
. . . . @ . . @ . . . . . . . . . . . . . . . . @ . . . . . . . 
. @ @ . @ . . . . . . . . . . . . @ @ . . . . . @ . . . . @ . . 
. . @ . . . . @ . . . . . . . @ @ . . . @ . . . . . . . . @ . . 
. . @ . . . @ @ @ . . . . . . @ . . . . . . . . . @ . . . @ . . 
. . . @ . . . @ . . . . . . . . . . . @ . . . . . . . . . . . . 
@ . . . . . @ . . . . . . . @ . . . . . . . . . . . . . . . . @ 
. . . . . . . . . @ . @ . . . . @ . @ @ . @ . . . @ @ . . . . . 
. @ . @ . @ . . . @ . @ . @ . . . . . . . . @ . . . . . @ . @ @ 
@ . . . . . . . . . . @ . @ . @ . . . @ . . . . . . . . . . . . 
. . . . . . . . . . @ . @ . . . . . . . . . @ . . @ . . . @ . . 
. . . @ @ . . . . . @ . @ . . . @ . . . @ . . . . . @ . @ . . . 
. . . . . . . @ . . . @ . . . @ . . @ . . . . . . @ . . . @ . . 
. . . . . . . @ @ . . . . . @ . @ . . @ @ . @ . . . @ . . . . . 
. . . . . . . . . . . . . . @ . . . . . . @ . . . @ . . . . . . 
. . @ . @ @ . . . . . . @ . . . @ @ . @ @ . . . . @ @ . . . . . 
. . . . @ . . @ . . @ . . . @ . @ . . . . . . . . . . . . . . . 
. . . . . . . . . . . . @ . . . . . . . . . . @ . . . . . . . . 
. . . . @ . . . . . @ . . @ . . @ . . @ . . . . @ @ . . . . . . 
. @ . @ . . @ . . . . @ . . @ . @ . @ . . . . . . . @ . . . . . 
. @ . @ . . . . . @ . . . . @ . @ . . . . . . . . . . . . . @ . 
. @ . . @ @ . @ @ @ @ . . @ . . . @ . @ . . . . @ . . . . . @ . 
50
26 1 31 21
1 7 3 4
25 13 22 27
21 5 17 16
19 5 3 25
24 19 23 28
4 8 12 1
27 3 27 7
13 4 27 10
11 5 16 6
23 10 10 2
5 15 14 14
5 22 11 3
7 3 19 4
0 20 16 20
25 11 13 1
12 10 6 11
14 0 28 31
31 11 18 21
12 29 24 27
14 27 12 9
21 12 6 7
4 30 22 14
9 26 20 17
28 15 19 13
26 3 0 13
1 23 7 28
12 30 27 5
28 30 3 24
15 27 10 1
4 14 0 23
22 5 2 31
8 16 15 30
11 9 10 5
28 1 27 16
24 24 5 23
17 26 2 29
28 22 17 4
12 5 4 18
6 25 14 13
27 11 3 11
18 25 18 9
22 19 10 25
26 27 15 10
16 22 24 30
29 9 7 29
28 17 8 11
12 12 21 16
8 13 3 5
2 29 23 1
