32 32
. . . . @ . . . . . . . . . . . @ . . . @ @ . . . . . . . . . . 
. . . @ . . . . @ . . . @ @ . . . . . . . . . . . . @ @ @ @ @ . 
. . . . . . @ @ @ . . . . . . @ . @ @ . @ . . . . . . . . @ . . 
. @ @ . . . . . @ . . . . . @ . . @ . . . . @ . . . . . . @ . . 
@ . . @ . . . . . @ . . @ . . . . . @ @ . . . . @ . . . @ . @ . 
. . . . . @ . . @ . . @ . . @ . . . @ . . . . . . . . . . . . . 
. . . @ . @ @ @ . . @ . @ @ . . . . . . . . . . . . . . @ . . . 
. @ . @ @ . . . . . . . . . @ . . . . . . @ . . . . @ @ . @ . @ 
. . . . @ @ . . @ . . . . . @ . . . . . @ @ . @ . @ . . . . @ . 
. @ . . . . @ . . . . . @ . . . . @ . . . . . @ . . @ . . . . @ 
. . . . . . . . . . . @ . . . . . . @ @ @ . @ . . . . . @ @ . . 
. . @ . . . . . . @ @ . . . . . . . . . @ . . . . . . . . . . . 
. . . . . . . . . . . . . . . . @ @ . . . . . . . . . @ . . . . 
. @ @ . . . . @ . . @ . . . @ . . . . . . @ . . . . . . . . . . 
. @ . . . @ . . . . @ . @ . . . . . . . . . . . . . @ . @ . . . 
. . . @ . . . . . . . @ . . . @ @ . . . . . . . @ . . . . . . @ 
@ . . . @ . . . . . . . . . @ @ . . . . . . . @ . . . . . . . . 
@ @ . . . . @ @ . . @ . . . . @ . . . . . . . . . . . . @ . . . 
. . @ . . . . . . . . @ . . . . . . . . . . . . . . . . . . @ . 
@ . . @ . . . . . . . . . . @ . . . . . . @ . @ . . @ . . . . . 
@ . @ . . . @ . . . . . . . . . . . . . . @ @ . @ . . . . . . . 
. . @ . . . . @ @ . . . . . . . . . . . . . . . . . . . . . . @ 
. @ . . . . . . @ @ . @ . . . . . . . . . . @ . . . @ @ @ @ . . 
. . @ @ . . . . . @ . @ . . . . . . . . @ . . . @ . . . . . @ . 
. . @ . . . . @ . . . . . . . . . . . . . . . . @ . @ @ . . . . 
. . @ . . @ @ . . . . @ . . . . . . . @ . . . . . . . . . @ . . 
@ . . . . . . . . @ . @ . . . @ . @ @ . . . . . . . . . @ . . @ 
. . . . . . . . . . . @ . @ . . . . . . . . . . . @ . . . . . . 
. . . . . . . . . . . @ @ @ . . . . . . . @ @ . . . . @ @ . @ . 
. . . . . . . . . . . . . . . . . . @ @ @ . . @ @ . @ . @ . . . 
. . . . . . . . @ . . . @ . . . . . . . . @ . . . @ . . . . . @ 
. . @ . . @ . . . @ . . . . . . . . @ @ . . . @ . . @ . @ . . . 
50
15 14 4 28
4 20 24 18
26 21 30 21
29 16 11 1
17 21 15 1
23 17 3 10
19 15 4 3
14 14 13 20
18 19 10 31
8 24 5 4
23 23 3 31
18 16 14 2
2 17 21 16
19 22 28 18
22 17 8 31
3 21 18 28
24 12 13 10
20 28 14 22
31 2 25 18
4 2 7 19
20 17 30 26
2 29 24 1
18 6 6 14
1 11 29 29
14 21 0 24
8 7 9 12
19 27 26 26
11 0 30 2
7 10 16 16
21 25 29 4
11 19 27 9
24 1 3 27
2 10 8 19
21 9 24 26
21 4 4 6
20 19 16 6
15 25 22 18
23 7 21 21
13 30 17 4
10 0 2 14
24 3 20 13
20 16 28 16
11 2 21 6
12 0 29 23
31 31 11 6
27 31 16 27
7 12 27 30
23 24 31 29
17 27 31 1
15 19 9 21
