32 32
. . . . @ @ @ . . . @ . . . . @ . . . . . . . . . . . @ . . . . 
. . . . . . . . . . . @ @ . @ . . . . . . . . . . @ . . . @ . . 
@ . . . . . @ . . . . . . . . . . . . . . . . . . . . . . . . . 
@ . . . @ . . . . . . @ . . . . . . . . . . @ . . . . . @ . @ . 
. @ . . . . . @ . . . . . . @ @ . . . . . @ . . . . . . . . . . 
. @ . @ . @ @ . . . . . . @ . . @ . @ @ . . . @ . . . . . . . . 
. . . . . . . . . @ . . . . . . . . . . . @ . . . . @ . . @ . @ 
. . . . @ @ @ @ . . . . . @ . . . . @ . @ . . . @ @ . . . . @ @ 
. . . @ . . . . . . . . . . . . . . . . @ . . . . . . . . . . @ 
. . . . . . . . . . . . . . @ . . . . . . . @ . . @ . . @ . . . 
. . . . . . . . . @ @ . . . . . @ . . . . . @ . . . . . . . . . 
. . . . . . @ . . . . @ . . . . @ @ . . . . . . . . @ . . . @ . 
@ . @ @ . . . @ . . @ . . . @ . . @ . . @ . . @ @ @ . . . @ . . 
@ . . @ . . @ . . . . . . . @ . . . @ @ . . . . . . . . @ . . . 
@ . . @ . @ . . . . . . . . . . . . . @ . . @ . . . . @ @ . . . 
. . . @ @ . . . . . . . @ . @ . . . . . . . @ . . . @ . . . . . 
. @ . . @ @ . . . . . . . . @ @ @ . . @ . @ . . @ @ . @ . . . . 
. . . @ . . . . @ @ . . . . . . . @ . . . . . . . . @ . . . . . 
. . . . . . @ . . . . . . . @ . @ . . @ . . . . @ @ . @ . . @ . 
@ @ . . . . . . . . . @ . . . @ . . . . . . . @ . . . . . . @ . 
. . . . . . . . . . . . . . . . @ @ . . . . @ @ @ @ . . . . . @ 
. . . . . . . . . . . . @ . . . @ @ . . . . . . . @ . . . . . @ 
. . . . . . . @ . . . . . . @ . . . . . . @ . . . . . @ . . @ @ 
. @ @ . . . . . @ @ @ . . . . . . . . . . . @ . . . @ . . . . @ 
. @ . . . @ . @ . @ . @ . . . . @ . . . @ @ . . . . @ . . @ . . 
. . . @ . . . . . . @ . . @ . . . . . @ . . . @ . . . @ . . . @ 
@ . . . . . . . . . . . . . . . . . . . . . . . . . . . . . . . 
. . . . . @ . @ . @ . . . . @ . . . . . . . @ . . . . . . . . @ 
. @ . . . . . . . @ . . . . . . . @ @ . . . . . @ @ . . . . @ . 
. . . . . . . . . @ . . @ . . . . @ . . @ . @ @ . @ . . . @ . . 
. . . . . . @ . . . @ . . . @ . . . . . . . . @ . . @ . . . . . 
@ . @ . @ . . @ . . . @ . @ . . . . . . . . . . . . . . . . . . 
70
14 28 17 23
29 27 0 25
15 25 30 12
5 2 0 29
1 12 2 22
8 20 18 19
1 1 20 21
30 31 18 18
15 13 12 5
20 14 21 14
13 4 12 14
27 24 23 26
13 30 0 1
13 15 11 18
26 10 29 0
18 8 1 31
29 26 6 27
20 16 28 31
29 0 5 11
7 21 14 8
17 30 9 22
1 2 31 12
1 26 25 25
28 8 20 0
19 24 3 11
14 2 9 12
16 26 18 22
23 4 26 10
14 5 9 30
14 31 6 8
7 20 12 17
8 1 17 24
31 12 0 7
25 17 26 8
18 22 11 10
4 14 6 17
30 17 9 19
27 29 6 14
23 11 29 17
28 5 29 26
29 4 8 7
8 3 30 24
6 12 16 27
26 8 25 10
0 17 17 18
6 23 30 27
23 6 26 31
3 9 22 6
8 22 7 18
21 28 8 14
20 3 10 3
28 20 11 12
18 11 26 9
19 17 21 19
9 22 31 10
7 26 24 0
29 5 29 5
11 16 2 15
4 19 0 0
13 24 4 18
9 4 10 29
8 5 22 12
29 15 19 6
24 3 21 1
10 13 4 14
8 31 27 15
13 8 15 12
9 20 24 31
15 11 3 16
13 18 13 14
