32 32
. . . . . . . . @ . . @ . @ . . @ . @ . . @ . . @ . . . . . . . 
@ . @ . . . . . . . . . . . . . . . . . . @ . . @ . @ . . . . . 
. . . . @ . . . @ . @ . . . . . . @ . . @ @ . @ @ @ . . @ . . . 
. @ . @ . . . . . . . . . . . @ . . . . . . . . . . . @ . . . @ 
@ . . . . . @ @ . . @ . @ . . . . . @ . . . . . . @ . @ . . . . 
. . . . . @ . . . . . . @ . . . . . . . . . . . @ . @ @ . . @ . 
. . . . @ . @ . . . @ . @ . . . . @ . . . . . . @ . . @ . . . . 
. . @ . . . . . . @ . . @ . . . . . @ . . . . . . . . . . . . . 
@ . . . . . . @ . . . . . . . . . @ . . @ . . . . . . @ . . . . 
. . . . @ @ @ @ . . @ . @ . @ . @ . @ . . . . . @ . . @ @ @ . . 
. @ . . . . . @ . . . . . @ . . . . @ . . @ . . . . . @ . . . . 
. . . . @ . . . @ . . . @ . . . . . . . . . . . . . . @ . . . . 
. . @ . @ @ . . @ . . . . . . . @ . . . . . . . . . . . . . . . 
. @ . . . @ . . @ . . . . @ . . . . @ . . @ . . . @ . @ . . . @ 
@ @ @ . . . . . . . . . @ @ . . . . @ . . . . . . @ . . @ @ @ . 
. . . . . . . . . . . . . . . . . @ . . . @ . . . @ . . . . . . 
. . @ . @ . @ . @ . . . . @ . @ . . . . @ . . . @ . . . . . @ . 
@ . . @ . . . . @ . . . . . . . @ . . . . . . . . . . @ . . . . 
@ @ . . . . . . . @ @ . . . . . . . . . . . . @ @ . . . @ . @ . 
. . @ . @ . . . . . . . . @ @ . . . . . . . . @ . @ . . . . . . 
. @ . . . . . . . . . . . . @ . . . . . . . . . . . . . . . . . 
. . . @ . . . . . . . . . @ . @ . . . . @ . . . . . . . . . . . 
. @ . . . . @ @ . . . . . . . @ . . . . . . . . . . . . @ . . @ 
. @ . . . . . . . . . . @ . @ . . . . @ . @ @ . . @ . @ . . . @ 
@ . . . . @ . . . . . . . . . @ . . . . . @ . . @ . . . @ . . . 
. @ . . . . @ @ . . . . . . . . . . . . . . @ . . . . @ . @ . . 
. @ @ . . . . . . . . . . . . . . @ . @ . . @ . . . @ . . @ . . 
. . . . . @ . . . @ . . . . . . . . . . . @ . . . . @ @ @ @ @ . 
. . . . . . . . . @ @ . @ . @ . . . . . . . . . . . . . . @ . . 
. . . . @ . . @ . . . . @ @ . . . . . . . . @ . . . . . . . . . 
. . . @ . @ . @ . . . . . . . . . . . . @ . . . @ @ @ . . . . . 
. . . . . . . . . . . . @ . . . . . . . . . . . . . . @ . . @ @ 
60
13 20 11 4
15 19 26 8
13 11 30 29
30 20 24 14
15 9 19 24
3 27 1 24
4 5 8 18
29 18 29 17
26 20 7 6
28 7 28 20
31 11 9 2
19 28 4 23
15 7 27 14
17 29 8 29
19 2 19 17
20 18 28 23
13 17 3 9
21 16 30 2
8 18 17 28
28 17 6 15
20 4 8 25
18 5 13 5
21 30 19 12
11 18 12 26
5 20 5 18
0 27 22 18
5 17 19 8
16 10 3 16
30 4 20 28
19 13 7 12
30 6 10 1
24 15 19 14
0 31 4 5
22 6 10 12
18 31 7 15
25 8 26 29
27 0 0 15
13 7 30 30
6 20 2 18
28 28 4 20
14 17 4 3
31 5 27 16
7 13 1 28
15 5 7 11
5 23 19 28
9 14 1 4
6 31 18 23
3 29 0 27
15 12 20 7
12 27 22 15
8 31 7 17
12 16 23 7
11 11 14 10
10 31 13 18
28 21 7 13
12 18 19 13
30 22 17 12
4 21 20 3
2 17 16 20
24 20 6 28
