32 32
. . @ . . . . . . . . @ . . . @ . . . . @ . . @ . . @ . . . . . 
. . . . . . . . @ @ . @ . . . . @ . @ . . . @ . . . . . @ . . . 
. . . @ . @ . . @ . . . . . . . @ . . . . @ . . . . . . @ @ . . 
. . @ . . . . . . . . . . . @ . . . . @ . . @ . . . . . . . @ . 
. @ . @ . . . . . . . . . . . . . . . . @ @ . @ . . . . . . . . 
. . . @ @ . . . . . . . . . . . . . . . . . @ . @ . . @ @ . . . 
@ . . . @ . . . . . . @ . . . . . . . @ . @ @ . @ . . . . @ . . 
@ @ . . @ . @ @ . . . . . . . . . . . @ . . @ @ . . . . . . . . 
. . @ . . . . . . . . . . . . . . . @ @ . . . . . . @ . . @ . . 
. . . . . . . . . . . . . . . . . . . . @ @ . . . @ . @ @ . . . 
@ . @ @ . . . . @ . . . . . . . . @ . . . @ . . . . . . . . @ . 
@ . . . . . . . . . . . . . . . . . . @ @ . . . . . . . . . . . 
. . . . . . @ . . @ @ . . @ . . @ . . @ . . @ @ @ . . . . . . . 
@ . . . . @ . @ . . . . . . . . @ . . . . . . . . . . . @ . . . 
@ . @ . . . . . @ . . . . . . . @ . . @ @ . . . . . @ . . . . . 
@ . . . . . @ . . . . . . . . . . . @ . . . . . . . . @ . . . . 
@ . @ . . . . @ . . . . . . . . @ . . . @ @ . . . @ @ . . @ @ . 
@ . @ . . . . . . . . . @ @ . . . . . . @ . . . . . . . . @ . @ 
. . . . . . . . . . . . . . . @ . . . . . . @ . . . . . . . @ . 
. . . . . . . . @ . . . . @ . . . . . . . . @ . . . . . . . . @ 
@ @ @ . . . @ . . . @ . @ . . . . . . . . . @ . . @ @ . . . . . 
@ . . . @ . . . . . . . . . . @ . . . . . @ @ . @ . @ . . . . . 
. . @ . . . @ @ . . . . . . . @ . . . . . . @ . @ . @ . . @ @ . 
@ . @ @ . . . . @ . . @ @ . @ . . @ . . . . @ . . @ . . . . . . 
. . . . . . . . @ . . . . . . @ . @ . . . @ . . . . . . . . . @ 
. . @ . @ . . @ . . . @ . . . . . . . . . . . @ . . . . . . . . 
. @ . . . . . . . . . . . . . . @ . @ . . . . . . . . . @ . . @ 
. @ . @ . . . @ . . @ . . . . . . . @ . . . . @ @ . . @ @ . . . 
. . . . . . @ . @ @ . . . . . . . @ . . . . . . . . . . . . . . 
. . . @ @ . . . . @ . . @ . @ @ @ . @ . . . . . . . . . . . . @ 
. . @ . . @ . . . @ . . . . . . . . . @ . . . . . . @ @ . . . . 
@ . . . . . . @ . . . . . . . . . . . @ . @ . . . . . @ . . . . 
60
27 22 21 8
19 26 15 20
2 12 18 6
3 26 27 6
29 12 7 0
27 18 31 23
13 14 31 10
28 18 5 4
14 9 12 13
9 3 19 15
6 27 27 25
18 2 5 18
28 6 8 31
29 1 22 17
15 19 16 17
7 9 17 2
7 3 0 3
1 25 26 7
19 16 9 21
24 17 11 16
30 1 28 4
27 24 31 6
31 1 31 2
16 5 19 0
30 23 15 10
25 15 0 19
26 29 28 16
19 10 3 6
2 28 24 1
31 11 2 12
31 22 12 9
28 22 5 3
29 14 13 30
31 28 26 31
17 16 21 13
20 22 16 24
30 5 16 7
31 12 31 15
23 14 25 5
25 19 9 20
23 23 1 2
15 11 13 1
13 29 31 5
26 28 23 15
31 5 11 24
13 20 2 18
13 27 23 16
20 1 10 21
15 7 17 4
28 17 3 7
4 12 0 2
29 24 16 8
29 29 17 5
26 18 17 1
9 31 17 30
2 24 15 15
17 19 12 1
6 6 0 22
10 26 16 10
12 1 15 3
