32 32
. . . . . . . @ @ . . . . . . . @ . . . @ . . . . . . . . @ . . 
. @ . . . @ . . @ @ @ @ . . . @ @ . . . . . . . . . . . . . . . 
. . . . . . . . @ . . . . . . . . . . . . . . . @ . @ . . . @ . 
. @ @ @ @ . . . . @ @ . . . . . . . @ . . . . . @ . . @ . . . . 
. . . . . @ . . . . . . . . . . @ . . . . . . . . . . . @ . . . 
. @ . . @ . . . . . . . . . . . . @ . . @ @ . . . . . . . . . . 
. . . . @ @ . @ . . . . . . . . . @ . @ . . . . @ . . @ . . . . 
. . . . . @ . . . @ . . . . . . . . . . @ . . . . . . . . . . . 
@ . . . . . @ . . . . @ . . @ . . . . . @ . . . @ @ . . . . . . 
. . . . . . . @ . . . . . . . . . . . . . . . . @ . . . . . . . 
. . . . @ . . . . . . @ . . . . . . . . . . @ . . . . . . @ @ . 
. . . @ . @ . . . . @ @ @ . . . @ @ @ . @ . . . @ @ . . . . . . 
. . . . . . . . . @ . @ . . @ @ . . . . . . . . . . . . . . . . 
. @ . . @ . . . . . . . . @ . @ . . . . . @ . @ . . . . . . . . 
. . @ . . . . . . @ . . . . . . . . . . . . . . . . @ @ . . @ . 
@ . . . . . . . @ . . @ . . . . @ . . . . @ @ . . . @ . . @ @ . 
. @ . @ . . . . . . @ @ . . . . . . . @ . . . . . . . . @ . . . 
@ . . . . . . . . . . . @ . . . @ . . . . . . @ @ . . . . . . . 
. . @ . . . . . . . . . . . @ . . . . . . . @ @ . . . . . @ . . 
. . . . . . . . . . @ . @ @ . . @ @ . @ . @ . . . . @ . . . . @ 
. . . . . . . . . @ . @ . . . @ @ @ . @ . @ @ . . . @ @ . . . . 
. . @ . . @ @ . . @ . . @ . @ @ . @ . . . . . . . . . . . . . . 
. . . . @ . . . @ . @ . . . . @ . . . . @ . . @ @ . @ . . . . . 
@ . @ . . . @ . . . @ . @ . . . @ . . @ . . . @ . . . . . @ . @ 
@ . . . . . . @ . . . . . . . . . @ @ . . . . . . . . . @ . @ @ 
@ @ . . . . . @ . . . . . . @ . . . . @ . . . . . . . . @ . . . 
. @ @ . . . . . . . . @ . . @ . @ . . . . . @ @ @ . . . @ . . . 
. . . . . @ . @ . @ . . . . . @ . @ @ . . . . . . . . . . . . . 
. . . . . . . . . . . . . . . . . . . . . @ . . @ . . . @ . . . 
. . . . . . . . . . . . . . . . . . . . @ . . . . @ . . . . . @ 
@ . @ . . . @ . . @ . . . . . . . @ . . @ . . @ . . . . . . . . 
. . @ . @ @ . . . . @ . . @ @ . . . . @ . @ . . . . . . . @ . . 
70
23 2 21 3
9 22 1 15
26 16 7 11
8 31 15 10
26 28 14 23
4 9 13 6
9 23 9 4
22 24 13 10
31 2 11 0
15 26 29 21
19 14 31 21
27 4 3 28
3 21 6 5
20 17 5 29
16 5 9 8
7 17 30 30
3 20 7 22
9 16 8 9
18 5 31 0
27 12 21 9
11 14 8 16
15 18 29 7
12 8 11 21
4 7 23 27
5 12 7 26
18 6 13 0
13 9 26 18
5 5 10 4
5 13 1 22
4 28 14 20
10 24 15 7
30 25 12 12
16 10 4 21
12 14 29 27
24 20 7 21
30 29 22 29
8 20 18 17
2 12 19 4
3 4 2 11
31 0 23 4
25 27 15 19
10 0 8 31
30 6 14 14
19 12 16 3
25 19 4 18
8 10 20 15
25 16 9 28
12 30 11 19
12 16 13 3
16 28 23 29
7 26 6 11
23 12 27 24
30 18 18 23
10 5 15 8
3 26 10 7
13 3 18 14
8 9 28 15
11 2 16 16
2 20 11 27
12 3 22 30
22 7 20 25
27 8 9 17
23 4 10 26
28 19 10 30
30 4 1 14
13 17 1 29
14 11 22 14
31 7 13 1
22 5 9 2
10 2 27 8
