32 32
@ . @ . @ . . @ . . . @ . . . . @ . . @ . . @ . . . . . . . @ . 
. . . @ @ . . . . . . . . . . . . . @ . . . . . . . . . . . . . 
. . @ . . . . @ . @ @ . . @ . @ @ . . . . . . . . @ @ . . . @ . 
. . . . . . @ . @ . . . . . . . . @ . @ . @ @ . . . . . . . . . 
. . . . . . @ . . . . . . . @ . @ . @ . @ . . . @ . . . . . @ . 
. . . @ @ @ . . . . @ . . . . . . @ . . . . . . . . . . . . . @ 
. . . . . . @ . . @ @ @ . @ . . . . @ . . . . . . . . . @ . . . 
. . . @ . . . . @ . . . . . @ . . . . . . . @ . @ . . . @ . . @ 
. . . . . . . . . . @ . @ . @ . @ . @ . . . @ @ . . . . . . . @ 
@ . @ . . . . . . . @ . . . . . . . . @ . . . . . . . . @ . . . 
. . . @ . . @ @ . . . @ . @ . . . . . . @ . . . . . . . . . . . 
@ . . @ @ @ . . . . . . @ @ . . . . . . . @ . . . . . . . . @ . 
. @ . . @ . . @ . @ . . . . . @ . . . . . . . @ @ . . . . . . . 
@ . @ . . @ @ . . . . . . . . . . . . . @ @ @ @ . . . @ @ . . . 
@ . . . . . . . @ . . . . . . . . . . . . . @ @ . . . . . @ . . 
. . . . . . . . @ . . . . . @ . @ @ . . . . . @ . @ . . . . . . 
. . . . . . . . @ . . @ . @ @ . . . . . . . @ @ @ . . . . @ . . 
. . . . . . . @ . . . @ . . . . @ . . . . . . . . . . . . @ @ . 
. . . . . . . . . . @ . . @ . . . . . . . . . . . . @ . @ . . . 
. . . . . . @ . . @ . . . . . . @ . . . . . . . . . . @ . . . . 
. . . . . . . . . . @ . . @ . . . . . . @ . . . . . . . . . . . 
. . . @ @ . . @ . . @ . . @ . . . . . . @ . . . . . . . @ . . . 
. . . . . . . . . @ . . . . . . . . . . @ . @ . @ @ . . . . @ . 
@ . . . . @ . . . . . @ . . . . . . . @ . . . . . . . . . . . . 
@ . @ . . . . . . . . . . . . . @ . . @ . @ @ . . . . . . . . . 
. . @ . . @ . . . @ . . @ @ . . . . . . . @ . . . . . @ . . . . 
@ . . . @ . . . . . . . . @ . . . . . . . . . . @ . . . . . . @ 
. @ . . . . . @ @ . . . . . . . @ . @ . @ . . . . . @ . . @ @ . 
@ . . . . . . @ . . @ . . @ . . . . . . . . . @ . . . . . @ . . 
. . @ . @ . . @ . @ . @ . . . . . . . . . . . . @ . . . . . . . 
. . . . @ . . . . . . . . . . . . . . . . @ . . . @ . @ @ . . . 
. . @ @ @ . . . . . . . @ . . @ . . . . @ @ @ . . . . . . @ . . 
10
27 23 18 17
2 10 12 2
24 9 15 24
29 30 4 18
13 9 3 15
23 2 9 18
0 15 9 13
9 18 31 18
4 2 10 10
23 22 29 23
