32 32
. . . . . . . @ . . . . . . . @ . . . . . . @ . . @ . . . . . . 
. . @ . . @ @ . . . . . . . . . . . @ . . . . . . @ @ . . . . @ 
. . . . . . . . . . . . . @ @ . . . . @ . . . . @ . @ . . . . . 
@ . . @ . . . . . . . . . . . @ . @ . . . . @ @ . . . . . . @ . 
@ @ . . . . . . . @ . . . @ . @ . . @ @ . . . . . . . . . . . . 
@ . . @ . . . . . . . . . . . . @ @ . . @ . . @ . . . . @ . . . 
. @ @ @ . . @ . . . @ @ . @ . @ @ . . @ . @ . . . @ . . . . . . 
@ @ @ . . . . . . . . . @ . . @ . . . . . . . . . . . . . . @ . 
. . @ @ . . @ . . . . . . @ . . . . . . . . . . @ . . . . . . . 
. . . @ . . . @ @ . . . . . @ . . @ @ . . . . . . . . . . . . @ 
. . . . . . . . . . @ . @ . @ . . . . . . . . . . . @ @ . . . @ 
@ . . . . . . . . . @ . @ . . . . . @ . . . @ @ . . . . @ . . . 
. . . @ . @ . . . . . . . . . . @ . . @ . . @ . . . . @ . . @ . 
. . @ @ . . . . . . . . . @ . . . . . . . . @ . . @ . . . . . @ 
@ . . . @ . . @ @ . . . . . . . . . . . . . . . . . . @ . . . . 
@ . . @ . . . . . . . . . . . . . @ . . . . . . . . @ . . . . @ 
. . . . . . . . @ . @ . @ @ . . . @ . . . . . . . . . . . . . @ 
. . . @ . . . @ . . . @ @ . . @ @ . . . . . . @ . . . @ . . . . 
. . . . . . . . . . @ . . @ . . @ @ @ @ . . . . . . . . . . . . 
. @ . . . @ . . . . . . . . . . . . @ . . . . . . @ @ @ . . . . 
. . . . . @ @ . . @ . . . . . . . . . @ . . . @ @ . . @ @ @ @ . 
@ . . . . . . @ . . . . . . @ . . @ . . . @ . . . . . . . . . . 
. . . @ . @ . . . . @ . . . . . @ . . . . . @ . . @ . . . . . . 
. . . . @ . . @ . . @ . . @ . @ . @ . . . . . . . . . . . . . . 
. . @ @ . @ . . @ . @ . @ . . . @ . . . . . . . . . . . @ . . . 
@ . @ . . @ . @ . . . @ . . @ . . . @ . . . . @ . . . . . . . @ 
. . . . . @ @ . . . @ . . . . @ . . . . . . . . . . . . @ . . . 
. @ . . . . . . . @ . . . . . . . . . . . . . . . . . . . . . . 
@ @ . . . . . . . . . . . . . . . . . . . . . . . . . . . . . . 
. . @ @ . . . . @ . . . @ . . @ . @ @ . . . . . @ . @ . . . . @ 
. . . . . . . . @ . . . . . . . . . . . . . . @ . . . . @ @ . . 
. . . . . . . @ . . @ . @ . . . . @ . . @ @ . @ . . @ . . . . . 
60
12 3 25 20
27 6 12 5
5 4 22 4
17 13 24 14
21 16 13 5
11 22 27 9
27 21 13 11
2 22 27 0
15 1 2 23
25 7 27 25
25 11 14 17
9 23 19 26
14 22 20 12
9 31 4 6
8 11 15 19
4 20 30 23
12 23 9 16
29 11 26 12
4 24 24 19
28 13 15 8
30 31 24 9
11 10 2 21
0 24 22 14
24 5 13 17
25 5 28 9
30 27 17 1
2 10 19 3
20 10 1 23
1 0 25 5
9 21 22 1
6 15 6 2
26 25 13 24
8 15 8 12
30 1 25 23
31 19 10 25
1 3 7 12
9 3 8 13
15 31 11 3
17 22 13 29
1 18 28 6
8 4 3 20
14 0 28 12
16 27 10 0
4 15 17 24
1 8 10 14
1 31 16 30
28 10 24 11
8 2 22 18
27 3 12 12
11 27 24 10
10 3 4 16
20 16 18 31
11 24 29 17
11 12 9 13
4 5 15 2
22 8 27 24
25 24 16 27
0 9 13 1
26 6 25 15
0 18 15 13
