32 32
. . . . . . . . @ @ . . . @ . @ . @ . . . . . . . . . . . @ . . 
@ . . @ . . . @ . @ @ @ . . . @ . . . . . . . @ . . @ @ @ . . . 
@ . . . . . . @ @ . . . . . @ . . . . . . . . . . . @ . . . . @ 
. @ . . . . . . @ @ . . . . . @ @ . . . . . . . . . . @ @ . . . 
. . @ . . . . . . . . . . . . . @ . @ . . @ . . @ . . . @ @ . . 
. @ . . . . . . . . . . . . . . @ . . . . . . . . . . @ . . . . 
@ . @ . @ . . . . . @ . . . . . . @ . . . . . . . . . . . . . . 
. . . . . . . . . . . . @ . @ . . . . . . . . . . . . . . . . . 
@ @ . @ . . . . . . . @ . . . . . @ . . . @ . . . . . @ . . . . 
. . . . . . @ . . @ . . @ . @ . . . . . @ . @ . . . . . @ . . . 
. . . . . . . . . . . . . . . . . @ @ . @ @ . . . . . . . . @ . 
. . . . . . @ @ . . @ . . . @ . . . . . . . . . . . . . . . . . 
. @ @ . . . . . @ . . . . . . . . . . @ . . . . . . . @ . @ . . 
. @ . . . . @ @ . . . . @ . . . . . . . . @ @ . . . . . . . . . 
. . . . @ . . @ . . . . . . @ . @ . @ . . . @ . . @ . . . . . . 
. . . . . . . . . . @ . @ . . . . . @ . . @ . . . . . . . . . @ 
. . . . . @ . . . . . . . . . . . . . . . . . @ . . . @ . . . . 
. . . @ . . @ @ . . . . @ . . @ . . . . . . . . . . . @ @ @ . . 
@ . . . . . . . . . @ . . . @ . @ . . . . . . @ . . . @ . . @ . 
@ . @ . . . . . . . . . . . . . . . . . . . @ @ @ . . . . . . . 
@ . . . @ @ . . . . . . @ . @ @ . . . @ @ @ . @ . . @ @ . @ . @ 
. . . . . . @ . . . . . . . @ . @ . . . . . . . . @ @ . . . . . 
. . . . . . . . @ . . . . . . . . . . . . . . @ . . . . . . . . 
. @ . . . . . . . . . . @ . . @ . . . . . . @ . . . . . . . . @ 
. . . . . @ . . . . . . . . . . . @ . @ . . @ . . . . . @ . . . 
. . . @ . . . @ . . . . @ . . . . @ @ . . . . @ . . . . @ . @ . 
. @ . . @ @ @ . @ . @ . . . @ @ . . @ @ @ . . . @ @ . . . . . @ 
. @ @ . . . . @ @ @ . . . @ . @ . . . . . . . @ . . . . . . . . 
. . . . . @ . . . . . . . . . . . . . . @ . @ . . @ . . @ . . @ 
@ . . @ . @ . . . . . . . @ . . . . . . . . . . . @ . . . @ . . 
. . . . . @ @ . . @ . @ . @ @ . . . . . . . . . @ . @ . . . . @ 
. . . . @ . . @ . . . . @ . . . . . . @ . . . . . . . @ . . . . 
30
24 17 19 23
25 27 25 4
24 31 8 14
1 15 4 24
31 6 2 15
1 11 21 19
23 15 25 3
31 7 7 23
23 11 21 29
18 1 19 0
8 28 28 27
26 12 14 31
12 11 8 19
13 1 18 13
29 13 19 29
23 30 4 23
10 29 13 26
19 14 10 20
22 8 20 1
26 31 11 12
6 0 21 7
7 6 17 16
7 0 27 22
6 23 18 6
20 15 11 9
18 21 1 2
25 12 17 22
28 11 25 1
18 7 30 17
16 13 15 18
