32 32
. . @ . . . . . . @ . . . . . . . . @ . . @ @ @ . . . . . . . . 
. . . @ . . . . @ . @ @ . . . . @ . @ . . . @ @ . . . . . . . . 
. . . . . . . . . . . . . @ . . . . . @ @ . . . . @ @ @ . . . . 
. . . . . . . . . . . . @ . . . . . @ . . . . @ @ @ . . . @ @ . 
. @ . . . . . . . @ . . . . @ . . . @ . . . . . . @ @ @ @ . @ . 
. . . . . . @ . . . . . . . @ @ . . . . . . . @ . . . @ . . . @ 
. . . . . . . . . . . @ . . @ @ . . . . . . . . . . . @ @ . . . 
. . . . . . . . . . . @ . @ . . @ @ . . . . . . @ . . . . . . . 
. . . . . . . . . @ . . . . . . . . @ . . . . . . . @ @ @ . . . 
. . . . @ . @ . . . @ . . . . . . . . . @ . . @ @ @ . . . . @ . 
. . . @ . . . @ . . . @ @ . . . . . . @ . . . . @ . . . @ . . . 
@ . . . @ . . . . . . . . . . . . . . . . @ . . . . . . . . . . 
. . @ . . . . . . . @ . . @ @ . . . . . . @ @ @ . . . . . . . . 
. . @ @ @ . . . . . . @ . . . . . @ . @ . . @ . . . . . . . . . 
@ . . . @ . . . . . . . @ . . . . @ . @ . . . . . . . @ @ . . . 
. . . . . @ . . @ . @ . . . . . . . . . . . @ . @ @ . . . @ . . 
@ . . . . @ . @ . . . . . . . . @ . @ . . . @ . . . . @ . . . . 
. @ . . . . . . . . . @ . @ @ . @ . . @ . . . . @ @ . . . . . . 
. . . . . @ . . @ . . . . . . . @ . . . . . . . . @ . @ . . . . 
. @ . . . . @ . @ . . . . @ . . . . . . . . . . . . @ . . . . . 
@ . . . . . . . . . @ . @ . . @ . . . . . @ @ @ . @ . . @ . @ . 
. . . . . @ . @ . . . . @ @ . . . . . . . @ . . . . . . . . @ . 
. . . . . . . . @ . . . @ . . . . . . @ @ @ . . . . . . . . @ . 
. @ . . . @ . @ . . . . @ @ . . . . . . . . . @ . . . . . . @ . 
. . @ . . . . . . . . . . . . . . . . @ . . . @ . . . @ . . . . 
. . . . . . . . . . . . @ . . . . . @ . . . . @ . . . . . . @ @ 
. . . . . . @ @ . . . . . . . . @ . . . . . @ . . . . . @ . @ . 
. @ . . . @ . @ @ . @ . . . . . . . . . . . @ . . . . @ . . . @ 
. . . . . @ . . . . . . . @ @ . . . . @ . @ . . . . . . . . @ . 
@ . . . . . @ @ . . @ . . . @ . . . . . @ . . . . . . . . . . . 
. . . . . . . . . . . . . . . . @ @ . . . @ . . . . . @ . . . . 
. . . . @ . . . . . @ . . . . . @ @ . . . . @ @ . . . . . @ . @ 
50
30 13 21 13
17 11 23 4
29 11 2 2
15 4 18 15
1 25 3 7
21 15 27 26
1 9 9 14
7 3 12 8
5 30 16 20
25 27 31 1
8 4 25 16
23 11 8 11
17 28 3 17
31 3 28 29
1 7 7 30
6 17 13 10
26 6 24 6
25 24 18 30
12 0 29 10
14 1 20 19
29 21 9 26
24 6 2 1
15 17 4 28
3 19 9 22
18 15 31 0
15 22 6 27
12 6 11 14
9 18 15 19
9 29 5 14
28 17 13 9
12 19 15 4
31 30 28 2
3 8 29 22
23 6 19 15
1 26 0 15
16 19 19 26
5 7 3 11
6 3 10 3
15 7 12 15
10 10 14 19
14 9 2 26
20 21 7 17
1 28 22 18
5 11 25 22
26 21 15 0
11 19 16 12
12 27 9 7
0 12 3 9
7 13 17 6
28 16 18 31
