32 32
. . . @ @ . . . . . . @ . . . @ @ . . . . . . . . . . . . . @ . 
. . . . . @ . . . @ . . . . . . . . . . . . . @ . . @ . . @ . @ 
. . @ @ . . . . . @ . . @ . . . . . . . . . @ @ . . . @ . . @ @ 
. @ @ . . . . @ . . . . . . . . . . . . . . . . . . . @ . @ @ @ 
. . . . @ . @ . . . . . . . . . . . . @ . . . . . . . . . . . . 
. @ . . . @ . . . . . . . . . . . . @ . @ . . . . . . . . @ @ . 
@ @ @ . . . @ . @ . . . . . . . @ @ . @ . . . . . . . @ . . . @ 
. . @ @ . . . . . . . . . . . . . @ . @ . . @ . . . . . @ . . . 
. . @ @ . . . . @ @ . . . . . @ . . . . . . @ . . . . . . @ . . 
. . . . @ . . . . . . . @ . . . . @ . . @ @ . . . . . @ . . . . 
. . @ . . . . . . . . . . . . . . @ . @ . . . . . . . . . @ . . 
. . . . . . . . . . . @ @ . . . . . . . . . . . . . . . . . . . 
. . . . @ . . . . . . . . . . @ . . . @ . @ . . @ . . . @ . . @ 
. . . . @ . . . . . @ . . @ . . . . @ . . @ @ . . @ . . . . . . 
. . . . . . @ . . . . . . . . . . . . . . @ . . . . . . . . . @ 
. . @ . . . . . . . . . . . @ . . . . . . . . . @ . . . @ . . . 
. @ . . . . . @ . . . @ . . . . . . . . . . . @ @ . . . . . . . 
. @ . . @ @ @ . . . . . . . . . . . . . . . . @ . @ . . . . . @ 
. . . @ . . . @ . . . . . . . . . . . . . . @ . . . . . . . . . 
@ . . . . . . @ . @ . . . @ . . . . . . . . . . . @ . . @ @ @ @ 
. . . . . . . . . . . @ . @ . . . . . . . . . . . @ . @ @ . . . 
. . . . . . . . . . . @ . . . @ . @ . . @ . . . @ . @ . . . . . 
. . @ @ @ . @ . . @ . . . . @ . . . . @ . . @ . @ . . . . . @ . 
@ . . @ . . . . @ . . . . @ . . . @ @ . . . . . . . . . @ . . . 
@ . . . @ . . . . . . @ @ . . . . . . . . . . . @ @ . . . . . . 
@ . . . . . @ @ . @ . . . . . @ . . . . @ . @ . . @ . . @ . @ . 
. . . . @ . . . . . . @ . . . . . . @ . . . @ . . @ . . . . . . 
@ . . . . . @ . @ . . . @ . . . . @ . . @ . . @ @ . . . . . . . 
. @ . . . . @ . @ . . . . . @ . . . . . . . @ . . . . . . . @ @ 
. . . . . . @ . . . @ . . @ . @ . . @ . . @ . . . . . . . @ @ . 
. . . . . . . . . . . . . . . . . @ . . . . . @ . @ @ . @ @ . . 
. . @ . . . @ . . @ . . . . . . @ . @ . . @ . . . . . . @ . @ @ 
60
3 20 5 11
25 10 3 3
2 25 30 27
4 6 14 9
14 10 28 4
9 17 23 12
28 14 14 4
7 4 16 23
22 27 19 27
11 12 22 4
9 26 26 18
15 28 19 13
18 15 21 1
2 1 28 8
0 3 14 6
23 24 25 12
26 13 8 11
24 17 28 16
25 29 26 26
1 10 8 4
14 7 0 11
6 12 25 31
8 3 19 14
19 8 8 0
20 20 16 29
12 18 26 8
10 17 1 0
31 18 4 1
20 11 12 18
6 0 24 14
8 5 26 12
9 16 9 16
13 5 22 6
3 14 28 0
19 28 8 3
5 2 1 9
29 26 14 2
18 2 16 20
21 23 12 28
13 24 28 5
15 11 24 29
25 18 18 19
3 27 13 2
28 6 11 27
1 15 19 21
27 24 14 29
7 20 15 24
19 21 7 15
14 21 25 0
12 29 5 15
17 24 23 19
24 25 15 22
6 9 3 21
22 24 30 9
20 31 21 22
28 2 23 29
21 24 3 30
8 17 17 24
3 9 6 19
2 5 18 18
