32 32
@ . . @ . . . . . . @ . . . . . . @ . . . . . @ . . @ . @ . . . 
. . @ . . . . . . . . . . . . . . . @ . . . . . . @ . . . . . . 
. . . . . . . . . . . . . @ @ . @ . . . . . . . @ . . . . @ . @ 
@ . . @ . . . . . @ . @ . . . . . . @ . . . @ @ . . @ @ . @ . . 
@ . . @ . . . . . . . . . . . . @ . . . @ . . . . . . @ . . . . 
. @ @ . . . . . . . . . . . . . . . @ . . . . . . . . . . . . @ 
@ @ . . . . . . . . . . . . . . @ . . @ . . @ @ @ @ @ . . . . . 
. @ . . . . . . . . @ . . . . @ @ @ @ . . . . . @ . . . @ @ @ . 
. . @ . . . . . @ . . . @ . . . . . . . . . . . . . . . . @ . . 
. . . @ . @ . . . . . @ . . . . . . . . . . . . . @ @ . . . . @ 
. . . . . . . @ @ @ @ . . . @ . . . . . . . . . @ . . . @ @ . . 
. . . . . . . . . . . . . . . . . . . . . . . @ . . . . @ . . . 
. . @ . . @ . @ @ . . @ @ @ . . . . . @ . . @ . @ @ . . . @ . . 
. @ . . @ . @ @ . . . . . @ . @ @ . . . @ . . @ . . . . . . . . 
. . . . . . . . . . . . . . . . . . . . . . @ . . . @ . . . @ . 
. . . . . . . . . . . . . . . . . . . . . . . . . @ @ . . . . . 
. . . . . . @ . . . @ @ . . . @ @ . . . . . . . . . @ . . . . @ 
. . . . . @ . @ . . . . . . . . . . . . . . @ @ @ @ . . . . . . 
. . . @ @ . @ . . . . . . @ . . . . . . . @ . . . . @ . . . . . 
. . . . . . . @ . . . . . . @ . . . . . . . @ . . . @ @ . . @ . 
. . . . . . . . @ . . . . . . . @ @ . . . . . . . . . . . . . . 
. . . . . . . @ @ . . . @ . . . . . @ . @ . . . . . @ . . . . . 
. . . . . . @ . @ . @ . . . . . @ @ . . . . @ . . . @ @ @ . . . 
. @ . @ . . @ . . . . . . @ . @ . . . . . . . . . . @ . . . . . 
. . . @ @ @ . . . . . @ . @ @ . @ . . . . @ . . . . . @ . . . . 
. . . . . . . . @ . . . . . . . . . . @ @ . @ . . . @ . . . . . 
. . . @ . @ . . . @ . @ . . . . . . @ . @ . . . . . . @ . @ . . 
@ . @ . . . . . . . . . . . @ . @ @ . . @ @ . . . . @ . . . @ . 
. . @ . . @ . @ . @ . . . . . . . . . . . @ . . . . . . . . . @ 
. . . . @ . . . . . . @ . . . . . . . . . . . . . . . @ . . . @ 
. . . . . . . @ @ . . . . @ @ . . . . . @ . @ . . . . . . . @ . 
. . . . . . . . @ . . @ @ . . . . . @ . . . @ . . @ @ . . . . . 
70
20 23 11 1
2 0 15 29
13 17 4 8
4 12 23 22
8 14 4 28
21 31 10 18
31 30 27 18
6 9 7 1
18 12 11 19
11 23 21 14
11 21 2 20
21 20 11 11
20 16 5 25
31 19 11 4
20 9 6 11
4 2 29 17
1 27 15 9
5 1 11 23
30 15 5 22
27 25 6 8
30 23 10 4
28 24 4 22
19 18 7 16
14 16 31 25
19 16 16 31
15 24 21 19
27 17 1 12
25 0 20 29
21 6 20 2
0 11 25 7
12 30 21 29
3 22 4 25
14 6 10 26
24 19 11 13
31 12 19 1
27 10 28 23
22 28 2 13
11 6 1 31
23 20 13 26
11 20 26 4
7 7 13 9
8 2 17 2
3 19 2 9
8 23 5 18
13 19 17 12
26 29 31 31
18 8 21 8
13 0 24 5
28 30 2 16
30 29 18 27
30 6 4 11
20 1 17 26
16 26 24 4
12 10 14 21
1 12 4 14
26 2 10 1
14 14 6 1
31 23 28 27
13 22 27 30
16 30 4 4
11 15 24 23
4 14 0 16
29 19 29 0
12 7 11 17
12 2 4 1
19 24 3 31
19 23 21 26
2 23 7 6
23 30 25 4
26 5 7 7
