32 32
@ @ @ . . . . . . . . . . . . . . . @ @ . . . . . . @ @ . . @ . 
. . . . . . . . . . @ . . . @ @ . @ . @ @ @ . . . . . . . . . . 
. . . . . . @ @ . . . . . . . . . @ . . . @ . . @ . . . . . . . 
. . @ @ . . @ . . . . . . @ @ . . . . @ . . . @ . . . . . . @ . 
. . . . . . @ . . @ . . . @ . . . . . . . . @ . @ . . . @ @ . @ 
. . . . . . . . @ . . . . . . @ . . @ . . . . . @ . . . . . @ . 
. . . . . @ @ @ @ . . . . @ . . . @ . @ @ @ . . @ . . @ . . . . 
. . . . . . . @ @ @ . @ . . . . . . . . . @ . . . . . . @ . . @ 
. . . . . . . . . . @ . . . . . . @ . . . . . . . . @ . . @ . . 
@ @ . . . . . . . . . . . . @ . . @ . . . @ @ @ . . . . . . . . 
. . . @ @ . @ . . . . . . . @ @ . . . @ @ . . @ . . . . . . . . 
. . @ . @ . . . . . . . . . . @ . . @ @ @ @ . . . . . . @ . . . 
@ @ . @ . . . . . . . . . . . . . . . @ . . @ . . . . . @ . . . 
. . . . . . . . . @ . . @ . . . @ . . . . . . . . . . . . @ . @ 
. . . . . . . . . @ . . . . . . . . . . . . . . @ . . @ @ . @ @ 
. . @ . . . @ . . . . . . . . @ . . @ . . . . . . . @ . . . . . 
. . @ . . . . @ . . . @ . . . . @ . . . . . . . . . . . . @ @ . 
. . . @ . . . . . . . . @ . . @ . . . @ . . . @ . . . . . @ . @ 
. . . @ . . . . . . . . @ @ . . . . @ . @ . . . . . . . . @ @ . 
. . . . . . . . . . @ . . . @ . . . . . @ . @ . @ . . . . . . . 
@ . . . . @ . . . . . . . . . . . . . . . . . @ . . . . . . @ . 
. . . . . . . . @ @ @ @ . . . . . . . . . @ . . . . . . . . . . 
. . . . . . . . @ @ . @ @ . . . . @ . . . . . . . @ . . . . . . 
@ @ @ . . . . . . . . . . . . . . . . @ . . . . . @ . . . . . . 
. @ . . . . @ . @ @ . @ . . . . . . . @ @ @ . @ . . . @ . . . @ 
. @ . . . . . . . . . . . . . . . . @ . . . . . . . . @ @ . . @ 
. . . @ . . . @ . . . . . . . @ . . . . . . . @ . . . . . . . . 
@ . . . . @ . . . @ . @ . . @ . . . . @ . . @ . . . . . . . @ . 
. . . . . . . . @ @ @ . . @ @ . . . @ . @ . . @ . . @ . @ . . . 
. . . . . . . . . . . . @ . . . . . @ . @ . . . . @ @ . . @ . @ 
. @ . . . . . . . . . . . . @ . . . . . @ . . . . @ . . . . . @ 
. . @ . . . . . . . . . . . . . . . . . . . . . . . . . . . . . 
20
12 12 7 4
17 5 27 27
31 8 7 11
21 12 10 17
29 31 4 29
0 4 14 22
18 16 0 8
26 24 16 22
16 18 13 13
0 19 9 11
16 1 18 31
31 9 0 24
25 4 17 27
23 21 22 13
5 2 6 17
29 5 24 16
11 20 0 25
0 24 31 26
7 22 5 25
22 13 5 18
