32 32
. @ . . . . @ . . . . . . . . . . . . . . . . @ . . . . @ . . @ 
. . @ . @ . @ . . . . . . . . @ . . . . . . . . . . . . . . . . 
@ . . . . @ @ . @ @ . . . . . @ . . @ @ @ . @ . @ . @ @ @ @ @ . 
. . . . . . @ . @ . @ . . . . . . . . . . . . . . . @ . . . . . 
. . . . @ . . . . . . . . . @ . . @ . . . . . . . . . . . . . . 
. . . . . . . . . @ . . . @ . @ . @ . @ . . . . @ . @ . . . . . 
. . . . . . @ . @ @ @ . . . . . . . . . . . . . . . . . . @ . @ 
. . @ . . @ . . @ . . . . . . . . @ . . . . @ . @ . . . . . . @ 
@ . @ . . @ . @ . . . @ @ . . . . . . . . @ @ . . . . . @ . @ @ 
. @ . . . . . . . @ . . . . . . . . . . . . . . @ . . . . . . . 
. . @ . . . . . @ . @ . . . . . . . . . @ . . . . @ . . . @ . . 
. . . @ . . @ . . . . . . . @ . . @ . . . @ . . . @ @ . . . . . 
. . . . @ . . . . . @ @ . . @ . . . @ . . . . . . @ . @ . . . . 
. . . . @ . . @ @ . . . . . . @ @ @ . . . . @ @ . . . . . @ . . 
. @ . . @ . . @ . . . . . . . . . . . . . . . . . @ . . . . @ @ 
. . . . . . . @ . . . . @ . . . @ @ . @ . . . . @ . . . . . . . 
@ . . . . . @ @ . @ . . . . . . . @ . . . . . . . . . . . . . @ 
. . . . . . @ @ . . . @ . . . . @ . @ . . . . . . . . . . . . . 
. . . . . . . @ @ . . @ . . . . . . . . . . . . . . . . . @ . . 
. . . . . . . . . @ . . . . @ . . . . . . . @ . . . . . . . . . 
. . @ @ . . . . . . . . . @ . . . . @ . . @ . @ . . . . @ . . . 
. . . . @ @ . . . . . . . @ . . . @ . . . . @ . . @ . . . @ @ . 
@ @ . . @ . . . . @ @ . @ . @ . @ . . . . @ . . . . @ . . . . . 
. . @ . . . . . . . . @ @ . . . . . . . . @ . . @ . . . . . @ . 
. . @ @ . . . . . . . @ . . . @ . . . . . . . . . . . @ @ @ . . 
. @ . . . . . . . . @ . . . . . . . . @ . . . . @ . . . . @ . . 
. @ . . . . @ . . . . . . @ . . . . . . @ . . . @ @ @ . . . . . 
@ . . . . . @ . . . . . @ . . . . . . . . . . . . . . . . . @ . 
@ . . . . . . @ @ @ @ . . . . . . . . @ @ . . . . . . . . . . . 
. . . . . . . . @ . . @ @ . . . . . . @ . . @ . @ . . @ @ . . . 
@ . . . . . @ . . @ . . . . . . . . @ . . . . . @ @ . . @ . @ . 
. . . . @ . . . . . . . . . . . . . . . . . . . . . . . . . . @ 
10
8 9 31 17
10 27 13 14
31 22 5 15
27 19 14 10
3 13 13 28
22 10 14 15
6 13 3 3
9 21 3 5
11 2 4 28
17 0 6 24
