32 32
. . . . @ @ . . . . . @ . . . @ . . @ . @ @ . @ . . . . . @ . . 
. . . . . . . @ @ . @ . . . . . . . @ . . . . . . . . . . @ . . 
@ . . . . . . . @ . . . . . . . . @ . . . . . @ . . . @ . . . . 
@ @ @ . . . . . . . . . . . @ . . . . . . . @ @ @ . . . . . . . 
@ . @ . @ . @ . . . . @ @ . . . . . . . @ @ . . . . . . . . . . 
. . @ . . . . . . . @ . @ @ @ @ @ @ . . @ . . . . . . . . . . . 
. . . @ . . . . . . @ . @ . . . . @ @ . . . @ . . . . . . . . . 
. @ . @ . @ . @ . . . @ @ . @ . . . @ . . . . @ . . . . . . . @ 
. . . . . . . . . . . . . . . @ @ . . . . @ @ . . . . . . . @ @ 
. . . . . . . @ . . . . . . . . . . . . . . . . . . . @ . . . . 
. . . @ . . . . . . . . . . . . . . . . . . . @ . @ . . @ . . . 
. @ . . . . . . . . . @ @ . . . . . @ . . . . . . . . @ . . . . 
@ . . . . @ . . . . . . . . @ . @ . . . . . . @ . . . . . . . @ 
@ . . . . @ . . . . . . . . @ . . . . . . @ . . . . . @ . @ . . 
. . . . @ . . . . . . @ . . . . @ . @ . . . . @ . @ . . @ . . @ 
. . . . @ . . @ . . @ . . . . . . . . . . . . . . . . . . @ . . 
. . . . @ . . . . . . . @ . . @ . . . @ . @ @ . . . @ . . @ @ . 
. . . . . . . . . . . . . . . . @ . . @ . . . . . . @ . . . . . 
@ @ . . @ . . . . @ . . . @ . . . . . . . @ . . . . . . @ @ . . 
. . . . . . . . . . @ . . . . . . . . . @ @ . . . . . @ . . . . 
. . . . @ @ . . . . . . . . . . . . . . . . . . . @ . @ . @ . . 
. . @ @ @ . . . . . . . . . . . @ . . @ . . . . . . . @ . . . . 
. . . . . . . @ @ . . . @ . . . . @ . . . . . . @ . . . . . . . 
@ . @ . @ . @ . . . @ . . . . . . @ @ . . . @ . . . . . @ . . . 
. . . . . . @ . @ . . . @ . . . . . . . . . . . . . @ . . . @ @ 
. . . . . . @ . . @ . . . . . . . @ . . . . @ . . . @ . . @ . . 
. . . . . . . . . . @ @ @ . . . . . . . . . @ . . @ . . . @ . . 
@ . @ @ @ . . @ . @ . . . . . . . . . . @ @ @ @ . @ @ . . . @ . 
@ . . . . . . @ . @ . . . . . . . . . @ . . . . . . . @ . . . . 
. . . @ @ . . . . . . . @ . . . . @ . . . @ . @ . . . @ . . . . 
. . . @ @ . @ @ @ . . . . . . . . @ . . . . . . @ . @ @ . . . . 
@ . . . . . . @ . . . . . @ . . . . . . . . . . . . . . . . . . 
50
7 26 20 22
2 0 19 7
21 31 23 24
11 15 16 26
19 22 5 9
21 21 20 25
18 15 16 3
5 19 9 0
5 28 8 16
25 3 30 20
31 17 15 25
24 9 0 30
13 9 8 5
29 27 11 31
9 4 23 31
11 18 13 13
13 21 27 14
22 9 19 26
0 14 4 6
9 13 20 18
19 30 22 0
23 17 8 17
11 29 24 2
28 6 31 13
18 24 28 11
11 23 31 3
28 15 31 1
14 19 7 29
27 5 31 16
28 28 18 24
11 17 27 6
9 2 21 7
31 2 1 26
23 8 13 17
10 17 10 20
11 21 4 28
19 31 13 12
30 22 3 22
2 6 4 1
0 6 1 21
16 23 24 31
13 23 24 8
29 6 26 15
10 16 17 28
8 25 9 1
0 5 2 29
24 1 28 0
8 26 30 21
21 30 16 6
22 21 13 1
