32 32
. . @ . . . . . . . . @ . . @ . @ . . . . @ @ . . . . . . @ . . 
. . . . . . . @ . @ @ . . . @ . @ . . . . . . . . . . . . . . . 
@ . @ . . . . . . . @ . . . . . . . . @ @ . . . . . . . . . @ . 
@ . . . @ . . @ @ . . . . . . @ . @ . . @ . . . . . . . . . . . 
. @ . @ . . . @ . . . . . . . . @ . . . . . . . . . . . . @ @ . 
. . @ @ @ . @ @ . @ . . @ . . @ . . . . . . . . . . . . . . . . 
. . . . . . . @ . . . . . . @ @ @ . @ . . . @ . . . . . . . @ . 
. . . @ . . @ . @ @ . . @ . . @ . . . . . @ . . . . . . . . . . 
. . . . . . . @ @ . . . . . @ . @ . . . . @ @ . . @ . . . . . . 
. . . . . . @ . . . . . @ . . @ . . . . @ . . . . . . . . . . . 
. . . . . . @ @ @ . . . . . . . @ . . . . @ . . . . . . . . . . 
. @ . . . @ @ @ . . . @ @ . . . . . . . . . . . . . @ . . . . . 
. . . . . . . . . . . . @ . . . @ @ . @ @ @ . . . . . @ @ . . @ 
. . @ . @ @ @ . @ . . . . . . . . . . @ . @ @ . . . . . . . . @ 
. @ . . . . . . . . . @ @ . . @ . @ . @ . @ . . . . @ @ . . @ @ 
. . . . . . . @ . . . . . . . @ . . . @ . . . . . . @ . . . . . 
. @ . . . . . . . . . . . @ . . . . . . . . @ . @ . . . . . . . 
. . @ . . . . @ . . . @ . . . @ . . . . . . . @ . . @ . . . . . 
. . @ . . @ . . . . . . . . . . . . @ . . . . . . . . . . . . . 
. . . @ . @ . . . . . . . . . . . . . . . . . . . . . . @ . @ . 
. @ . . . . . . . . @ . . @ @ . . . . . . . . . @ @ . . . . . @ 
. . . . . . . . . . . . . . @ . @ . . . . . . @ . . . . @ . @ . 
. @ . . . . . . @ . @ . . @ . . . . . . . @ . . @ . . . @ . . . 
. . . . . . @ . @ . . . . @ . @ . @ @ . . . @ . @ . . . . . . . 
. . . . @ . . . . . . . . . . . . . . . . . . . . . . . @ . . @ 
. . . . . . . . . . . . . @ @ . . . . . . . . . . . . . . . . . 
. . @ @ . . . . @ @ . . @ . . @ . . . . . . . . . @ . @ . . . @ 
. . . . . . . . . . . . . . . . . @ @ . . . @ @ . . . . @ . . . 
. . . . . . . @ . @ . . @ . @ . @ . . . . . . @ . @ @ . @ . . . 
. . . . @ . . . . . . . @ . . @ . . @ . @ . . @ . @ . . . . . . 
. . . . . . . . . . . . @ . @ . . @ . . . @ . . @ . . . . . @ . 
. @ . @ @ . @ . . . . @ . . . . . . . . . @ @ @ @ . . @ . . . . 
60
31 2 30 25
25 2 30 27
23 2 17 24
16 11 2 25
31 6 11 30
29 20 28 13
7 27 16 5
20 16 18 31
21 3 31 23
17 16 2 3
4 10 23 19
24 3 25 0
24 24 2 29
17 28 10 29
20 20 24 13
17 19 22 10
4 21 23 24
21 11 25 21
3 25 9 12
24 25 29 19
31 15 23 14
18 8 21 18
0 28 3 16
20 13 30 22
8 16 1 0
28 3 5 26
27 15 3 20
1 17 12 18
6 29 16 29
17 24 26 18
26 8 11 6
6 4 26 16
2 20 18 10
1 8 23 30
0 17 15 11
9 13 26 26
23 14 1 25
11 26 9 3
11 21 15 22
22 20 18 0
0 31 31 21
24 11 20 17
1 7 28 5
9 6 13 27
4 6 5 27
2 3 30 3
4 16 7 9
26 27 17 7
18 16 22 20
11 25 15 27
22 28 7 21
15 4 0 14
4 4 5 10
19 9 20 0
6 19 13 2
29 23 22 3
12 13 10 26
4 1 27 2
25 4 26 29
4 22 14 7
