32 32
. . . . . . . . . . . . . . @ @ . . . . . . . . . @ . . @ . . . 
. . . . . . . . . . . . @ . . . . . . @ . . @ . . @ @ . . . . . 
@ . . . . . . . @ @ . . . . . . @ . . . . . @ . . @ . @ . @ . . 
. @ . . . . . . @ . . . . @ . . . . . . . . @ . . @ . @ @ . . . 
. @ . . @ . . . . . . . @ @ . @ @ . . @ . . . . . . . . . . . . 
. . @ . . . @ . . . . @ @ @ . . . . . . . . . . . . . . . . . . 
. . . . . . . . . . . @ . . . . . . . . . . . . . @ @ . . . . . 
. . . . @ . . . . . . . . . . . . . . . @ . . . . . . @ @ . @ . 
. . @ . . @ . . . . @ . . . . . . . . . @ @ . . . . . . . . . @ 
. . . . . . . . . . . . . . . . . @ . @ . . @ . . . . . . . . . 
@ . . . . @ @ . @ . . . @ . . . @ @ . @ . @ . . . @ . @ . . . @ 
. @ . . . . @ . . . @ . . . . . . @ . . @ . . . @ @ . . . . . . 
. . @ @ @ . . @ . . @ . . . . @ . @ . . . . . . @ . . @ . . . . 
@ @ . @ . . . . . . . @ @ . @ . @ . . @ . . . . . . . . . . . . 
. . . . . @ . . @ . . . . . . . . . . @ . . . @ @ . . . . . @ . 
. . . . . @ . @ . . . @ @ @ . . . . . . . . . . . @ . . . . . . 
. . . @ . @ . . . . . . . . . @ . . . . . . . . @ . . . . @ @ . 
@ . @ . @ . . . . . @ . . @ . . @ . . . . . . . . . . . . . . . 
. . . . . . . . . @ . . . . @ @ . . . . . . . @ . . . . . . . @ 
. . . . . . . @ @ . . . . . . . . . @ . . . . . @ . . @ . . . . 
. . @ . . @ . . . . . @ @ . @ . . . . . . . @ . . @ . . . . . . 
. . @ . . . . . . . . . @ . . . . . @ . . . . . . . . @ . . @ . 
. . . . . . . . . . @ @ . @ . @ @ . . . . @ . . . . @ . . . . . 
. . . . . @ . @ @ . . . . . . . . . . . . . . . . @ @ . . @ . . 
. . . . @ . . . . . . @ . @ . . . . . . . . . @ @ . . . @ . . . 
. . . @ . . . . . @ @ @ . @ @ @ . @ @ . . . @ . . @ . . . @ @ . 
. . . . . @ . @ . @ . . . . . @ @ . . . . . @ @ . . . @ . @ . . 
. . . . . . . . . @ . . . . . . . . . . . @ . . . . . . . . . . 
. @ . . . @ . @ . . . . . . . . . . . . . . . . . . @ @ @ . . . 
. . . . . . . @ @ . . @ . . . @ . . . . . . . . . @ . . @ . . . 
. @ . . @ . . . @ @ . . . . . . . . @ . . @ . . . . . . . . . . 
. . @ @ . . . @ . . @ @ . . . @ . . . . . @ . . . @ . . . . . . 
20
18 26 6 0
8 27 10 14
28 15 0 30
13 2 28 17
4 21 25 12
3 10 19 21
25 19 25 22
27 29 28 6
20 6 8 25
2 0 26 27
5 19 17 28
21 28 11 4
21 6 0 15
9 29 3 0
12 18 0 8
8 25 19 16
2 29 27 14
2 19 2 9
22 24 5 27
23 12 8 21
