32 32
. . @ . @ . . . . @ . . . . @ . . . . . . . . . . . . . . . . . 
. . @ . . . . . . . . . . . . . . . . . . @ . . . . . . . . @ . 
. . . . . . . . . . . @ . . @ . . . . . . . . . @ . . . . @ . . 
. . . . . . @ . . @ . @ @ @ . . . . @ . @ . . @ . . . . . . . . 
. . . @ . @ . . . @ . @ @ . @ . . . . . . . . . . @ . @ . . . . 
. . @ . . . . . @ . @ . . . . . . . @ . . . . @ . . . @ . . . . 
. . . . . . @ . . . . . @ . . . . . @ . . . . . . . . . . . . @ 
. . . . @ . . . . . @ . . . . @ . . @ @ . . @ @ @ . . @ @ . . . 
. @ . . . @ . @ @ . . . @ @ . . . . . . . @ . . . . @ . . . . . 
. . . @ @ . @ . . . . . . @ . @ . . . @ . . . . . @ . . . @ . . 
. . . . . . . . @ . . . @ . @ . . . . . @ . @ @ @ @ . . . @ . . 
. @ . . . . . @ . @ . . . . . . . @ . @ @ . @ . . . . . . . . @ 
. @ . . . @ . . . . . . . . . . . @ . @ . . . . @ . . . . . . . 
. . . . . . . . @ . . . . . . . . . . @ . . . . @ . . @ . . . . 
. @ . . @ . . @ @ . @ . . . . . . . . @ . . . . . . . . . . . . 
. . . . @ @ . . . . . . . . @ @ @ . @ . . @ . . . . @ @ . . . . 
@ . @ @ . . . . . . . @ . . . . . @ . . . . . @ . . . . . . . . 
. . . . . . . . . . . @ @ . . . . . . . . . . . . . . . . . . @ 
@ . . . @ . @ . . . . @ . . . @ . . @ . . . . . . . @ . . @ . . 
@ . . @ @ . . . . . . @ . . @ . . . @ @ . . . . . @ . . . . . . 
. . . . . . . @ . @ . . @ . . . . . . . . @ . . . @ @ . . . . . 
@ . . . . . @ . . . . @ @ @ . . . @ . . . @ . . . . @ . @ . . @ 
@ . . . . . @ . . . . . . @ . . . . . . . @ @ @ . @ @ . . . . . 
@ . . . @ . . . . . . . . @ . . . . . . . @ . @ @ @ @ . . . . . 
. . . . . . . . . . . . . @ . . . . @ . @ . . @ . . . . . . . . 
. . . . @ . . . . . @ . @ . . . . . . . . . . . . . . . @ . . . 
. . . @ . . . . . . @ . @ . . . . @ . . . . . @ . . . . . @ . . 
. . . . . @ . . . . . . . @ @ . . . . . . . . . . . . @ . . . . 
@ . @ . @ @ . . . . . . . @ . . @ @ . @ @ . . . . . . . . . . . 
. . . @ . @ @ . . . . @ . . . . . @ . . . . . . . . . . . . . . 
. . . . . @ @ . . . . . . . @ . @ . . . . . . . . . . . . . . . 
. . . . . @ @ @ . @ @ . . . . . . . @ . . . . . . @ . . . . . . 
90
5 14 4 2
25 13 31 12
1 2 8 3
0 1 7 21
20 13 30 19
23 21 28 23
11 24 26 27
23 17 2 12
12 9 6 15
7 1 31 1
7 26 3 7
0 9 18 14
17 23 14 14
15 3 15 3
1 26 30 31
21 0 18 12
19 29 20 14
22 30 8 17
4 10 22 29
31 29 30 26
18 12 10 18
19 6 4 1
29 7 11 22
20 1 19 21
17 7 29 13
9 9 15 25
31 10 11 27
12 22 2 21
24 9 16 8
20 29 0 9
2 4 16 26
2 10 27 1
4 26 13 4
11 22 16 19
3 30 19 0
20 19 2 27
5 19 22 23
20 6 7 16
22 6 26 6
10 28 22 2
10 6 21 27
19 5 26 26
27 31 21 4
22 18 11 31
1 3 20 13
15 0 31 9
16 23 19 5
22 27 10 23
8 24 7 5
10 15 22 17
26 11 29 14
0 29 17 31
15 17 4 24
24 30 28 18
25 26 6 16
31 8 18 17
2 14 30 29
8 25 7 10
26 7 13 30
29 13 28 28
16 14 3 11
7 5 10 16
30 23 31 5
9 28 6 4
29 27 31 22
21 28 24 0
6 10 5 3
24 15 28 12
22 31 20 29
19 16 17 0
2 23 7 9
0 17 8 26
14 22 18 28
28 12 13 2
30 17 30 30
19 18 27 12
13 20 12 18
30 10 0 2
11 6 26 9
13 14 24 21
17 5 17 9
0 6 24 4
6 17 15 2
0 30 21 2
24 28 9 25
25 25 1 15
0 4 16 13
26 5 2 11
23 9 0 24
30 11 4 10
