32 32
. . . . . @ . . . . . . . . . . . @ @ . . . . . . . . @ @ . . @ 
. . . . . . . . . . . . @ . @ . @ . @ @ @ . . . . . . @ . @ . . 
. . . @ . . . @ @ @ . . @ @ . . . . @ . . . @ . . . . @ . . @ . 
. . . . . . . . . . . . . . . . . . . . . . @ . . . . . . . . . 
. . @ . . . . @ . . . @ @ . . . . . . . . . . @ . . . . . . . . 
. . @ . . . . . @ . . . . . . . . . . . . . . . . . . @ . . . . 
. . . @ . . @ . . . @ . . @ . . . . . . . . . . . . . . . . . . 
. . . . . @ . . @ . . . . . . @ . . . . . . . @ . . . . . . . . 
. @ . . . @ . . . . . . . . . . . @ . . . . . . . . . . . . . . 
@ . . . @ . . . @ @ . . . . . . . . . . @ . . . . . . . . @ . @ 
. . . . . . @ . . . @ . @ . . . . . @ @ . @ . @ . @ . . . . . . 
. . . . . @ . . . . . @ . . . . . . . @ @ . @ . . @ @ . . . @ . 
. . . . . . . . . . . . . . . @ . . . . . . @ . . . . . . . . . 
. . . @ . . . . . . . . . @ . . . @ . . . @ . . . . . @ . . . . 
. @ . @ @ . @ @ . . . . . . @ . . . . . . @ . @ . @ . . @ . . . 
. @ . . . . @ @ . . . @ @ . . . . . . . . . . . . @ . @ . . . . 
. . . . . . . . . . . . . . . @ . . . . . . . . @ . . @ . @ @ . 
@ . . . @ . . . . . . @ . @ @ . @ . . . . @ . @ . . @ . . . . . 
. . @ @ . . @ @ . . @ . @ @ . . . . . . . . . . . . . @ . @ . . 
. . . . @ . @ . . . . . . . . . . . . . . . . . @ . @ @ . . . @ 
. . . . . . . . . . @ . @ @ . . . . . . . . . . @ . . @ . . . . 
. . . . @ . . . . @ @ . . @ . . . . @ . @ . @ . . . . . . . . . 
. @ . . . @ @ . . . . . . . . . . . @ @ @ . . . . @ . . . . . . 
. . . . . . . . @ . . @ @ . @ . . . @ . . @ . @ . . @ . . . . . 
. . . @ . . . . . . . . . @ . . . . . . . . . . . . @ . . . . @ 
. . @ @ . . . . . . . . . . . . . @ . . @ . @ @ . . . . . . . . 
. . @ @ . . . . . . . @ @ . @ . @ . . . . . . . @ @ . @ . . @ @ 
@ . . . . . . . @ @ . . . . . . . . . . . . . @ . . . @ . . @ . 
. . @ . . @ . . . . . @ . . @ @ . . . @ . @ . . . . @ @ @ . . . 
. . . . . . . . . . . . . . . . . @ . @ @ @ . @ . . . . . . . @ 
. @ . . . . . . . . @ @ @ @ . @ . . @ . . . . . . . . . . . . . 
@ . @ . . . . . . . @ . . . @ @ @ . . . . . . . . . . . . @ . . 
60
15 2 2 0
14 18 31 28
25 30 28 4
28 7 25 20
25 8 23 3
11 13 2 8
20 0 14 15
18 20 29 6
7 9 31 3
27 17 5 16
16 23 16 13
28 17 30 19
13 1 16 24
4 11 12 12
31 6 26 18
14 15 3 19
4 5 22 14
9 24 30 18
14 22 26 8
25 7 27 22
8 13 23 26
1 28 24 14
4 27 6 16
15 26 23 1
15 8 2 15
6 12 7 16
1 18 16 16
27 4 23 28
21 21 0 1
3 27 7 3
8 15 17 31
27 29 18 11
30 10 15 22
28 8 18 8
9 3 7 22
19 31 20 31
20 28 21 25
21 2 1 23
29 8 16 25
16 22 29 21
17 4 27 24
25 6 4 0
18 24 21 16
30 0 13 11
26 0 30 8
4 31 9 23
0 1 20 26
20 24 24 23
5 10 17 30
11 22 15 26
0 15 29 23
12 5 5 12
14 16 5 13
0 4 10 22
5 16 30 25
15 4 13 1
10 1 21 2
17 10 19 24
31 16 31 5
7 8 7 24
