32 32
. . . @ . . . . . . . @ . @ . . . . . . . . . @ . . . . . . . . 
. . . . . . @ . @ . . . @ . . . . . . . . . . . . . @ . . @ . . 
. @ @ . . . @ . . . @ . . @ . . . . @ @ . @ . @ . . . @ . @ . @ 
. . @ . . . . . . . @ . . . . @ @ @ . @ . . . . . . . @ . . . . 
. @ @ . . . @ . @ . . . . . . . . . . . @ @ . . . . . . . . @ . 
@ @ . . . . . . . . @ @ . . . @ . . . . . . . . . . . . . . . . 
. . . . . . . . . . @ . @ . @ . . . @ . . . . . . . . . . . @ . 
@ . @ @ . . . . . . @ . . @ . . . . . . . . . . . . . . . . @ . 
@ . @ @ . @ @ . . . . @ . . . . @ @ . @ . . . . . . @ @ . . . . 
@ . . @ . . . . . . . . . . . . . . @ . . . . . @ . . . . . @ . 
. . . . . @ . . @ @ @ @ . . . . . . . . . . . . . . @ . @ . . . 
. . . . . @ . . . . . . @ . . . . . . . . . . @ . . . . @ @ . . 
. . . . . @ . . . @ . . . . . . . . @ . . . . . . @ . . . . @ @ 
. . . . @ @ . . . . . . . . . . @ . . . . . . . . @ . . @ . . @ 
@ . . . . @ . . . . . . . . . . . . . . @ . . . . . . . . . . . 
. . . . . . . . . . . . . . . . . . . . . @ @ . @ . . . @ . . . 
. . . . . @ . . . . . . @ . . . . @ . . . . @ @ . . . . @ . . @ 
. . . . @ . @ @ . . . . . . . . @ @ . @ . . . . . . . . . . @ . 
. . . . @ . @ . . . . @ . . . . @ @ . . . . . . . . @ . . . . . 
. @ . . . . @ . . . @ @ . . . . . . . . . @ . . @ . @ . . @ . . 
. . . . . . . . . @ @ . . . @ . . . . . @ . @ . . . . . . . . . 
@ . . . @ @ . . @ . . @ . . . @ . . . . . . . . . . . . . @ . @ 
. . . . @ . . . . @ . @ . . . . . @ . . . . . . @ . . . . . . @ 
. . . . @ . . . . . . @ . . . . @ . . @ . . . @ . . . . . . . . 
@ . . @ @ . . . @ . . @ . . @ @ . . . . . . . . . . . . @ @ . @ 
. . . . . . . . . . . . @ . . . . @ . . . . . @ . . . . . . . . 
. . . . . . . . . . . @ @ . . . . . . . . . . . @ . @ @ . . . . 
. . @ . @ . @ @ . @ . . . . . @ . . . @ @ . . . . . . . . . . . 
. . . . @ @ . . . . @ . . . @ @ . . . . . . . @ . @ . . . . . . 
. . . . . . . . . . . @ . . . @ . . . . . . . @ . . @ . . . @ . 
. @ . @ . @ . . . . . . . @ . . . . . . @ . . . . . . @ . . . . 
@ @ @ @ . . @ . . . @ . . . . . . . . @ @ @ . . . . . @ . . . . 
40
11 2 5 19
5 7 17 30
7 14 15 11
23 9 8 23
15 19 8 27
10 22 20 10
21 3 12 15
25 20 28 21
4 26 12 8
9 15 2 5
17 5 5 31
29 23 10 22
19 5 26 14
16 4 14 14
4 30 15 16
19 21 0 3
18 22 20 26
0 22 30 18
17 20 1 16
31 7 14 8
3 22 18 16
6 15 22 22
5 31 11 27
7 22 22 19
0 4 26 3
26 2 7 22
14 11 2 13
12 7 27 28
27 13 2 16
22 4 7 25
10 16 16 21
2 30 24 10
25 22 19 9
14 25 30 16
27 18 10 17
27 15 24 8
20 11 15 9
12 30 10 12
24 12 14 12
2 22 31 18
