32 32
@ . . . . . . . . @ . . . . . @ . . . @ @ . . @ . . @ . @ . . . 
. . @ @ . . @ . . . . . @ . . @ . . . . . . @ @ @ . . . . . . . 
@ . . . @ . @ . . . @ . . . . . . . . . @ . @ @ @ @ . . . . . . 
@ . . . . . . . @ . . . . . . . @ . . . . . @ . . . . @ . . . . 
. . . . . . . @ . . . . @ . . . . @ . . . . . . . . . @ @ . . . 
. . . . . @ . @ . . . . . . . . . @ . . . . . . . . . . @ . . . 
. @ . . @ . . . . . @ . . . . . @ @ . . . . . @ . @ . . . . @ . 
@ . . . . @ @ . . @ . . . . @ @ . . . @ . . . . @ . . . . . . . 
. . . . @ . . . . @ . . . @ . . . . @ . @ . . . . . . . . . @ . 
. . @ @ . . . . @ . @ . . . . . . . . . . . . . @ . @ @ . @ . . 
. . . . . @ . . . . . . @ @ . . . @ @ . . . . . . . . . . . @ @ 
. @ . . . . . . . . . @ . @ . . . @ . . . . . . . . . . . . . . 
. @ . . @ . . . @ . . . . @ . @ . @ . . @ . . . . @ . @ . . . . 
. @ . . . . . @ . @ . . . . . . . . . . . . . . . . @ . . . . . 
@ . . @ . . . . @ . . . . . . @ . . . . . . . @ . @ . . . @ . . 
. . . . . . @ . . . . . . @ . . . . . @ . . @ . @ . . . . . @ . 
. . . . @ . . . . . @ . . . . @ . . . . . . @ . . . . . . . . . 
. . . . . . . . . . @ . . . @ @ . . . . . . . . . . @ . . . . . 
. . . . . @ . . . . . . . . . . @ . . . @ . . . @ . . . . . . . 
. @ . . . . . . . @ @ . . . @ . . . . . . . . . . @ . @ . . . @ 
. . @ @ . . @ @ . . . . . . . . . . . @ @ . . . . . @ @ @ . . . 
. . . . . @ . . . . . @ @ . . . . . . . . @ . @ . . . . . . . . 
. . . . . . . . . @ . . . . . . . . . @ . . @ . . . . @ . . . . 
. . . @ . . . . . @ . @ . . . . . . . . @ @ @ . . . @ . . . @ . 
. . . . @ . . . . @ . . . @ . . . @ . . . . . @ . . @ . @ @ @ . 
. . . . . . . . . @ . . . . . . . . . . @ . . . . . . . . . . . 
. @ @ . . . . . @ @ . . . . . . @ @ . @ @ . . . . . . . . . . . 
. @ . . . . @ @ . . . @ @ . @ . . . . . . @ @ . . . . . . . . @ 
. . . . . . . . . @ . . . @ . . . . . . . @ @ @ . . . . . . . . 
. . . . . . @ @ . . @ . . . . . . . . . . @ . @ @ . . . . @ . . 
. . . . . . . @ @ . . . . . @ @ . @ @ . . . . . . @ . . . . @ . 
. . . . . . . @ . . . . . . @ . . @ . . . . @ . . . . . . . @ . 
40
26 15 17 8
17 15 30 19
28 26 24 28
4 9 14 6
29 22 25 21
14 10 10 30
28 8 16 27
7 7 29 17
22 6 3 10
9 10 9 29
25 22 11 5
28 28 17 18
0 21 6 6
11 28 4 20
14 11 11 20
3 26 9 15
27 29 6 30
29 19 25 8
7 14 4 18
21 3 30 29
7 11 16 25
24 22 30 7
17 27 23 23
19 10 15 29
9 12 28 13
1 21 16 17
10 24 16 5
8 15 12 24
0 9 28 10
10 30 25 31
17 21 29 19
30 5 2 8
23 4 6 25
12 28 14 2
3 0 30 26
24 14 2 24
7 25 2 13
13 29 8 29
18 1 23 18
3 6 12 17
