32 32
. . @ . . . . . . . @ . . . . . @ . . . . . . . . @ . . . @ @ . 
. @ . . @ . @ @ . . . . . . . . . . . . . . . . . @ @ . . . . . 
. . . . . . . . . @ @ . . . @ . . @ . . . . . . . . . . . . . . 
. . @ . . . . . . . @ . . . . @ . . . . . . . . . @ . . . . @ . 
. @ . . . . . . @ . . . . . . @ . . @ . . . . . @ @ . . @ . . . 
. . . . @ . . . . . . . . . . . . . . @ . . . . . . . . . . @ . 
. . . . . . @ . . . . . . . . . . . @ . . . . . . . . . @ @ . . 
. . @ . . . . @ . @ @ @ . @ . @ @ @ . . . . . . . . . . . . . . 
. . . . . . @ @ . . . . . . . . . @ . . @ . . . . . @ . @ . . . 
. @ . . . . . . . . . @ . @ @ . . @ . @ . . . . . @ . . . . . . 
. . . . . . . . . . . . @ . . . @ . . . . @ . . . . . . . @ . . 
. . . . . . . @ . @ . . @ . . @ . @ @ . @ . . @ . . @ . . . . . 
@ @ @ . . . . @ . . @ . . . . @ . . @ @ . . @ . . . . . @ @ . . 
@ . . . @ . . @ . @ . . @ . . @ . @ @ @ . . . . . @ @ . . . @ . 
. . . @ . . . . . @ @ . . . . @ . . . . . . @ @ @ . . . @ . . . 
. @ . . . . @ . . . . . @ . . . . . . . . . . . . . @ @ . . . . 
. . @ @ . . . . . @ @ . . . @ . . . . . . @ . @ . . . . @ @ . . 
. . . . . . . . . @ @ . . . . . @ . @ . . . @ . . . . . . . . . 
. @ . . . . @ . . . . . . . @ . . . . . @ @ . . @ . @ . . @ . . 
. . . . . . . . . . . @ . . . . @ . . . @ . . @ . . @ . @ . . @ 
@ . . . @ @ . . . . . . . . . . . . . @ . . . . . . . . . . . @ 
. . @ . . . . . @ . @ . . . . . . @ . . @ . . . . . . . @ . . . 
. @ . . . . @ @ . . @ . . . . . @ . . . @ . . @ . . . . . . . . 
. . . . . . . @ . . . . . . . . . @ . . . . @ . . . . @ . @ @ @ 
. . . . . . . . . . . . . . . . . . . . . . . @ . . . . @ . @ . 
. . . . . . . . . @ . @ @ . @ . . . @ . . @ . . . . . . @ . . . 
. . . . . @ . . . . @ @ @ . . . @ . . . . . . . . . . . . . @ . 
. . . . . @ . . . . . . . . . . . . . . . . @ . . . . . . . @ . 
. . . . . . . . . . . @ @ @ . . . . . . . . . @ . . @ . . . . . 
@ . . . . . . . . @ @ @ . @ . . . @ . . . . . . . . @ . . . . . 
. . . . @ . . . . . . . . . . . . . . . . @ @ . . @ . . . . . @ 
. . . . . . . . @ . . . . . . @ @ . . . . @ @ . . @ . @ . . @ . 
40
15 22 16 3
26 31 21 2
7 10 19 0
20 10 13 25
23 31 30 17
13 6 15 19
16 3 2 13
10 28 24 21
0 9 22 20
5 1 9 3
21 14 19 1
24 13 19 27
19 29 27 11
9 9 14 6
0 31 3 0
5 11 31 21
25 21 28 0
24 22 19 18
23 17 15 29
24 3 10 10
3 30 27 25
29 25 6 2
21 6 8 27
17 22 4 10
23 26 4 7
19 11 12 1
9 21 1 2
28 9 30 12
29 17 18 28
27 18 1 21
12 29 5 6
24 16 26 21
19 30 31 7
12 20 4 2
26 30 24 15
27 8 10 8
28 26 2 19
4 21 20 17
21 28 11 16
14 22 19 15
