32 32
@ . . @ . . . . . @ . . . . . . @ . . @ . . . . . . . . . . . . 
. @ @ @ . . . . . @ . . @ @ . . . . . @ . @ . @ . @ @ . @ . . . 
. . . . @ . . . . . . @ . . . . . @ . . . . @ . . . . . . . . . 
. . @ . . . @ . . . . @ . . . . @ . @ . . . @ @ @ . . . . @ . . 
. . . . . . @ . . @ . . . . . . . . . . . . . @ . @ . . . . . . 
. @ @ . . @ . . . . . . . . . @ . . . @ @ . . . . @ . . . . @ . 
@ . . @ . . . . @ . . @ @ . . . . . . . . . @ . . @ . @ . . . @ 
. @ . . @ @ . . . . . . . . @ . . . @ @ . . . . . . . @ . . @ . 
. . . . . . . . @ @ . @ . @ . . . . . . . @ . @ . . . @ . . . . 
. . . @ . . . @ . @ . . @ . . . . . . . @ . . @ @ . . . . . @ . 
. . . . . . @ . . . . @ . . @ . . . . @ . . . . . @ . . . . . . 
. @ . . @ . . . . . . . . . . . . . . . @ @ @ @ . . . . . . . . 
. . @ . . . . . . . . @ . . . . @ @ . @ . . @ . . . . . . @ @ . 
@ . . . . . . . . . . . . @ . . @ @ . . . . . @ . . . @ . @ . . 
. @ . . . . . . . @ . . . @ . . . . . . @ . . . . . . . . . . . 
. . . . . . . . . . . . . . . . . . . . . . . . . . @ . . . @ @ 
. . . . . . . . . . . . . . . . . . . . @ . . . . . . . . . @ . 
. . . . . @ @ . . @ . . . . . @ . @ . . . . . . @ . @ . . . . . 
@ . . . . . . @ . . . . . . . . . . . . @ . . @ . . . . . . . @ 
. . . . . . . . . . . . . . . @ . . @ . . . @ . . . . . @ . . . 
. . . @ . . . . . @ . . @ @ @ . . . . . . . . @ @ . . @ . . @ . 
. . @ . . . . @ . @ . @ @ . . . . . . . @ . . . @ . @ @ . . . . 
. . . . . @ @ . . . @ . @ . . @ . . . . . . . . . @ . . . @ . . 
. . . . . . . . . . . . . . @ @ @ . . @ . . @ . . . . . @ . . . 
. . @ @ . . . . @ . . . . . . . . . . . . . . . . . . . @ . . . 
. . @ . . . . . . . . @ . . @ @ @ . . . . @ . . . @ . . . . @ . 
. . . . . @ . . . . . . . . . . . . @ . . . . . . . . . . . . . 
. . . . . . . . . @ @ @ . . . . . @ . . . @ . . . . . @ . . . . 
. . . . @ @ . . . . @ . . . . @ . . @ . . . . . . . . . . . @ . 
@ . . . . @ . . . @ . . . @ . @ . . . @ . @ . . . . . . . . @ . 
@ . . . . @ . . . . . . . . . @ . @ . @ . . . @ . @ @ . . . . . 
. . . . . . . . @ . . @ . . . . . . . . . . @ @ . @ . . . . @ . 
80
13 30 17 10
25 11 28 30
21 3 24 0
0 15 30 27
2 9 30 26
7 20 18 20
19 4 9 6
5 6 10 2
15 18 7 1
8 18 15 1
14 31 30 13
21 24 27 14
30 18 29 31
24 12 19 25
0 5 20 28
27 11 22 25
30 0 11 5
14 2 14 22
22 8 15 7
14 15 8 14
8 12 13 6
28 7 15 4
14 6 18 10
17 9 16 5
31 5 15 14
25 3 12 23
22 4 1 23
10 9 6 15
5 8 26 23
9 22 14 27
28 26 24 23
3 10 26 5
0 3 29 5
28 2 31 30
15 7 21 6
7 24 5 23
7 16 11 15
4 26 29 25
9 6 31 2
4 20 8 4
23 19 29 26
28 3 9 18
7 6 8 16
29 19 5 0
12 5 7 16
7 14 8 29
27 19 28 0
24 29 29 24
15 16 27 1
3 14 8 2
15 12 13 12
5 20 12 27
13 4 11 28
5 12 0 9
25 19 17 29
31 30 18 30
11 11 11 11
8 26 6 21
6 0 20 30
22 16 12 15
27 18 18 1
22 14 27 18
28 15 22 8
28 14 11 24
13 12 7 30
16 17 3 5
5 18 14 30
1 6 17 25
6 26 12 25
3 7 17 8
10 31 0 31
28 18 26 8
24 14 28 18
25 17 17 19
3 29 16 18
19 14 0 15
1 24 1 25
24 27 3 4
2 19 2 9
17 18 22 26
