32 32
. . . . . . . . . @ . @ . . . @ @ . . . . @ . . . @ @ . . . @ . 
. . . . . . . . @ @ . . . . . . . . . . . . . @ . . . . @ . . . 
. . . . . . @ . . . . . . . . . @ . . . . . @ . @ . . . . . . . 
. . . . . . . . @ . . . . . . . . . . . . . . . . . @ . . @ . . 
. . . @ . @ . . . @ . . . . . . . . . . . . . . @ . . . . . . . 
@ . . . . @ . . . . . . @ . @ . @ @ . @ @ . @ . . . @ @ . . . . 
. . @ . @ . @ . . . . . @ . . . . @ . . . @ . @ . @ . . . @ . . 
. . . . . . . . @ . . @ . . @ @ . . . . . . . . @ . . @ . . . . 
. . @ @ @ @ . . . . . @ . . . . . . . @ . . . . @ . . . . . . . 
@ . @ . . @ . . . . . . . @ . . . . . . . . . @ . . @ . . . . . 
. @ . . . . @ . . . . . . . . . . . . . . . . . . @ . . . @ . . 
@ @ @ @ . @ . . . . . . . . @ . @ . @ . . @ . . . . . . . . . . 
@ . @ @ @ @ . . . . @ @ @ . . . . . @ @ . . . . . . @ . . . . . 
. . . . @ @ . @ . @ . . @ . . . @ . . . . @ . . . . . . . . . . 
. . . . . . . . . . . . . . . . . . . @ . . . . . . @ . . . . . 
. @ @ . . . . . . . . . . . . . @ @ . @ . @ @ . . . . . . . . . 
. . . . . . @ . . . . . . @ . . . @ . . @ . . . . . . . . . . . 
. @ . . @ . . . . . . . . . @ . @ . . . @ . @ . @ . . . . . . . 
. . . . . . @ . . . @ . . . . . . . . @ . . . @ . @ . . @ @ . . 
@ . . . @ . . @ . . . . . . . @ . . @ . . . @ . . . . . . . . . 
@ @ . . . . . . @ . @ . @ . . . . @ @ . . . . . . . . . . . . . 
. . . . . . @ @ . . . . . . @ @ . . . . . . . . . . . @ . . . . 
. @ . . . @ . . @ . . . . @ . . . . . . . . . . . . . . . . . @ 
. . . . . . . @ . . . . . @ . . . . . . . . . . . @ . . . . . . 
. . . . @ . . . . . @ . . . . . . @ . . @ . . . . . . . . . . . 
@ . . @ @ . . . . . . . @ . @ . . . @ @ @ . . . . @ . . . . @ . 
. . . . . . . . @ @ . . @ @ . . . . . . . . . . . @ . . . . . . 
@ . . . . . . . @ . @ @ . . . @ . . . . . @ @ . . @ . . . . . . 
. . . . . @ . . . . . @ @ @ . . . . . @ . . @ . . . . . . @ . . 
. . . @ . . . . @ @ . @ . @ @ . . @ . . . @ . @ . . @ . @ . . . 
@ . . @ @ . . . . . . . . . . . . . . . . . . . . @ . . . . . . 
. . . . . . @ @ . . @ . @ . . . . @ . . . @ . . @ @ @ . . . . . 
60
2 23 6 3
3 22 6 15
18 29 4 2
31 2 12 22
0 2 10 15
20 13 22 14
3 13 4 21
29 15 13 17
24 6 23 26
20 9 29 21
0 22 27 31
22 16 31 31
5 7 13 5
29 26 18 26
30 12 30 10
13 8 16 14
20 22 6 14
26 19 30 28
8 14 19 6
12 0 14 23
11 10 20 6
9 5 15 18
6 29 21 16
21 10 30 29
25 19 25 2
17 8 28 8
11 26 31 1
19 30 16 3
2 27 22 26
22 18 23 24
8 25 27 17
11 21 4 27
9 23 29 23
1 23 12 3
24 22 21 12
7 20 5 23
16 23 24 25
24 27 20 28
4 18 7 11
12 30 2 29
9 11 24 12
24 28 22 31
16 26 20 1
13 7 25 7
17 11 31 15
10 25 23 31
23 12 23 13
4 5 29 31
9 16 7 7
25 7 29 25
24 24 26 7
28 19 26 30
24 15 7 18
16 16 7 22
23 24 25 5
3 16 9 18
5 23 16 28
29 12 29 14
29 5 14 9
12 9 13 13
