32 32
. . . . . . . . . . . @ . . . . . . @ . . . . . . . . . . @ . . 
. @ @ @ . . @ . . . . @ . . . . @ . . @ . @ @ . @ @ . . @ . @ . 
. . . . . . . . . . . . @ . . . . @ . @ . . . . @ . . . . . . . 
. @ . . @ @ . . . @ @ . . @ @ . . . @ . @ @ . . . . @ . . . . @ 
. @ . . . . @ @ . . @ . . . . . . . . . . . . . . . . @ @ @ . . 
. . @ . . . . @ @ . . . . . . . . @ . @ @ . . . . . . @ . @ . @ 
. . . . . . @ @ @ . . . . . @ @ . . . . @ . . @ . . . . @ . . . 
. . . . . . . . . . @ . @ . . @ . . . . . . @ . . . . . . . . . 
. . . . . . . . . . @ . . . . . . . . . . . . @ @ . . . . @ . . 
. . . . . . . . @ . . . . . . . . . . . @ . . . . @ @ @ . . . . 
@ . . . . . . . . . @ @ . . @ . . . . @ @ . @ . . . . . . . . @ 
. . @ @ . . . . . . . @ . . . . @ . @ . . . . @ . . @ . @ . . @ 
. . . . . @ . . . @ . @ @ . @ . . . . . . . . . . . . . . . . . 
. . . . . @ . . . @ . @ @ . . @ @ . . . @ . @ . . . . . . . . . 
. . . . . . . . . . . . . . . . . . @ . . . . . . @ . . . . . . 
. @ . . . . . . . . . . . . @ . . . . @ @ . . . . . . @ . . @ . 
@ . @ @ . . @ . . . . . . @ @ . . . . . @ . . @ . @ . . . . @ @ 
. . . . . . . . . . . . @ . . . . @ @ @ . . . . . . . . @ . . @ 
. @ . . . . . . . @ . . . @ . . @ . . . @ . . . . . . . . . @ @ 
. . . . . . . . . . . . . . . @ . @ . @ . . . . . . . . . . . . 
. . . . . . . . . . . @ . . @ @ . @ . . . @ . @ . . . . . . @ @ 
. . . . @ @ @ . . . @ . . @ . . . . @ @ . . . . . @ @ . . . @ . 
. . . . @ @ . . . . . @ . . . . . . @ . . . . . . . . . . . @ . 
. . @ . . . @ . @ . @ . . . . . . @ . . @ @ . @ . . @ . @ . @ . 
@ . . . . . @ . . . . . . . . . @ . @ @ . @ . . . . . . . . . . 
. . . . @ @ . . . . . . @ . . . . . . @ . . . @ . . . . . . . @ 
. . . . . . @ . . . . . . . . . . . . . . . @ . . . . . . . . @ 
. . . . . . @ . . @ . . . . . . @ . . . . . . . . . . . . . . . 
. @ . . @ . @ . . . . . @ . . . . . . . . . . . @ . . @ . . . . 
. . . . @ . . . . . . . . . . . . . . . . . . . . . . . . . @ . 
. @ . . . . @ . . . . . . @ . . . . . . . . . . . . . . . . . . 
. . @ . . @ @ . . . @ . @ @ . . . . . . . . @ . . . . . . . . . 
60
3 31 31 29
9 25 21 17
8 12 27 29
22 25 8 17
31 14 23 29
7 28 2 30
27 8 29 18
28 9 6 2
15 4 27 24
0 0 17 7
15 31 17 10
21 30 27 11
31 22 18 12
29 20 15 11
19 27 14 7
31 4 4 17
16 14 26 25
21 10 10 20
13 28 28 12
25 8 12 27
22 2 12 9
22 27 13 20
18 28 28 21
30 13 28 31
15 14 27 23
31 29 23 13
24 20 22 11
7 2 15 9
27 18 7 31
1 31 26 1
30 9 18 16
13 6 3 0
7 20 7 8
8 15 22 17
3 0 24 5
11 9 3 22
16 19 4 7
23 31 20 31
24 3 24 27
17 21 17 29
17 7 28 9
27 31 23 10
25 15 2 14
25 11 19 7
10 22 29 26
24 29 4 30
29 3 25 27
8 14 14 13
23 30 20 24
6 22 24 3
11 6 17 18
30 26 26 7
3 10 3 4
28 28 13 8
19 7 20 8
22 14 4 24
15 1 7 23
15 2 6 18
9 14 18 30
27 2 30 26
