32 32
. . . . . . . @ . . . . . . . @ @ . . . . @ . . . . . . . @ . . 
. . . . . . . . . . . @ . . . . . @ . @ @ @ . @ . . . . . . . . 
. @ . . . @ @ . . . @ . @ . . . @ . @ . . . . . @ . @ . @ . . . 
. . . . . . . @ . . . @ . @ . . . . . . . @ @ . . . . . . . . @ 
. . . . @ . . . @ @ . . . . . . . . . . @ . . . . @ . @ . . . . 
. . . . . . . . . . . . . @ . @ . . . . . . @ . . @ . @ . . . @ 
. . . . . . . . @ @ @ . . . . . . . . . . . . . . . . @ . . . . 
. . @ @ . . . @ @ . . . @ . . . . . . . . . . . . . . . . @ . . 
. . @ . . @ . . . @ . @ . . . . . . . . @ . . . . . . @ @ @ . . 
. . . . . @ . . . @ . . . . . . . . . . @ . . @ @ . @ @ . @ . @ 
@ . . . . . . . . . . . . . . @ . . . . . . . . . . . . . . . . 
. . . . . . @ . . . @ @ . . . . . . . @ . . . . . . . @ @ . . . 
. @ . . . . . . @ . . @ . . . . . . . . . . . . . @ . . . . . . 
. . . . . . . . . . @ . . . . . @ . . . . . . @ . . . . . . . . 
. . . . . . . . . . @ . . . @ @ . . . . @ . . . . . . . @ @ . . 
. . . @ . . . . . @ . . . . . . . . . . . . . . . . . . . @ . . 
@ . . . . @ . . . . . @ . . . @ . @ . . . . . . . @ . . . . . . 
. @ @ @ . . . @ @ . . . . @ . . . @ . . . . . . . . . . . . . . 
. . . @ . . @ @ . . . @ @ . . . . . @ . . . @ . . . @ . . . . . 
@ . . . . . . . . . . @ . . . . . . @ . . . . @ . @ . . . @ . @ 
. . . . . . @ . @ . . @ . . @ . . . . @ . . . @ . @ . . . . @ @ 
. . . . . @ . . . @ . @ . . @ . @ . . . @ @ . . . . @ . . . . . 
@ @ . . @ . . . . @ @ @ . . . . . . @ . @ . . . . . . . . . . @ 
@ @ @ . . . . . . . @ . . @ . . @ . . . . . . @ . . . . . . . . 
. . . . . . . . . @ . . @ . . . . . . @ . . . . . . . . @ . @ @ 
. . . @ . . . . . @ @ . . @ . @ . . . @ . . @ . . . @ . . . . . 
. @ . @ . . . . . . . @ . . . . . . @ . . . . . @ . . . . @ @ @ 
@ . @ . . . . . . . . . . @ . @ . @ . @ . . . . . . @ @ . . . . 
. . @ . . . . . . @ . . . . . . @ . . . . . @ . . . . . . @ @ @ 
. . . . . . . @ . . . . . . . . @ @ @ . . @ . . @ . @ . @ . . . 
@ . . . @ . @ . . . . . . . . . . . . . . . . . . . . @ . @ @ . 
. . . . . . . . . . . . . @ . . . . . . . . . @ . . . . . . . . 
70
24 24 25 23
1 3 5 19
2 19 22 14
23 24 14 10
7 21 14 26
10 5 21 2
22 2 1 10
19 22 10 0
16 30 22 26
2 18 1 7
8 28 19 12
30 7 13 9
8 30 29 23
7 28 9 0
11 14 14 24
7 26 26 15
1 28 17 6
5 17 4 23
2 5 14 4
1 6 30 5
13 16 31 2
29 31 30 21
9 14 20 29
1 19 28 27
3 14 1 11
15 20 22 20
3 9 5 3
14 18 2 24
12 26 9 20
21 27 26 3
23 2 4 20
10 3 7 12
26 28 1 8
25 30 22 29
14 2 27 10
17 13 12 26
2 14 11 5
28 7 15 21
17 15 8 0
2 26 22 1
21 18 0 12
9 27 27 20
22 12 8 31
8 21 10 15
30 17 8 27
5 0 27 0
14 24 10 19
23 25 21 9
0 29 21 31
12 11 25 6
19 2 4 31
21 4 17 7
12 1 12 8
15 30 16 8
27 31 20 2
29 21 17 9
6 9 31 18
30 13 17 25
7 11 6 22
15 11 15 23
15 24 6 23
12 21 14 22
15 4 14 0
26 11 21 4
14 17 21 30
30 14 6 8
0 8 22 23
10 8 20 24
23 16 25 14
24 13 4 13
