32 32
. . . . . . . . . @ @ . . . . . . . . . . . . @ . . @ . . . @ . 
. @ @ . . . . . . . . . . . . @ . . . . . @ @ . . . @ . . . . . 
. . . . @ @ . . . . @ @ . @ . @ @ . @ @ . . . . . . . . . @ @ @ 
. . @ . @ . . . . . . @ @ @ . . . @ @ . . . . . . @ . . @ @ . . 
. @ . . . . . . @ . . . . . . . . . . . . . . . . @ . . . . . . 
@ . @ @ . . @ . . . . @ . . . . . @ . @ . . . @ @ @ . . . @ . . 
@ . . . . . . . . @ . . . . . . @ . . . . . . . . . . . . . . . 
. . . . . . . . . . . . . . . . @ . . . . @ . . . . . @ . @ . . 
. . . . . . . . . . . . . . @ . . . . . . . . . . @ . . @ . @ . 
. . @ . . . . . . . . @ . . . . . . . . . @ . . . . @ . @ . . . 
. @ . @ . @ . . . . . . . . . . . @ . . . . . @ . @ . . . . @ . 
. . @ . . @ . . @ . . @ . . . . . . @ . . @ @ . . . . . . . . @ 
. . @ . . . . . . . @ . . . . @ . @ . @ . . . . . . . @ . . . @ 
@ . . . @ . . . . . . @ . . . . . . . . @ . . . . . . . . . . . 
. . . . @ . . . @ @ . . . . . . . . . . @ @ @ . . . . @ @ . @ @ 
@ . . . . . . . . . . . @ . . . . . . . . . . . . . . . @ . . @ 
. @ . @ . . . . @ . @ . . @ . . . @ . . . . . . . @ . . . . @ . 
@ . . . . . . . . . . @ . . . . . @ . . . . . @ @ . . @ . . . . 
. . . . @ . . . . . @ . . . . . . . . . @ @ . . . . . @ . @ . . 
. . . . . @ @ . . . . . . . . . . . . . . . @ . @ . . . @ @ . . 
. . . . . . . . . . . @ . . @ @ @ . . . . . . . . . . . . . . . 
. @ . . . @ . . . . @ . @ . . . . . . @ @ . . . . . . @ . . @ . 
. @ . . @ . @ @ . . . . . . . . . . . . . @ . . . . @ . . . . . 
. . . . . . . . . . . . . . . . . . . . . . . . . . @ . . . @ . 
. . . . . @ . . . . @ . @ . @ . . . . . . . . . @ . @ . @ . . . 
. . . . . . . . . . . . . @ . @ . . . . @ @ . . . @ @ . . . . @ 
. . . @ . @ . @ . . . @ . . . @ . . . . . @ . . . . . . . . . . 
@ . . . . . . @ . @ . . . . . . . . . @ . . . @ . . . @ @ @ . . 
@ . . @ . . . . @ @ . . @ @ . . . @ . @ . . . . . . . . . @ . . 
. . @ . . . . . @ . . @ @ . . @ . . . . . . . . . . . . @ @ . @ 
. @ . . @ . . . . @ . . @ . . . . . . @ . @ @ . . . . . @ . @ . 
. . . . . . . . . . . . . . . . . @ . . . . . . . . . . . . . . 
10
15 28 3 8
5 13 8 31
9 24 21 13
26 30 22 5
16 25 2 27
22 4 18 13
20 22 9 3
5 30 4 25
30 31 5 31
24 1 11 15
