32 32
. . . . @ . . . @ @ . . . . . . . . . @ . . @ . . . . . . . . . 
. . . . . @ . . . . . . . . . . . . . . . . . . . @ @ @ . @ . . 
. . . . . . . . . . @ . . . . @ . . . @ . @ @ . @ . . @ . . . @ 
. . . . . @ . . . @ @ @ . . @ @ . . . . . . . . . . . . . . . . 
. . @ . . . . . . . . @ . . . . . . @ @ @ . . . . . . @ @ @ . . 
. . . . . . . . @ @ . . . . . . . . . . . . . . @ . . @ . . @ . 
. . . @ . @ . . . @ . . . @ . . . . @ @ . @ . . . . @ . . @ . . 
. . . . . . @ . . . . @ . . @ . . . . @ . . . . . . . . . . . @ 
@ . . . . . . . . @ . . @ . . @ . . . . . . @ . . . . @ . @ . . 
. . . . @ @ . . . . . @ . @ . @ . @ . . . . . . @ . . . . @ . . 
. @ . . . . . . . . . . . . @ . . . . . . . . . @ @ . . . . . . 
. . . . . . . @ @ . . . . . . @ . . . . . . . . . . . . . @ @ . 
. . @ @ . @ . . . . . @ . . . . @ @ . . . . @ . . . . . . . . @ 
. . . . . @ . . @ . @ . @ . . . @ . . . . . @ @ . . . . . . @ @ 
. . . . . @ . @ . @ . . . @ . @ . . . . . . . . . . . . . . . . 
. @ . . . . . . . @ . . @ @ . @ . . . . . . . . . . . . @ . @ . 
. . @ . . . . . @ @ . . . . @ @ . . . @ @ . . . @ . . . . . . @ 
. . . . @ . . . @ . @ @ . @ . . . . . @ . . . . . . . . . . . . 
. @ . @ . . . . . @ . . . . . @ @ . . . . . . @ . . . . . . . . 
@ . @ @ . . @ . . . @ . . . . @ . @ . . . @ @ . @ . . . . . . . 
. . . . . . . . . . . . . @ . . . . . . . . . . @ . @ . . . . . 
. . . . . . . . . . . . @ . . . . . . . . . @ @ . . . . @ @ @ . 
. . @ @ @ . . . @ @ . . . . @ . @ @ . . . . . . . . . . . . . . 
. . @ @ . . . . . . . . . . . . . . @ @ . . @ . . . . . . . @ . 
. . . . . . . . . . @ . . . . . . . . @ . . . . . . . . . . . . 
@ . . . @ . . . . . . . @ @ . . . . . . . . . . . . . . . . . @ 
. . . @ @ @ . @ . @ . . . . . @ . . . . . . @ @ . @ . @ . . . . 
. . . . . . . . . . @ @ . . . . @ . . . @ . . . . . . . . . . @ 
@ . @ . . . . @ . @ . . . . . . . . . . . @ . . . . . . . . . . 
. . . . . . . . . . . @ @ . . . . @ . . . . . . . . @ . @ @ @ @ 
@ . . . . . . . . @ @ @ . . @ @ . . . @ . . . . @ . . . . . . . 
. . . . . @ . . . . . . @ . . . . . . . . . . . @ . . . . . . . 
40
24 24 4 8
7 2 19 14
13 19 27 12
2 24 30 9
3 30 26 30
14 2 20 9
30 3 21 25
25 19 31 1
23 20 28 17
0 16 14 5
0 12 1 28
21 23 14 19
18 14 25 20
28 24 17 26
23 27 16 23
6 4 3 0
1 29 10 6
17 26 29 24
27 24 31 17
15 17 2 0
30 20 25 23
18 28 11 23
27 0 8 14
23 25 17 10
22 5 19 3
20 15 28 18
0 0 15 0
11 5 23 29
27 12 26 10
12 26 30 7
20 13 25 8
23 6 23 10
8 14 22 16
17 27 0 9
22 31 13 30
5 11 23 25
19 13 8 8
15 6 8 1
8 29 5 27
20 30 0 27
