32 32
. . . . @ . . . . @ . . . . . . @ . . . . . . . @ . . @ @ @ @ . 
. . . . @ . . . . . . . . . @ . . . . . . . . . . . . . . . . . 
@ . @ . . . @ . @ . . . . . @ . . . . . . . @ . . . . . . . . . 
. . . . . . . . . . . . @ . . . . @ . . . @ . . . . . . . . . . 
. . . @ . . @ . . . . . . . . . . . . . . . @ . . . @ @ . . . . 
. . . . . . . . @ . . . @ . . @ @ @ . . . . . . . . . @ . @ . . 
@ . @ @ . . . @ . . . . . . . . . @ . @ @ @ . . . . . . @ @ @ . 
. . . . . @ @ . . @ . @ . . . @ . . . . . @ . . . . . . . . @ . 
@ . @ . . @ . . . . . @ @ . . . . . . . @ @ . @ . . . @ . . . . 
@ . . . . @ @ . @ . . . . . @ . @ @ . @ . . . @ . @ . . . @ . @ 
@ . . . . @ . . . . . . @ . . . . @ @ . . @ . . @ . @ . . . @ . 
. . @ . . . . . . . . . . . @ @ . . . . . @ . . . . . @ . . @ . 
. . . . . . . . @ . . . . . . . . . . . . . . . . . . . @ . . . 
. . . . @ @ . . . @ . . . . @ . . . . . . . . . @ . . . . @ . . 
@ . . . . . . @ . . . . . . . . . . @ @ @ . . . . @ . . . . . . 
@ . . . . . . . . @ . . . . . . . . . . . . . . . . . . . . . . 
@ . . . . . . . . . . . . . . . . . @ . . @ . . @ . . . . . . . 
. . . . . . . . . @ . . . . . . . . . . . . @ @ . . . . . . . . 
. . . . . . . . . @ . . . . . . . . . @ . . . . . . . @ . . . . 
. . @ . . . @ . . . . . . @ . . . . . . @ . @ . . . . . . . . @ 
. . @ . @ . . . . . . . . . . . . . . . @ . . . . . . . . @ . . 
. . . . . . . . . . . . . . . @ . @ . . . . . . . . @ . . . . @ 
@ . @ . . . . . @ . . . . . . . . . . . . . . . . . . @ . . . . 
. @ . @ . . . . . . @ . . . . . . . . . . . . @ @ . . . . . . . 
@ . . . . . . @ . . . . @ @ . . . . @ @ . . . . . @ . . @ . @ . 
. . . . . . . . @ . . . . . . @ . @ . @ . . . . . . . @ . . @ . 
. @ . @ @ . . . . . . . . . . @ . . . . . . . . . . . @ @ . . . 
. . . @ . @ @ . . . @ . @ . @ @ . . . . . . . . . . . . . . . . 
. . . . @ . @ . . @ @ . @ . . @ . . . @ . . @ . @ . @ . . . @ . 
@ @ . . . . @ . . . . @ . @ . . . . . @ . . . . . . . . @ @ @ . 
. . . . . . . @ . @ . @ . . @ . @ . . . @ @ . . @ . . . . . @ @ 
@ . . @ . . @ . @ @ . . . . . @ . . . @ @ . @ . . @ @ @ . . . . 
40
28 22 14 5
2 15 17 12
9 8 1 5
4 7 18 6
2 1 28 7
11 2 17 14
12 31 28 16
29 28 20 24
14 26 26 23
8 4 5 30
23 6 2 23
1 6 21 14
21 4 28 23
25 19 11 0
27 2 16 10
22 9 24 24
0 27 12 2
13 16 28 4
17 24 21 27
3 7 22 10
22 20 16 15
18 11 0 18
28 23 8 20
3 22 28 22
24 15 16 1
22 15 26 26
17 11 5 24
31 16 17 26
11 22 16 27
0 28 24 25
13 11 2 7
26 27 5 20
15 29 23 31
16 27 13 9
27 10 1 8
17 17 10 8
22 5 29 22
18 20 3 29
12 20 12 21
26 12 27 24
