32 32
@ . . . . . . . . . . . . . . . . . @ . . . . . . . . . @ @ @ . 
@ . . . . . . . . . . @ . . @ . . . @ @ . . @ . . . @ . . . . @ 
@ . . . . . . . . . . . . @ @ @ . @ . @ . . . . @ . . . . . . . 
. . . . . . . . . . . . @ . . . . . . . . @ . . . . . . . . . . 
. . . . . . . . . . . . . . @ . . . . . @ . @ @ @ . . . . . . @ 
. . . . . . @ . @ . . . . . . . . . . . . @ . . . . . . . . . . 
. @ . . @ @ . . @ . . . . . . @ . . @ . @ . . . . . . . . . . . 
. . . . . . @ . . . @ . . . @ . . . . . . . . . . . . . . . . @ 
. . @ @ . . . . . . . . . . . . @ . . @ . . @ . @ . . . . . @ @ 
. . @ . . . . . . . . . @ . . @ . . . . @ @ @ . . @ @ @ . . . . 
. . . . . . @ . . . . . @ . . @ @ @ . . . @ . . @ . . . @ . . . 
. @ @ . @ . . . @ . . . . . . . . @ . @ . @ . . . @ @ . . . . . 
@ . . @ @ . . . @ . . . @ . . @ . . . . @ . . . . . @ . . @ . . 
@ . @ @ . . @ @ . . . . . @ @ . . @ . . . @ . @ . . . . . . . @ 
. @ @ . . . . . . . @ . . @ @ . . @ @ @ . . . . . @ @ . @ . . . 
@ . . . . . . @ . . . . . . . . @ . . @ . . . . @ . . . . . . . 
. . . . . . @ . @ . . . @ . @ . @ . . . . . @ . @ . . . . . @ . 
. . . . . . @ . . . . . . . . @ . . . . . . . . . . . @ . . . . 
. . . . . . . . . . . . . . . @ . . @ @ . . @ . . @ . . . . . @ 
. @ . @ . . @ . @ . . . . . @ . . . . . . . . . . . . . . . . . 
. . @ . . . . . @ @ . . . @ . . @ . . . @ . . . . @ . . . @ . @ 
. . . . . . . . . . . . . . . @ . @ . . . . . . . @ . @ . . . . 
. . . . . . . . . . . . . . . . . . . @ . . . . . . . . @ . . . 
@ . . . . . @ . @ @ . . @ . . @ . . . . . . @ . . . . . @ . . @ 
@ . . . . . . . . @ . . . . @ . . . . @ @ @ . . . . . . . . @ . 
. . . . . . @ @ . . . . . . . . . . . . . . . . . . . . . . . . 
. . . . . . @ . . . . . . . . . @ @ . @ . . . . @ . @ . . . . @ 
. @ . . . . . . . . . . . @ . . . . . @ @ . @ @ . @ . . . . @ . 
@ @ . @ . . . . . . . . . . @ @ . . . . . . . . @ . . . @ . . . 
. . . . . . . . . . . . . @ . @ . . . . @ . . . . @ . . . . . . 
. . @ @ . . . . . . . . . . . . . . . . . . . @ . . . . . . . . 
. . @ @ . . @ . @ . . . . @ @ @ . . . . . . . . . . . . . . . @ 
30
10 21 21 17
27 5 13 11
23 15 30 11
24 21 31 22
2 22 9 27
26 10 1 25
11 27 12 4
24 18 29 25
26 2 25 15
22 17 14 17
14 6 3 1
7 30 30 17
18 22 10 17
24 13 21 19
21 20 23 1
9 6 21 27
15 13 27 28
27 18 19 12
9 7 1 8
28 12 11 29
9 16 22 13
16 17 4 3
1 30 4 0
12 11 30 25
22 31 20 7
26 25 16 21
29 14 25 22
4 1 7 11
7 20 20 31
10 16 23 2
