32 32
. @ . . . @ @ @ . . . . @ . . @ . @ . @ @ . @ . . . @ @ . . . . 
. @ . . @ . . @ . . @ . . . @ . @ . @ @ . . @ . . . . . . @ @ . 
. . @ . . @ @ @ . . . . . @ . . . @ . . . . @ . . @ . . . @ . @ 
@ . . @ . . . . . . . . . . @ . . . . . @ @ . . . . @ . . . . . 
. . . @ . @ . . . . . . . @ . . . @ . . . . . . . @ . . . . . . 
. . . @ . . . . . . . . @ @ @ . . . . . . @ . . . . . . . . . . 
. @ @ . . . . . @ . @ @ . . . . . . . . . . . . . . . . . @ . . 
. . . . . . . @ . . . . . . . @ @ . @ . @ . . . @ . @ . @ . . . 
. . . @ . . . . @ . . . . . @ @ @ @ . @ . . . . @ . . . . . . . 
@ . . . . . . . @ @ @ . . @ . . . . @ . . . . . . . . . . . . . 
. . . . @ @ . . . @ @ . . . . . @ . . @ @ . . @ @ . . @ @ . . . 
. . . . . . . . . @ . . . . . @ @ . . . . . @ . . . . . . . . . 
. . . @ . . . . . . . @ . @ . . @ . @ . . . . . . . . . . . @ . 
. . . . . @ . @ . . @ . . . . . . . @ . . . . . . . . . @ . . . 
. . . . . . @ . . . @ @ . @ . . . . . . . @ . . . . . . . @ . . 
@ . . . . @ . . . . . . . . . . . . . . . . . . . . . . . . . . 
. . . . . . . . @ . . . . . . . . . . . . . . . . . . . . . . . 
. . . . . . . @ . . . . . . . . . . @ . . . . . . @ . . . . @ . 
@ . . . . . . . . . . @ . . @ . . . . . . . . @ . . . . . . . . 
. . @ . . . . @ . . . . @ @ @ . . @ . . . . . @ . . . @ . . . @ 
. @ @ . . . . . . @ . . . . . . . . @ . @ . @ @ . . . . . . . @ 
@ . @ . . . . . @ . . . . . . @ . . @ . . . . . . . . . . . . . 
. . . @ @ . . . . . @ . . @ . @ . . . . . . . . @ @ . . . . . . 
. @ @ . @ . . @ . . . @ . . . . @ . . . . . . . @ . . . . . . @ 
. . . . . . @ . . . . @ . . . . . . . . . @ . . . . . . . . . . 
. . . . @ @ . @ @ @ . . . @ . . . . . . @ . . . . . . . . . . . 
. . @ . . . . . . . . . . . . . @ . . . . . . . . . . . . @ . . 
@ @ . @ @ @ . . . . . . . @ @ . . . . . . . . . . . . @ @ . . @ 
. . . . . @ . . @ . @ . . . . . . . . . . @ . @ . . . . . @ . . 
. . . . . . . . @ . . . . . @ . . . . . @ . . @ . . . . @ . @ . 
. . . . . . . . . . . . . @ . . . . . . . . . . @ . . . @ . . . 
. . . . . . . @ . . . . . . @ . . . @ @ . . @ @ . . . . @ . @ @ 
60
22 18 0 23
16 9 10 25
1 10 6 16
7 30 9 31
1 21 2 11
7 14 9 27
26 17 27 21
28 17 8 27
21 6 8 2
13 0 30 7
9 2 23 23
17 17 19 25
18 30 26 29
31 3 31 12
3 6 28 19
17 25 28 14
12 22 3 23
0 2 29 23
0 10 9 28
22 8 2 16
23 0 25 10
0 22 9 4
7 6 0 7
12 21 15 30
30 3 16 9
9 26 1 7
4 3 5 8
1 8 26 2
12 13 17 6
10 7 31 17
24 31 21 17
13 11 4 20
6 26 30 27
6 16 23 4
30 30 4 9
2 5 11 26
22 5 30 11
20 21 15 26
2 18 20 1
30 2 4 31
13 1 0 4
25 0 15 3
26 22 27 23
22 21 4 12
6 31 16 22
9 15 26 26
28 26 17 28
9 3 21 30
2 8 1 19
25 23 17 21
7 16 3 25
26 28 27 5
26 16 1 17
3 17 11 29
8 3 8 7
7 20 0 29
1 2 22 14
12 15 19 3
25 10 9 1
17 31 1 18
