32 32
. @ . . . @ . . @ . . . @ @ . . . . . @ . . . . @ . @ . . @ . . 
. @ . . . . . . @ . . . . . . . . . . . . . . . . . . . . . . . 
. . . @ . . . . . @ . . . @ . . @ . . . @ . . @ @ . . . @ . . . 
. . . . . @ . . . . @ . . . . . @ . . . @ @ @ @ @ . . @ . @ . @ 
. . . . @ . . . . . . @ . @ . @ . @ @ . . . . . @ @ . . @ . . . 
. . @ . . . . . @ . . . . . . . . @ @ @ . . . . . @ . . . . . @ 
. @ . . . . . . . . @ @ . . . . . . . . . . . . . . . @ @ . . @ 
. . . . . . . . . @ @ . @ . . . . . @ @ . . . . @ @ @ . . . . . 
. . . . . . . @ @ . . . . . . . @ . . . . @ . @ . . . . . . . . 
. . . . . @ @ @ . @ @ @ . . . @ . . . . . . . . . . . @ . . . . 
@ . . . . . . . . . . . . . . @ @ . @ . @ @ . . . . . . . . . @ 
. . . @ . . . @ . . . . . . . . . . . @ @ . . . . @ . @ . . . . 
. @ @ . . @ . @ @ . . . @ . . . . @ . . . @ . . @ . . . . . . . 
@ . @ . @ . . . . . @ @ . @ . @ . . . . . @ . . . . . . . . . . 
. . . . . @ . . . . . . . . . . @ . . . . . . . . @ . @ . . . . 
. . . . . . . . . . . @ @ @ . . @ . . @ . . . . . . . @ . . . . 
. . . . @ . . . . @ . . . . . . . . . . . . . . . @ . @ . . . . 
@ . . @ . . @ . . . . . @ . . . . . . . . . . . @ . . . @ . . . 
. @ @ @ . . . . . @ . . . . . . @ . . . . . . . . . @ . . . . . 
. . @ @ . . . . @ . . . . . . . @ . . . . . . . . . . . . . . . 
@ . . . . . . . . . @ . . . . @ . @ . @ @ . . @ . . . . . . @ . 
. . . . . . @ @ @ . . . . . . . . @ . . . . . . . . . @ . . . . 
. . . . . . . . @ . . . . . . . . . . @ . . . . . . . . . . . . 
. . @ . . . . . . @ . . . . . . . . @ . . . . . . . . . . @ . . 
. . @ @ . . . @ . . . . . @ . . @ @ . . . . . . . @ @ . . @ . . 
. . . . . . . . . . @ . @ @ . . . @ . . . . . . . . . @ . @ @ @ 
. . @ . . . . @ @ . . . . . . . . . . . . . @ . . @ . . . @ . . 
. . @ @ . . @ . . . . . . . . . . @ @ . . . @ . . . . . . . . . 
. @ . @ @ . . . . . . @ . . . . . . . . . . . . . . . . @ . . . 
. . @ @ @ . . . . . @ . . . . . . @ . . @ . . . . . . . . @ . . 
. @ . . . @ . @ . . . . . . . . . . . @ . @ . . . . @ . . . @ . 
. @ . . . . @ . . . . . . . . . . . . . . . . . . . . @ @ . . . 
50
1 23 7 27
19 3 7 20
9 20 14 26
11 21 11 25
9 15 8 31
30 9 21 11
21 17 21 31
29 30 10 8
16 1 3 13
14 17 22 1
30 13 29 12
30 26 12 20
31 13 14 12
30 12 6 14
19 18 14 15
7 2 25 0
30 17 29 21
18 28 5 8
30 27 15 23
19 14 0 18
1 20 24 28
29 14 22 14
22 4 16 13
21 26 28 21
10 2 11 27
8 6 0 26
4 27 24 23
23 21 20 21
9 21 19 21
22 22 6 26
12 28 9 10
4 8 25 10
26 14 28 1
0 9 20 14
29 22 10 17
15 14 12 9
13 22 14 10
9 25 19 23
29 15 16 22
7 3 4 17
11 25 16 1
15 12 24 15
21 18 7 31
8 4 24 26
10 27 23 24
14 9 5 28
25 8 14 8
1 14 0 14
0 0 11 26
21 28 30 24
