32 32
. . . . @ . . . . . . @ . . . . . @ . . . @ . . . . @ . . . . . 
. . . . . . . . . . . . . @ . . @ . @ @ . @ . . . @ . . @ . . . 
. . . . . . . . . . . . @ . @ . . . . . . @ . . . . . . . @ . . 
. . . . . . . . . @ . . . . . . . . @ . . . . . . . . . . . @ . 
. @ . @ . . . @ . . . . . . . . @ . . . @ . . . @ . . . . . @ . 
. . . . @ @ @ . . . . . . . . @ @ . . @ . . . @ . @ . . . . @ . 
. @ . . . . @ @ . @ . . . @ . . @ @ . . . . . . . . @ @ @ . @ . 
. . . . . . . . . . @ . . @ . . . . . . . . . @ . @ . @ . . . . 
. . . . @ . . . . . . . . . . . . . . . . . . . @ @ . . . . . @ 
@ . @ . . @ . . . . . @ . . . . . . @ . . . . @ . . @ . . . . . 
. . . . @ . . . . . . . . . . . . . . @ @ @ @ . . . . . . . . . 
. . . . @ . . @ . . . . @ . . . . @ . . . . . @ . . . . . . . . 
. . @ . @ . . . . . . . . . . . @ @ . . . . . . . . . . . . @ @ 
. . . . . . @ . . . . @ . . @ . . @ . . . . @ . . . . . . . . . 
@ . . . @ . . @ . @ . @ . . . . . @ . . . . . . . @ @ . . @ @ . 
. . . @ . . . . . . @ . . . . . . . @ . @ . . . . . . . . . . @ 
@ . . . . @ . . . . . . . . . . . @ . @ @ . . . . @ . . . @ . . 
. . . @ . . . . @ . . @ . . . @ @ . . . . . . . . . . . . . . . 
. . . . @ . . @ . . @ . . @ . . . . . . . . . . @ . . . . . . . 
@ . . . . . . @ @ . . . . . @ @ . @ . @ . . @ . . . . . . . . . 
. . . . @ . @ . @ @ . . @ . . . . . . . . . . @ @ . @ . . . . . 
. @ . . . . . . @ @ @ . @ . . . . @ @ . . . @ . . . . . . @ . . 
. . . . . . . @ . . . . . . . @ . . . @ . . . . . . . . @ . . . 
. . . . . . . . . . . . . . @ @ . . . . @ . . @ . . . @ . @ . . 
. . . . . @ . . . . @ . @ @ . @ . . @ . @ . . . . . . . . . @ . 
. . @ @ . @ . @ . . . . . . . . . . . @ . . . . . . . . . . . . 
. . . . . . . . . @ . @ . . . . . . . . @ . . . . . . . . . . . 
. @ . . . . . . . . . @ . . . . . . . . @ . . @ . . @ . . . . . 
@ @ . . . . @ . . . . . . . . . . . . . @ . . . @ . . . . . @ @ 
. . . @ @ . . . . . . @ . . @ . . . . @ @ @ @ @ @ . @ . . @ . @ 
@ . . . . . @ . . . . . @ . @ . . . . . . @ . @ . . . . . . . @ 
. @ . . . @ . . . . . . @ . . . . . . . . . . . @ @ . . @ . . . 
30
27 25 30 7
8 23 5 8
12 22 15 3
27 29 17 17
3 18 28 26
4 3 31 16
6 4 9 4
3 10 17 10
4 17 0 0
8 9 10 6
22 16 14 21
10 16 26 10
0 21 31 22
14 8 29 17
15 3 13 4
20 2 21 26
6 21 8 22
1 25 11 23
26 30 11 7
24 24 8 12
1 1 0 17
2 22 10 12
16 8 21 11
5 21 6 26
24 13 7 10
13 19 20 17
3 19 25 15
8 29 5 7
9 10 12 27
22 22 16 3
