32 32
. . . . . . . . @ . . . . . . . . . . . . . @ @ @ . @ . @ . . . 
. . . @ . . . . @ @ . . . . . @ . . @ . . . . . @ . . . @ . . @ 
. @ . . . . . @ @ . . . . . @ . @ . . @ . . . . . @ . . . . . @ 
@ . . . . . . . . . . . . @ . . . . . . . . . . @ . . . . @ . @ 
. . . . . . . . . . . . . . . . . . . . @ @ . . . @ . . . . . . 
. . . . . @ . @ . . . . @ . . . . . . . @ . . @ . . . . . . . @ 
. . . @ @ . . . . . @ . @ . @ . . . . @ . . @ . . . @ . . . @ @ 
. . . . . . . . . . @ . @ . . . @ . . . . . . . . . . . . . . @ 
. . . . . . . . . . . . . . . . @ . . . . @ . . . @ . . . . . @ 
@ . . . . . . . . . . . @ @ . . . . @ . . . . . . . . @ . . . . 
. @ . . . . . . . . . . . @ . . . @ . . @ . @ . . . . @ . . . . 
. . . . . . . . @ @ . . . . . . . . . @ . @ . . . . . . @ . . . 
. . @ . . . . . . . @ . . . @ . @ . @ . . . . @ . @ . . . @ . . 
@ . . @ . . . . . @ . . . @ . . . . . . . . . . . @ . @ . . @ . 
. . . . . . . . @ . . @ . . . @ @ @ @ . . . . . @ . . @ @ . @ . 
. @ . . . . . @ . . . . . . . @ . . . . . . . . . . @ . . . . . 
. . . . . . . . . . . . . @ . . @ . . @ @ @ . . @ @ @ . . . . @ 
. . @ . @ . @ @ . . @ . . . . . . . . . . @ @ . . . . . . . . @ 
. . . . @ . @ . . . . . @ . . @ . @ . . . . . . . . . . . . . @ 
. . @ . . @ . . @ . . . . @ . . . . . . . . @ . . . . @ . . . . 
@ @ . @ . . . . . @ . . . @ . @ . . . . . . @ . @ . . . . . . . 
@ @ . . . . . . . . . . . @ . . . . . @ . . @ . @ . . . . . . . 
. . @ . @ . . . . . . . . @ @ . . . . @ . . @ . . . @ . . . . . 
. @ @ . . . . . @ . . . . . . . . . . . @ @ @ . @ . . . . . . . 
. @ . . . . . . . . . . . . . . . . @ @ @ @ @ @ . @ @ . . @ . @ 
@ . . @ . . . . . . . . . . . . @ . . . . @ @ . . . @ . . @ . . 
. @ . . . . . . . . . . @ . . . . . . . . . @ @ . . @ . . @ . @ 
. . . @ . . . . . . . . . . . . @ . . @ . . . . @ . . . . . . . 
. . @ . . . . . @ . @ . . . . . . @ . . . . . . . . . . . . . . 
. @ @ . . . . . @ . . . . . . @ . . . . . @ . . . . . . . . . . 
@ @ . . . . @ . . . @ . . . . . . . . . . . . . . . . . . . . . 
. . . . . . @ . . . . . . . . . . @ . . . . @ @ . . @ . . . . @ 
40
22 29 19 9
27 21 8 24
1 17 19 17
27 18 29 11
12 10 21 7
29 7 2 5
22 28 28 25
12 22 21 30
28 23 23 21
0 26 13 14
19 0 21 10
24 11 10 26
30 2 10 18
24 12 3 31
20 17 17 24
10 31 0 2
3 14 10 5
0 29 25 7
5 31 25 26
3 5 22 3
1 11 4 2
0 12 0 17
3 29 5 29
28 4 12 19
0 11 20 31
31 14 7 30
14 17 29 31
24 24 21 3
11 1 4 26
15 4 11 30
0 6 5 20
17 22 20 27
28 5 10 8
21 10 21 5
11 22 6 4
23 20 26 23
20 0 19 30
22 14 17 11
13 5 15 17
15 7 4 8
