32 32
@ @ . . . . . . . . @ . @ . . . @ . . . . @ . @ . . . . . . . @ 
. . . . . . @ . . . . . . . . . . @ . @ . . . @ . @ . . . @ @ . 
. . . . . . . @ . . . @ @ @ . . . . . . @ . . . . . . . . . . @ 
@ . . . . @ . . . . . @ . . . . . . . @ . . . . . . . . . . . . 
. . @ . . . . . . . . . @ @ @ @ . . . . @ @ @ . . . @ . . . . . 
. . . . @ . . . . @ @ . . . . . . . . . . . . . . . . @ . . . . 
@ . . . . . @ . . @ . . @ . . @ @ . . . . . . . . . @ @ . . . @ 
. . . . @ . @ . . . . @ . @ . . . . . . . . . . . @ . . . . . . 
. . . . . . . . . . . . . . . @ @ . . . . . . . . . @ . @ . @ . 
. . . . @ . . . . . @ . . . . . . . @ . . . . . . . @ . . @ . @ 
. . . . . @ . @ . . . @ @ @ . . . . . . . . . . . @ . . . . . . 
. . . . @ . @ . @ @ . . . @ . . @ @ . . . @ @ . . . . . . @ @ . 
. . . . . @ . . . . . . . . @ @ . . . . @ . . . . . . . @ . . . 
@ @ . . . . . . . . @ @ . . . . . . . @ . . . @ @ @ . @ . . . . 
. . . @ @ . . @ . . . . . . . . @ . . @ @ . . . . @ . . . . . . 
. . . . @ . . . . . . . . . @ . . . . . . . . . . . . . . . . . 
. . . . . . @ . @ . . . . . @ . . @ . . . @ . . . . . . . . . . 
@ . . . . . @ . . . . . . . . @ . . . . . @ . . @ . . . . . . . 
. @ . . . @ . @ . . . . . @ . . . . . . . . @ . . . . . @ . @ . 
@ . . . . . . @ @ . . . . . . . . . . . @ @ . . . . . . . . . . 
. . . . . . @ . . . @ . . . . @ . . . @ . @ . . @ . . . @ @ . @ 
. . . . @ . . @ . . @ . @ . . . . . . . . . . . . . . . . . . . 
. . @ . . @ . . . . . . . @ . . . @ . . . @ @ . . @ . . @ . . @ 
. . . @ . @ . . . @ . @ @ @ . . . . . . . . . . . @ . . . . . . 
@ . . . . . . . . . . . . . . . . . . . . . . @ . . . . . . . . 
. . . @ @ . . . . . @ @ . . . @ @ @ . . @ . . @ . . . @ . . . . 
@ . . . . . . @ . . . . . . @ . . . . . . @ . @ . . . . . . @ . 
. . . . @ . . . . @ @ @ . . . . . . . . . . @ . . . @ . . @ . . 
. . @ . . . . . @ . . @ . . . @ @ . . . . . . . . @ @ @ . . . . 
. . . . . . . . . @ @ . @ . . . . @ . . . . @ . . . . . @ . . . 
. . . . . . . @ @ . . @ . @ . . . . . . @ . . . . . . . . . . . 
. . . . @ . . . @ . @ @ @ . . . . . . . . . . . . . . . . . . @ 
50
14 18 2 9
16 3 29 5
5 15 30 21
30 17 20 13
14 9 1 31
4 18 31 15
14 8 9 22
12 16 2 16
10 16 3 28
30 27 0 27
2 27 4 30
16 5 23 3
19 10 26 1
6 15 22 15
14 3 4 18
1 22 6 25
26 29 12 9
5 2 8 5
21 13 28 17
29 21 30 9
12 8 8 0
26 13 2 7
30 25 8 27
9 1 9 26
23 10 23 7
27 23 7 25
17 7 23 27
5 8 16 7
6 14 24 4
19 30 11 12
27 18 19 12
19 23 23 10
28 11 3 17
24 30 1 24
17 2 21 7
12 12 1 20
3 9 23 28
8 24 5 26
13 25 2 24
24 2 27 12
27 24 27 30
17 19 4 3
21 27 27 20
8 14 19 2
17 5 28 1
10 11 14 0
26 22 25 2
21 10 6 4
21 9 6 28
22 1 1 16
