32 32
. . . . . . . . . . . . . . @ @ . . . @ @ . . . . @ . @ . . . . 
@ @ . . . @ . . . . . . . . @ . . . . @ . . . . . . . . @ . @ . 
. . . . @ . . . . @ . . . @ . . . . . @ . . . . @ . . . . . . . 
. . . . @ . . @ . . . . . @ . @ . . . . . . . . @ . . . . @ . . 
@ . . . @ . @ . @ @ . @ . @ . . @ . . . . . . @ . . . . . @ . . 
@ . . . . . @ . . . . . @ @ . . . . . . . . . @ . @ . . @ . . @ 
. . . . . . @ . . . . . @ . @ . . . @ @ . @ . . . . . . . . . @ 
. . . . . . @ . . @ . . . . @ . . . . @ . . . @ . . . . . . . . 
. . . @ . . . . @ . . . . . @ . . . . . . . . . . . . . . . . @ 
. @ . . . . . . . @ . . . . . . . . . . . . . @ . . . . @ @ . . 
. . . . . . . . . . . @ . @ . @ . @ . . . . @ . @ @ . . . . . @ 
. @ @ . . @ . . . . . . @ . @ . @ @ . . . . . . . @ . . @ . @ @ 
@ . . . . . . @ . . . . . @ @ . @ . . . . . . . . @ @ . . . . . 
. . . . . . @ . . . @ . . . . @ . . . . . . . . . . @ . . . . . 
. . . . . . . . . @ . . . @ . . . . . . . @ . @ . . . . . . . @ 
. . . . . . . @ . . . . . . . . . . . . @ @ . @ . . @ . @ @ @ @ 
@ . . . . . . . . . . . . . . . . . . . @ . . . . . . @ . @ @ . 
. @ . @ . . . . . . . . . . . . . . . . @ . . . . . . . . . . . 
. @ . . . . . . . . . . . . . . @ . . @ . . . @ . . . @ @ . . . 
. . . . @ . @ . . . . . . . @ . @ . . . . @ . . . . . @ . . . @ 
. . @ @ . . . . . . . . . . . . . . . @ @ . . . @ . . . . . . @ 
. @ . . . . . . @ . . . . . . . @ . . . . @ . . . . . . . . @ @ 
. @ . @ . . . . . . . . . . . . . . . . @ . @ . . . . . . . . . 
. . . @ . . @ . @ . @ @ . . . . . . . . @ . @ . @ . . . . . . . 
. . @ . . . . @ . . . . . @ . . . . . . . . . . . @ @ . . @ . . 
. . . . . . @ . . . . @ @ . . . . @ @ @ . . . . . @ . @ @ @ . @ 
. . . . . . . @ . . . @ . . . @ @ . . @ . . . . . @ . . @ . . . 
. @ . . . . . @ . . . . . . . . . @ . . . . . . @ @ @ . @ . . . 
@ . . @ . . . . . . . . @ . @ . . . @ @ . . . . . . . @ . . . . 
. . @ . . . . . . . . . . . . . . . . . . . . . . . . @ . . . . 
. . . . . . . . @ . @ @ . . . . . . . . . @ . . @ . . . . . . . 
. . . . . . @ . . . @ . . @ . . . . . @ . . . . . . . @ . @ . @ 
50
10 0 7 13
10 12 14 9
23 2 14 26
17 19 24 4
0 0 11 17
9 28 13 18
29 5 16 8
19 9 4 8
21 4 20 29
17 22 24 9
13 21 15 1
2 0 9 13
13 1 3 19
1 24 21 4
29 13 10 17
30 5 23 8
30 25 22 4
23 21 24 1
14 21 21 11
12 14 13 17
29 18 25 2
26 4 30 5
8 15 2 2
12 31 8 16
3 30 20 24
15 22 14 13
10 27 9 8
25 16 4 12
7 4 2 31
19 11 20 9
25 17 26 11
29 22 4 9
1 3 19 10
20 1 25 19
18 26 9 25
28 24 23 31
10 26 20 11
31 0 26 29
8 16 19 19
19 8 9 16
25 19 16 31
14 18 20 6
28 3 15 19
9 31 6 29
7 23 8 31
20 12 15 16
21 5 6 22
29 11 5 15
11 15 23 17
21 23 3 9
