32 32
. . . . @ . . . . @ . . . . . . . . . . . . . . . . . @ . . . . 
. . @ . @ . . . @ . . . . . . . . @ @ . . . . . . @ . @ . . . . 
. @ @ . . . . . . @ . . . . @ . . . @ . . . @ . . . @ . . . . . 
. . . . . . @ . . . . . . . @ . . . @ . . . . . . . . . @ . . . 
. . . @ . . @ . . @ @ . @ . . . . . . . . . . @ @ . . @ . . . . 
. . . . . . . @ . @ . @ . . . @ . . @ . . @ . . . . . @ @ . . . 
. . @ . . . @ . . . . . . . . . . @ @ @ . . . . . . . . @ . . . 
. . . @ @ . . @ . @ @ . . . . . . . . . . . @ . . . . . . . . . 
@ . . . @ @ . . . . . . . @ . . . . @ @ @ . . . . . . . . @ @ . 
. @ @ . . @ @ . . . . . . @ @ . @ @ . @ . . . . @ . . @ @ . . @ 
. . . . . . . . . . . . . . . . . . . . . . . . . . . . @ . . . 
. . . . . . . . . . @ @ . @ . @ . . . . . . @ . . . . . . . @ . 
@ . @ . . @ . @ . . @ . @ . . . . . @ . @ . @ . . . . . . . . . 
. @ . . . @ . . . . . . . . . . . @ . @ . . . . . . . @ . . @ . 
. . . . . . . . . . . . . . @ . @ @ . . . @ . . . . . . . . . . 
. . . . . . @ @ . . . . . . @ . . . . . . . . . . . . . @ @ @ . 
. . . . . . @ . . . . . @ . . . . . . . @ . @ @ . . . . . . . . 
@ @ @ @ . . . @ @ . . . . . . . . . . . . . @ . . . . . . . . . 
. . . . @ @ . . . @ . . . . @ . . @ . @ . @ . . . . @ . . . . . 
. . . @ @ . . . . . @ . @ . @ . . . . . . . . . . . . @ . @ . . 
. . . . . . @ @ . @ . . . . @ . . . . . . . . . . . @ @ . @ . . 
@ . @ . . . @ . . . . @ . . . . . . . . @ . . . . . . . . @ . . 
. . . . . . . . @ . . . . . . . . . . . . . . . . @ . . . @ . . 
@ . . . . . . . @ . . . . . . . . . @ . @ . @ . . . . . . . @ . 
. @ . . @ . . @ . . . . @ . . . . . . . . . . . @ . . @ . . . . 
. . . . . . . @ . @ @ . . @ . . . . . @ . @ . . . . @ . . @ . @ 
. . @ . . . . @ @ . @ . . . . . . @ @ . . . . . . . . @ . @ . . 
. . . . . . . . @ . . @ . . . . . . . @ . @ . . . . @ . . @ @ . 
. . @ . @ . @ . . . . @ @ . . . . . . . . . . . . . . . . @ . . 
@ @ . . . @ . . . . . . . . . . . . . . . . . @ . @ . @ . . . . 
. . . . . . . . . . . . . . . . . @ . . . @ . . @ . . . . . @ . 
. . @ . . . . . . . . . . @ . . @ . @ . . . . @ . . . . . . . @ 
10
4 30 14 28
19 30 3 28
17 16 28 23
26 17 14 11
24 6 4 23
19 22 25 21
25 10 17 2
31 22 8 2
17 7 26 23
14 27 0 11
