32 32
. . . . . . . . . . @ . @ @ . @ . . . . . . . . . . . . . . . @ 
. . @ . . . @ . . . @ . . . . . . @ . . . . . . . . . . . . . . 
. @ @ . @ . . @ @ @ . . . . . . . @ . . @ . . . @ . . . @ @ @ . 
. . . . . . @ @ . . . . . . . @ . . . . . . @ . . @ . . . . . . 
@ . . . . . . @ . . @ . . @ . . . . @ . . @ . . . . . . . . . . 
. . @ . . . @ . . . . . . @ . @ . . . @ . @ . . @ . . . . . . . 
. @ . . . @ . . . . . . . . . . . . . . . . . . . . @ . . . . @ 
. @ . . . . @ . . . . . . . @ . . . . . . . . . . . . @ @ . . . 
. . . @ . . . @ . . . . . . . . @ . . @ . . . . . . . . . @ @ . 
@ . . @ . . . . @ @ . . . . . . . . . . . . . . . . . . . . . . 
. . . . . . @ . . . @ . . . . @ . @ . . . . . . . @ . . . . . . 
. . . . @ . . . . . . . @ @ . @ . . @ . . . . . . . . @ . . . . 
@ . . . . . @ . . . . . . @ @ . . . . . @ . . . . @ . @ . . . . 
. . . . . . @ @ . @ . . . . @ . . . . . @ . . @ @ . . . . @ . . 
. @ . @ . @ . @ @ . . . . @ @ . . . . . . @ . . . . @ . . . . . 
@ . @ . @ . . . @ . . . @ . . @ . . . . . . @ . . @ . . . . . . 
@ . . @ . @ . . . . . . . . . @ . . . . . . . . @ . . . . . @ . 
. . . . . . . . . . . @ . @ . @ . . . . . @ . . . @ . . . . . @ 
. . . @ . . @ . . @ . . . . . . @ . . . . @ . . . @ . @ . . @ . 
. . . . . . @ . . . . . . . . . . . @ . . . . . @ . . . . . @ . 
. . . . . . . . . @ . @ . @ . . . . . . . . . . . . . . . . . . 
@ . . . . . . . . . . @ . @ . . . . @ @ . . . . . @ . @ . . . @ 
. . . @ . . . . @ . . . . @ . @ . . @ . . . @ . . . . . @ . @ . 
. . . . . . . . . . . . . . @ . . @ . @ . . . . . . . . . @ . . 
. @ . @ @ @ . . . . . . @ . @ . . . . . @ . . . . . . @ @ . . . 
. . . @ . . . . . . . . . @ @ . . . @ . . . . . . . . . . . . . 
@ . @ @ . . . @ . . @ . . @ . . . . . . @ . . . . . . @ . @ . @ 
. . . . . . . . . . . . @ . . . . . . . . @ . @ . . . . . . . . 
. . @ . . @ . . . . . . . . . . . . @ . . @ . . . @ @ . . . . . 
. . @ @ . @ . . . . @ . . . . . . . . . . . . @ @ @ . . . . . . 
. . @ . . . . . . @ . . . @ @ . . @ @ . . . @ . . @ . . . . . @ 
@ . @ . . . . . . . . . . . @ . @ @ . @ @ . . . . . . . . . . @ 
50
18 1 28 19
15 2 1 19
12 30 5 12
23 16 11 19
27 27 6 2
11 14 21 10
12 20 9 31
25 6 20 3
2 17 8 27
18 9 12 9
5 27 2 9
30 25 13 10
5 2 14 4
2 4 8 5
24 1 13 27
5 19 30 15
28 30 9 29
10 28 19 6
30 4 27 19
1 5 16 24
2 27 12 2
5 0 19 12
16 29 17 15
16 19 0 11
27 14 7 24
31 15 27 17
1 19 28 25
8 3 1 28
2 22 21 23
31 3 1 31
26 8 23 25
6 4 22 1
12 10 23 18
14 19 25 9
28 5 7 15
21 7 30 24
31 20 30 7
25 9 20 17
14 21 9 26
8 12 17 16
18 13 28 26
21 19 13 29
14 4 0 22
28 12 19 29
7 24 7 22
13 7 10 3
24 24 14 5
15 6 29 3
1 9 8 16
4 14 29 18
