32 32
. @ . . @ @ . . . . . . . . . . . . . . . . . . @ . . . @ @ . . 
. . . . . @ . @ . . @ . . . . @ . @ . . @ . . . . . @ . . @ . @ 
. . . @ . . @ @ . . . . . . . . . . . . . . . . . . . . @ . . . 
. . @ . @ @ . . . . . . . . . . @ . @ . . . . . . @ . . . @ . @ 
. . . . . . . . . . @ @ . @ . . . . . . . . . @ . . . @ . . . . 
@ . . . . @ @ . . . . . . . @ . . . . . . . . . . . @ @ . @ . @ 
. . . . . . . . . @ @ . . . @ . . . . . . . . . @ . . @ @ . . . 
. . . . . . . . . . @ . . . . . @ . . . . . @ . . . . . . . . . 
. . . . . . . @ . @ @ . . @ . @ . . . . @ . @ . . . @ . @ . @ . 
. . . . . . . . . . . @ . . . @ . . . . . . . @ @ . . . . . . . 
. . . . . . . . . . @ . . . . . . @ . @ . . . . . . . . . . . . 
@ . . . . . . . . @ . . . . . @ @ . . . . @ . @ . . @ . . . . . 
. . . . . . . . . . @ . . . @ . . @ @ . @ @ . . . . . @ . . @ . 
. . . . . . . . . @ @ . @ . . . . . . . . . @ @ . . . @ @ . . . 
. . . . . . . . @ . . . . . . . . . . . . . . . . . . . . @ . . 
. . . . . . . . . . @ . . . . . @ . . . . . . . @ . . . . . . . 
. . . . . . . @ . . . . @ . . @ . . . . . . . . . . @ . . . . . 
. . @ . . . . . . . . . . . . @ . . . @ . @ @ . . . . @ @ . @ . 
. @ . . . . . . . . @ . . . . . @ @ . . . . @ . @ @ . . @ . . . 
. . . . . . . . @ @ @ . . . . @ . . @ @ . . . . . @ . . . . . . 
. . . . @ . . . . . . . . . @ @ . . . . @ . @ . . . . . @ . . . 
. @ . . @ @ . . . @ . . @ . @ @ . . . . . . @ . . . . . . . . . 
. . . . @ . . . @ . . . . . @ . . . . . @ @ . . @ @ . . . . @ . 
. . @ . . . @ . . . @ . . . . @ . . . . @ @ @ . . . . . . @ @ . 
. . . . . . . . @ . . . . @ . . . @ . . @ . @ . @ . . . . . . . 
. @ . . . @ @ . . . . . . . . @ . . . . . . . . . . . . . . . . 
. @ . . . . . . . . @ . @ @ . . . . . @ @ . @ . . @ . . . @ @ . 
. @ . @ @ . . . . @ @ . @ . . @ . @ . . . . . @ . . . . . . . . 
@ @ . @ . . . . . . . . @ . . . . @ . . . . @ . @ @ . @ @ . @ . 
. . . . . . . @ @ . . . . . . . @ . . . . . . . . . . @ . . . . 
. . . . . @ . . . . . . . . @ . . . . . . @ @ . . . . . . . @ . 
. . . . @ . . . . . . . . . . . . . . @ . . @ . . . . . . @ . . 
40
31 8 0 7
6 10 4 14
10 14 7 10
25 1 11 20
21 5 12 0
18 9 18 14
1 29 9 23
15 7 31 6
10 16 11 19
5 18 18 28
19 20 23 2
2 7 10 16
31 15 20 29
28 24 18 6
29 19 16 19
15 28 23 16
26 30 5 9
2 21 23 3
23 5 2 1
27 1 13 1
14 15 28 25
6 1 26 10
15 5 17 19
29 9 26 18
3 0 5 28
2 19 22 16
3 5 18 25
11 31 1 17
6 30 21 14
29 4 1 23
24 1 1 3
3 11 24 3
30 18 0 0
16 1 26 13
0 22 30 13
14 8 7 5
5 27 24 19
27 20 12 8
29 12 2 12
8 6 16 6
