32 32
. . . . . . @ . . . . . . . . . @ @ . @ @ . . @ . . @ . @ . . . 
. . . . . @ . @ . @ . . . . . . . . @ @ . . . @ @ . . . . . . . 
. @ . . . . . . @ . @ @ . . . . . . . . . . . . . . . . . @ . . 
. @ . . @ . @ . . . . . . . . . . @ . . . . . . . . . . . . . . 
@ . . @ . . . . . . . . . . . . . . @ @ . . . @ . . . . . . @ . 
. . . . @ . . . @ . . . . . . @ . . @ . @ . @ . . . . . . @ . . 
@ . . . . @ . . . @ . @ . . @ . . @ @ @ . . . . . . . . . . . . 
. . . . . . . . . . . . . . . . . . . . . . . . . . . . @ @ . . 
@ @ . . . @ . . . @ @ . . . . . . . . @ @ @ @ . . . . . . . . @ 
. @ @ . . . . . . . . . . . . . . . @ @ . . . . . . @ . . . . . 
. @ . . . . . . . @ @ . . @ . . . . . . @ . . . @ . . . . . . . 
. . @ @ . . . . . . . . . . . . @ . @ . @ . . . . . . . . . @ . 
. @ . . . @ . . . . . @ . . @ . . @ . . . @ . . . . . @ . . . . 
. . . . @ . . @ @ . . @ . . . . . @ . . @ . . @ . . . . @ . . . 
. . . . @ . . . . . . . . . . . . . . . . . . @ . @ . . . . . . 
@ . . . . @ . . . @ . . . . . . . . . . @ . . @ . . . . . . . . 
. . @ @ . . . . . @ @ . . . @ . . @ . . . . . . @ @ . . . . . . 
. . @ . . . . . . . . . . @ . . @ . @ . @ @ @ . . . . @ . . . . 
. @ . . . . . . @ . . . . @ @ . . . . @ @ . . . . @ @ @ . . @ . 
. . . . . . . . @ . . . @ . . . . . @ @ . . @ @ . @ @ . . . . . 
. @ . @ . . . @ . . . . @ . . . . . @ @ . . . . . . . . . . . . 
. . . . . . . . . . . @ . . . . . . @ . . @ . . . @ @ . . . . . 
. . . . . . @ . . . @ . . . @ . . . . . . @ . . @ @ . . . . . . 
. . . . . . . . @ . @ . . . . . . . . . @ . . . . . . . . . . @ 
@ . @ . . . . . . . . . . . . . . . . . . . . . @ . . @ . . . . 
@ . . . . . . . . . . @ . . . @ @ . . . . . . . . . @ . . . . . 
. . . . . . @ . . @ @ . . . . . @ . . @ @ . . @ . . . . @ . . . 
. . . . . . . @ . @ . . . . . . . @ . . . . @ . . . . . . . . @ 
. . . . @ . . @ @ @ . . . @ . @ . . . . . . . . . . . @ . . . @ 
. . . . . . . . . . . . . . @ @ @ . . . @ . @ @ . @ . . @ . . . 
. . . . @ . . . @ . . @ . . @ . @ . . @ . . . . . @ @ . . . @ . 
@ . . . . . . . . . . . . . . @ . . @ . @ . . @ . . . . . . . . 
60
11 8 25 27
26 1 0 2
9 3 26 3
26 17 9 2
28 20 23 8
6 9 28 28
16 14 0 18
22 26 23 11
22 21 22 1
22 7 26 2
5 25 24 31
26 13 8 24
8 4 18 25
4 15 18 22
9 30 30 23
9 11 8 20
24 13 23 5
0 18 0 7
5 23 2 25
4 8 10 0
22 20 0 14
16 19 13 30
0 28 19 27
13 19 23 10
13 2 19 21
28 25 1 6
7 23 26 15
15 22 13 29
17 4 28 5
20 3 15 6
14 19 4 24
28 6 3 24
1 13 20 20
12 9 27 6
5 21 13 26
27 9 28 25
16 27 24 25
11 5 8 15
1 7 12 28
14 25 1 16
0 16 29 6
5 9 31 16
29 1 1 15
30 15 14 0
30 20 19 25
19 27 17 11
22 4 27 2
31 14 16 6
4 9 11 22
20 19 21 24
28 8 6 30
10 7 1 14
31 24 1 0
27 19 15 16
30 24 5 5
21 31 23 20
11 17 5 3
17 8 28 18
8 0 2 26
25 3 15 0
