32 32
. . . . . @ . . . @ . . @ . . . . @ . . . . . . @ . . . . . @ . 
. . . . @ @ @ . . . . @ . . . @ . . . . . . . . . . @ . . . . . 
. . . . . . . . . . . . . . @ . . . . @ . . . . @ . . . @ . . @ 
@ . @ . @ . @ . . . . @ . . . @ . . . @ . . . . @ . . . . . . . 
. . . . @ @ . . . . . @ @ . . . @ . . . . . . . . . . . . . . . 
. . . . . . . . . . . . . . . @ . . . . . . . . . . . . @ @ @ . 
@ . . . . . . . . . . . . . . . @ . . . . @ @ @ . . . . . . . . 
. . @ . . . @ . @ . @ @ . @ . @ . . . . @ . . . . @ . . . . . @ 
. @ . . . . . . . . . . . . . . . . . @ . . . . . . . @ . . . . 
. . . . @ . . . . @ @ . . @ . @ . . . @ . @ . @ . . . @ . . . . 
. . . . . . . . . @ . . . . . . . @ . @ . . . @ . . . . . . . . 
@ . . . . . . @ . . . . @ . . . . @ . . . . . . . @ . . . . . . 
. . . @ . @ . @ . @ . . . . . . . . . @ . . @ . . @ @ . . @ . . 
. . @ . . @ . . @ @ . . . . @ . . . . @ . . . @ . @ . . . . . . 
@ @ @ . . . . @ . . . . . . @ . . . . . @ . . @ . . . . @ . . @ 
. . . . . . . . @ . . . . . . . . . . . . . . @ . . . . . . . . 
. . . . . . . . @ . . . @ . . . . . @ . . . . . . . . @ . . . . 
. @ . . . . . . @ . . . . . . . . . @ . . . . . . . . @ . . . . 
. . @ @ . . . @ . . @ . . . . . . . . . @ @ . @ . . . . . @ . . 
. @ . . . @ . . @ . . @ . . . . . @ . . . . @ . @ @ @ . . . @ . 
. . . . . . @ . . . @ @ . . . @ . . . . . . . . . @ @ . . . . . 
. . . . . . . @ @ . . . . . . @ . . . . . . . @ . . @ @ . . . . 
@ . . . . @ . . . . . @ . . . @ . . . @ @ . . @ . . . . . @ . @ 
. @ . @ . . . . . . . . . @ @ . . . . @ . . . . . . . . . . . . 
@ . . . @ . . . . @ . . @ . . . . . . . @ . @ . . . . . @ . . . 
. . @ . . . . . . . @ . . . . . . @ . . . . . . . . . . . @ . . 
. . @ . @ . . . @ . . . . . . . . . @ . @ . . . . @ . . . @ . . 
. . . . . . . @ . . . . . . . . @ . . @ @ . . . . @ . . . . . . 
@ @ . . . @ . . @ . . . . . . . @ . @ @ . . . . @ . @ . . @ . . 
. . . . @ @ @ @ . . . . . @ . . . . . . . . @ . . . . . . . . . 
. @ . . . . . . . . . . . . . . . . @ @ @ . . @ @ @ . . . . . @ 
@ . . . . . . . @ @ . . . . . . . @ . . @ . . . . @ @ . . . . . 
60
26 16 12 25
12 28 5 18
20 23 25 16
20 9 5 8
14 11 31 1
17 1 8 23
6 22 0 18
14 3 6 15
8 29 31 17
14 8 23 5
11 16 1 29
15 15 8 4
13 24 3 16
12 27 22 7
9 27 12 21
26 24 11 31
26 2 8 22
15 30 20 13
4 30 1 31
15 6 3 2
31 20 20 4
1 26 31 27
30 11 18 1
2 31 26 6
11 2 21 30
3 10 30 24
16 13 18 0
13 22 1 26
5 3 3 22
13 14 17 20
31 9 23 3
23 2 9 15
3 25 21 22
21 14 31 3
3 13 22 27
9 4 17 1
24 23 17 9
26 11 13 2
1 10 18 25
12 22 16 7
24 13 22 2
0 13 24 9
3 17 3 26
26 13 11 13
9 22 21 5
20 0 17 8
19 16 16 14
18 3 22 3
23 20 21 0
13 19 17 29
18 20 27 11
13 10 10 17
28 31 6 24
11 11 12 5
23 25 13 13
28 8 3 10
27 22 14 3
16 23 6 23
22 7 2 19
9 8 11 6
