32 32
. . . . . . . . . . . . . . . . . @ . @ @ . . . . . . . @ . . . 
. . . . . . @ . . . @ . . . . . . . . . . @ . @ . @ . @ . . . @ 
. @ . . . . . . . . . @ @ . . @ . . . . . @ @ @ . @ . . . . @ . 
@ . @ . . . . . . @ . . @ . . . @ . . . . . @ . @ @ . . . . . . 
. . . . . . . . . . . . . . . . @ . . . . . . @ . . . . . . . . 
@ . @ . @ . @ . . . . @ @ . . . . . . @ . . . . . @ . @ . . . . 
. . @ . . . @ . @ . @ . @ . . . . . . . @ . @ . . @ . . . . . . 
. . . . . . @ . . . . . . . . . . . . . . @ . . . . . . @ . . . 
@ @ . . @ . . . . . . . . . . . . . @ . . . @ . @ . . . . @ . . 
. . . @ @ . . @ . . . . . @ . . @ . . . . . . . @ . . @ @ . . . 
. . @ . . . . . . . . . @ . @ . . @ . . . . . . . @ @ . . . . . 
. . . . @ . . . @ . . . . . @ . . . . @ . . @ . . . . @ . . . @ 
. . . @ . . . . . @ @ . . . . . @ . . . . . . . . . . . . . @ @ 
@ . @ . . . . . . @ . . @ . . . . . @ . . . . . @ . . . . . . @ 
. . . . . . . @ @ . @ . @ @ . . . @ . . @ . . @ . . . . . . . @ 
. @ . . . . . @ . . . . @ . . . @ . @ . @ . . . . . . @ . . @ . 
. @ . . . . @ . . . . @ . @ . . . . @ . @ . . @ @ @ . . . . . . 
. @ @ @ . . . . @ . . . . . . . . @ . . . . . @ . . . . @ . . . 
. . @ . . . . . @ . . . . . . . . . . @ . . . . . . . . @ . . . 
. . . . . . . . @ . . . @ . . . . . . @ . . @ @ . @ @ . . . . . 
. . . . . . @ . . . . . . @ . @ . . . . . . . . . @ . . . . . . 
. . . @ . @ . . . . . @ @ . . . . . . . . . @ . . . . . @ . . . 
. . @ @ . . . . . . . . . . . . . . . . . @ . . @ . @ . . . @ . 
. . . . @ . . . . . . . . . . @ @ . . . . . . . . . . . @ @ @ . 
. . @ . . . . . . . . . . @ @ . . . . . . @ . . @ . @ @ @ . . . 
. . @ @ . . . @ . . . . . . . . . . . @ . . . . . . . . . . . . 
. . . . . @ . . . . @ . @ . . . . . . @ . . @ . . @ . . . . @ . 
. . . . . . . . . . . @ . @ . @ . . . . @ . . . . . @ @ . . @ . 
. . . . . . . . @ . . . . . . @ . . . . . @ . . . . . @ . . . . 
. . . . . . . . . . . . . . . . . . @ . . . . . . @ . . . . . @ 
@ . . . . @ . . . . . . . . @ @ . . . . . . . . . . . . . @ . . 
. . . . @ @ . . . . . . @ @ . . . @ @ @ . . . . . . @ . . . @ . 
20
20 17 5 4
1 25 9 8
5 12 17 2
4 22 20 11
22 30 18 2
1 10 15 18
15 3 2 16
13 18 26 18
18 10 19 27
27 16 25 13
3 31 1 22
25 0 18 1
30 8 25 11
21 4 10 30
8 15 5 8
26 29 4 15
26 23 14 18
3 10 26 13
17 21 19 13
29 1 27 30
