32 32
. . . . . . @ . . . . . @ . . . . . . . . . . @ . . . . . . . . 
. @ . @ . . . . . . . . . . @ . . . . . . . . . . . @ . @ . . . 
. @ . . . @ . . . . . . . . . . . . . . @ . @ . . . . @ . . @ . 
. . . . . @ . . . . . . . @ . . . @ . . @ @ . . . @ @ . @ . . @ 
. @ . . . @ . . . @ @ . @ . @ . . . . . @ @ . . . . . . @ . . . 
. . . . . . @ . . @ . @ . . . . @ . . @ . . . @ . . . . . . . . 
. . . . . . . . . . . . . . . . . . . . . . . . . . @ . . . . . 
. . . . . @ . . . @ . . @ @ . . . . . . . . . . . . . . . @ . . 
@ @ . . . . . @ . . . . . @ @ @ . . . . @ . . . . . . . . . . . 
. @ . . . . . . . . . @ . . . . . . . . . . . . @ @ . @ @ . . . 
. @ @ . . . @ . . @ . . . . . . . . . . . . . . . . . . . . . . 
. . . . . . . . . @ . . . @ @ . @ . . . @ . . . . . . . . . . . 
. . . @ . . . . . . . . @ @ . . . . . . . . . . . @ . . . . . @ 
@ . . . . . . . . @ . @ . . @ . @ . @ . . . @ . . . . . @ . . . 
. @ @ . . . . . . . . . . . . . @ . . . . . . . . @ . . . . . . 
. . . . . . . . . . . . . . . . @ . . . @ . @ @ @ @ . . . . . . 
@ @ @ @ @ . . @ . . . @ @ @ . . . . . . . @ @ @ . . . . . . . . 
. . . . . . . . . @ . . . . . @ . . . @ . . . . . @ . . . . . . 
. . @ . @ . @ @ . @ . . . . . @ . @ . . . . . @ @ . . . . . . . 
. @ . @ . . . . . . @ . . . . . . . . . . . . . . @ . . @ @ . @ 
. . @ . @ @ . . . . . @ . . . @ . . . . . @ . . . . . . . . . . 
@ @ . . @ . . @ . . . @ . . @ . . @ . . @ . @ . . @ . . . . . . 
. . . . . . . . . @ @ . . @ . . . . . @ @ . . @ . . . . @ . @ . 
. . . . . . . . . . . . . . . @ @ @ . . . . . . . . . . . . . . 
. . @ . . . @ . . . . . @ @ . . . . . . . . . @ . . @ . . . . . 
. . @ . . . . . . . @ . . @ . . . . . . . @ . @ @ . . . . . . . 
. . . . . . . . . . . . . . @ . @ . . . . . @ . . . . @ . . . @ 
. . @ . . . . . . @ . . . . . @ @ @ @ . @ . . . @ . . . . @ . . 
. @ . @ . . . . . @ . . . . . . . . . @ . @ @ . . . . . . @ . @ 
. . . . . . . . . . . . @ . @ . @ . . @ @ . . . . . @ @ . . . @ 
. @ . . . . . @ . . . @ . . . @ . @ . . @ . @ . @ . . @ . . . . 
. @ . . . . . . . . @ . . . . . . . . . . . . @ . . . . @ . @ . 
10
22 29 31 2
17 22 18 23
30 27 7 6
25 30 21 21
21 17 23 10
30 18 13 5
8 20 2 28
14 28 18 16
29 8 22 18
22 27 0 1
