32 32
. . . . . . . @ . . . . . . . . . . . @ . . @ . . @ . . . . @ . 
. . . @ . @ . . . @ . . . . . . . @ . . . @ @ . . . . @ @ . . . 
. . . . . . . @ . . . . . . @ . . . . . . . @ . . . . . . . . . 
. . @ . . . . . . . . . . . . . . . @ . . . . . . . @ . . . @ @ 
. . . . . . . . . . @ . . . . . . . . @ @ . . . @ . . . . . @ . 
. @ . . . . . . @ . . @ . . . . . @ . . . . . @ . . . . . . . . 
. . . . . @ . . . . . . . @ . . . . . . . . . @ . @ . @ . @ . . 
. . . @ . . . . . . . . . . . @ . . @ . . @ @ . . . @ . . @ . . 
. . . @ @ @ . . . . . . . . . . . . @ @ @ . . @ . . . . . . . . 
. . . . @ . . . . . . . . . @ . @ . @ . . . . . @ . . @ . . . . 
. . . . @ @ . . . . @ . @ . . . . . . . . . @ . . . . . . . @ . 
. . . @ @ @ . . . . . . . . . . . . . . @ . . . @ . . . . . . . 
. @ . . . . . . . @ . . @ . . . . @ . . . @ . . . . . . . . . . 
. @ . . . @ . . @ . . . . . . @ . @ . . . . . . @ . . @ . . . . 
. @ . . . . . . . @ . . @ . . @ . . . . @ @ . @ . @ @ . @ . @ . 
@ . . . . . @ . . . . . . . . . . . . . . . @ . . . . . . . @ . 
. @ . @ . @ . . @ . . @ . . . . . . . . . @ . . . . . . . . . . 
. . . . @ @ . . . . . . . . . . . . @ . . . . . . . . . @ . . @ 
. . . . . @ . . . . @ @ . . @ @ . . @ . . @ . @ . . . @ . . . . 
. . @ . @ . . . . . . @ . @ . . @ @ @ . . . . . . . @ . . . . @ 
. @ . @ . . . . . . . . @ . . . . . . . . . . @ . . @ . . . . @ 
. . . . . . . . . . . . . @ . @ @ . . . @ . @ . . . @ @ @ @ @ @ 
. @ @ . . . @ . . . @ . . . . . . . . . . @ . . . . . . @ . @ . 
. . . @ . . . . . . @ . . . . . . . . . . @ . @ . . . . . . . @ 
. . . . . @ . . . . . . . . . @ . @ . . . @ . . . . . @ . . . . 
@ . . . . . . . @ . @ . . . . . . . . . . @ @ . . . . @ . . . . 
. @ . @ . . . . . . . . . . . . . . . . . . . . @ @ . . . . . . 
. . . @ . . . . . . @ . . . . . . . . @ @ @ . . . . . . . . . . 
. @ . . . . . . . @ @ . . . @ . . . . . @ . . @ . @ . . . @ . . 
@ . @ . @ . . . . @ . . . . . . . . @ @ . @ . . @ . . . @ . . @ 
@ . @ . . . . @ @ . @ . . . . . . . . . @ . @ . . . @ . . . @ . 
. . @ . . @ . . . . . . . . . . . . @ . . . . . . . . . . @ . . 
20
6 20 6 20
14 31 1 0
26 17 8 4
16 30 24 3
28 24 1 3
2 0 15 3
19 10 2 23
13 9 6 3
25 25 6 25
17 10 1 8
28 16 21 3
1 15 10 11
7 24 29 11
8 24 22 23
14 14 31 5
20 23 26 22
29 11 29 12
12 8 8 24
26 27 8 28
25 15 6 24
